Season,Team1,Q1,Q2,Q3,Q4,OT,2OT,3OT,Final,Team2,Q1,Q2,Q3,Q4,OT,2OT,3OT,Final,Date
2000,ORL,22,18,17,29,0,0,0,86,CHH,21,21,37,21,0,0,0,100,19991102
2000,GSW,28,23,24,21,0,0,0,96,DAL,32,23,26,27,0,0,0,108,19991102
2000,PHO,23,38,16,17,8,0,0,102,DEN,29,18,25,22,13,0,0,107,19991102
2000,MIL,25,21,29,23,0,0,0,98,HOU,28,26,20,19,0,0,0,93,19991102
2000,SEA,25,37,26,16,0,0,0,104,LAC,22,26,27,17,0,0,0,92,19991102
2000,DET,22,24,24,30,9,13,0,122,MIA,33,24,20,23,9,19,0,128,19991102
2000,IND,41,26,23,29,0,0,0,119,NJN,27,28,27,30,0,0,0,112,19991102
2000,CLE,20,27,18,19,0,0,0,84,NYK,30,25,19,18,0,0,0,92,19991102
2000,PHI,18,20,16,22,0,0,0,76,SAS,23,14,20,32,0,0,0,89,19991102
2000,BOS,27,23,29,24,0,0,0,103,TOR,18,24,23,25,0,0,0,90,19991102
2000,LAL,25,18,20,28,0,0,0,91,UTA,18,18,23,25,0,0,0,84,19991102
2000,POR,32,25,23,26,0,0,0,106,VAN,22,17,25,22,0,0,0,86,19991102
2000,ATL,26,19,22,20,0,0,0,87,WAS,24,28,23,19,0,0,0,94,19991102
2000,WAS,21,26,20,34,0,0,0,101,BOS,28,25,36,23,0,0,0,112,19991103
2000,NYK,18,14,30,22,0,0,0,84,CHI,18,12,25,19,0,0,0,74,19991103
2000,NJN,27,14,24,25,0,0,0,90,CLE,27,19,27,24,0,0,0,97,19991103
2000,VAN,22,26,19,21,0,0,0,88,LAL,23,26,30,24,0,0,0,103,19991103
2000,DET,21,24,23,26,0,0,0,94,ORL,23,21,33,26,0,0,0,103,19991103
2000,LAC,20,31,27,20,0,0,0,98,POR,30,29,33,29,0,0,0,121,19991103
2000,MIL,26,31,29,33,0,0,0,119,ATL,25,28,27,29,0,0,0,109,19991104
2000,IND,19,27,15,28,0,0,0,89,CHH,29,30,22,17,0,0,0,98,19991104
2000,PHI,23,18,18,21,0,0,0,80,PHO,26,16,26,16,0,0,0,84,19991104
2000,GSW,14,20,22,25,0,0,0,81,SAS,23,21,29,31,0,0,0,104,19991104
2000,DAL,25,21,28,22,0,0,0,96,SEA,26,30,25,25,0,0,0,106,19991104
2000,MIA,25,15,29,17,0,0,0,86,TOR,20,27,19,31,0,0,0,97,19991104
2000,HOU,17,14,28,23,0,0,0,82,UTA,24,14,30,30,0,0,0,98,19991104
2000,CHH,31,18,22,29,0,0,0,100,BOS,37,21,23,22,0,0,0,103,19991105
2000,MIA,31,24,29,21,0,0,0,105,CHI,15,17,28,27,0,0,0,87,19991105
2000,NYK,29,27,24,23,0,0,0,103,DET,18,22,21,30,0,0,0,91,19991105
2000,SAS,25,26,21,23,0,0,0,95,HOU,26,21,24,14,0,0,0,85,19991105
2000,PHI,14,27,12,28,0,0,0,81,LAC,22,20,28,21,0,0,0,91,19991105
2000,TOR,35,30,23,24,0,0,0,112,NJN,29,21,19,23,0,0,0,92,19991105
2000,CLE,23,33,18,30,0,0,0,104,ORL,25,24,31,19,0,0,0,99,19991105
2000,DEN,20,12,29,22,0,0,0,83,POR,27,22,26,20,0,0,0,95,19991105
2000,MIN,29,17,30,19,0,0,0,95,SAC,28,26,24,22,0,0,0,100,19991105
2000,CHI,25,24,19,29,0,0,0,97,ATL,26,35,31,21,0,0,0,113,19991106
2000,NYK,26,24,20,23,0,0,0,93,CLE,37,18,22,25,0,0,0,102,19991106
2000,DAL,34,30,27,29,0,0,0,120,GSW,18,25,28,26,0,0,0,97,19991106
2000,BOS,23,22,31,32,0,0,0,108,IND,34,26,21,34,0,0,0,115,19991106
2000,DET,32,31,23,25,0,0,0,111,MIL,31,22,31,37,0,0,0,121,19991106
2000,SAC,27,36,18,20,0,0,0,101,MIN,26,35,27,26,0,0,0,114,19991106
2000,LAL,24,21,19,18,0,0,0,82,POR,25,30,21,21,0,0,0,97,19991106
2000,UTA,26,30,15,23,0,0,0,94,SEA,23,21,30,25,0,0,0,99,19991106
2000,DEN,27,26,18,23,0,0,0,94,VAN,26,27,35,21,0,0,0,109,19991106
2000,ORL,24,17,28,38,0,0,0,107,WAS,27,15,26,36,0,0,0,104,19991106
2000,DAL,16,29,21,31,0,0,0,97,LAL,29,23,29,24,0,0,0,105,19991107
2000,WAS,17,29,22,19,0,0,0,87,NJN,29,24,22,37,0,0,0,112,19991107
2000,SAS,19,19,20,16,0,0,0,74,PHO,12,19,20,26,0,0,0,77,19991107
2000,CHH,20,26,29,24,0,0,0,99,TOR,18,32,30,29,0,0,0,109,19991107
2000,ATL,33,21,27,19,0,0,0,100,DEN,32,22,31,30,0,0,0,115,19991108
2000,ORL,22,36,21,23,0,0,0,102,HOU,31,30,15,21,0,0,0,97,19991108
2000,UTA,25,20,25,24,0,0,0,94,LAC,16,19,21,23,0,0,0,79,19991108
2000,MIL,22,27,32,16,4,0,0,101,NYK,33,17,22,25,14,0,0,111,19991108
2000,SEA,25,26,28,19,0,0,0,98,PHI,27,21,30,39,0,0,0,117,19991108
2000,PHO,33,31,23,16,0,0,0,103,CHI,26,21,18,15,0,0,0,80,19991109
2000,LAL,25,29,34,35,0,0,0,123,DAL,22,27,22,30,0,0,0,101,19991109
2000,SAS,34,29,31,24,0,0,0,118,GSW,9,33,20,27,0,0,0,89,19991109
2000,IND,28,27,23,23,0,0,0,101,MIA,40,24,33,16,0,0,0,113,19991109
2000,POR,23,20,26,18,0,0,0,87,UTA,19,24,25,24,0,0,0,92,19991109
2000,DET,24,27,23,36,0,0,0,110,BOS,24,19,31,18,0,0,0,92,19991110
2000,MIL,25,23,42,21,0,0,0,111,CHH,26,34,28,29,0,0,0,117,19991110
2000,LAL,24,26,18,21,0,0,0,89,HOU,22,27,17,22,0,0,0,88,19991110
2000,SAS,30,21,23,25,0,0,0,99,LAC,20,26,27,21,0,0,0,94,19991110
2000,PHO,33,23,23,25,0,0,0,104,NJN,16,20,22,31,0,0,0,89,19991110
2000,PHI,24,23,29,29,0,0,0,105,ORL,25,20,28,37,0,0,0,110,19991110
2000,ATL,25,26,19,21,6,0,0,97,VAN,29,22,22,18,11,0,0,102,19991110
2000,SEA,35,30,24,20,0,0,0,109,WAS,27,31,20,17,0,0,0,95,19991110
2000,SEA,36,20,29,24,0,0,0,109,CLE,28,32,13,30,0,0,0,103,19991111
2000,TOR,41,33,24,25,0,0,0,123,DET,28,29,30,19,0,0,0,106,19991111
2000,ORL,24,23,30,24,0,0,0,101,IND,23,30,29,34,0,0,0,116,19991111
2000,DAL,32,18,26,29,0,0,0,105,MIA,43,31,23,31,0,0,0,128,19991111
2000,NYK,31,20,23,16,0,0,0,90,MIN,19,26,21,27,0,0,0,93,19991111
2000,NYK,20,13,25,16,0,0,0,74,BOS,26,20,23,11,0,0,0,80,19991112
2000,NJN,28,24,18,22,0,0,0,92,CHH,29,18,24,25,0,0,0,96,19991112
2000,POR,23,30,16,24,0,0,0,93,DEN,18,17,26,17,0,0,0,78,19991112
2000,HOU,23,29,24,21,0,0,0,97,LAL,16,20,18,27,0,0,0,81,19991112
2000,PHO,25,28,14,25,0,0,0,92,MIL,29,29,31,18,0,0,0,107,19991112
2000,CHI,25,25,13,23,0,0,0,86,PHI,25,22,26,19,0,0,0,92,19991112
2000,UTA,17,27,21,27,0,0,0,92,SAC,17,34,26,28,0,0,0,105,19991112
2000,GSW,29,29,24,21,0,0,0,103,VAN,17,24,20,32,0,0,0,93,19991112
2000,MIA,35,18,24,27,0,0,0,104,WAS,15,33,26,21,0,0,0,95,19991112
2000,BOS,23,20,26,22,0,0,0,91,CHI,15,26,24,27,0,0,0,92,19991113
2000,MIL,22,30,31,29,0,0,0,112,CLE,29,33,20,35,0,0,0,117,19991113
2000,ORL,32,35,22,28,0,0,0,117,DAL,30,26,33,36,0,0,0,125,19991113
2000,SEA,30,22,23,24,0,0,0,99,DET,33,21,28,25,0,0,0,107,19991113
2000,HOU,27,27,21,28,0,0,0,103,GSW,25,20,26,24,0,0,0,95,19991113
2000,WAS,15,26,15,27,0,0,0,83,IND,23,31,28,23,0,0,0,105,19991113
2000,PHO,25,19,25,31,0,0,0,100,MIN,25,29,31,26,0,0,0,111,19991113
2000,ATL,24,20,29,22,0,0,0,95,POR,35,41,24,31,0,0,0,131,19991113
2000,CHH,23,19,17,20,0,0,0,79,SAS,27,20,24,24,0,0,0,95,19991113
2000,ATL,21,14,22,31,0,0,0,88,LAL,35,22,20,16,0,0,0,93,19991114
2000,MIA,27,20,27,20,0,0,0,94,NYK,19,20,22,27,0,0,0,88,19991114
2000,DEN,32,31,32,21,0,0,0,116,SAC,28,33,34,31,0,0,0,126,19991114
2000,PHI,27,28,20,18,0,0,0,93,TOR,24,21,21,24,0,0,0,90,19991114
2000,LAC,25,17,23,24,0,0,0,89,VAN,20,27,33,29,0,0,0,109,19991114
2000,IND,30,10,22,34,0,0,0,96,HOU,25,20,22,20,0,0,0,87,19991115
2000,SEA,28,29,24,19,0,0,0,100,NJN,27,16,24,25,0,0,0,92,19991115
2000,LAL,28,18,21,24,0,0,0,91,PHO,23,23,18,18,0,0,0,82,19991115
2000,SAS,32,19,19,15,0,0,0,85,UTA,25,25,21,20,0,0,0,91,19991115
2000,CHH,25,28,26,19,0,0,0,98,ATL,32,25,24,22,0,0,0,103,19991116
2000,HOU,27,21,27,20,0,0,0,95,DAL,35,21,32,26,0,0,0,114,19991116
2000,NYK,28,18,28,28,0,0,0,102,DEN,20,28,22,25,0,0,0,95,19991116
2000,CHI,19,14,17,29,0,0,0,79,GSW,24,29,24,22,0,0,0,99,19991116
2000,POR,23,31,20,27,0,0,0,101,MIA,31,20,20,25,0,0,0,96,19991116
2000,LAC,21,23,25,24,0,0,0,93,MIL,21,25,28,27,0,0,0,101,19991116
2000,VAN,23,21,18,15,0,0,0,77,SAC,22,21,25,13,0,0,0,81,19991116
2000,IND,24,19,15,18,11,0,0,87,SAS,17,16,17,26,14,0,0,90,19991116
2000,DET,17,23,29,16,0,0,0,85,TOR,17,26,23,23,0,0,0,89,19991116
2000,PHI,26,21,25,23,0,0,0,95,WAS,10,25,23,15,0,0,0,73,19991116
2000,CLE,30,27,26,20,0,0,0,103,BOS,20,27,29,38,0,0,0,114,19991117
2000,DAL,30,11,24,34,0,0,0,99,CHH,25,31,24,24,0,0,0,104,19991117
2000,NJN,35,26,26,20,0,0,0,107,DET,25,32,32,20,0,0,0,109,19991117
2000,LAC,21,24,16,28,0,0,0,89,MIN,20,25,25,15,0,0,0,85,19991117
2000,POR,16,22,21,22,0,0,0,81,ORL,22,23,19,15,0,0,0,79,19991117
2000,MIA,29,21,21,27,0,0,0,98,PHI,24,19,25,25,0,0,0,93,19991117
2000,CHI,26,24,11,20,0,0,0,81,PHO,34,27,21,23,0,0,0,105,19991117
2000,GSW,32,26,25,25,0,0,0,108,SEA,36,21,32,22,0,0,0,111,19991117
2000,NYK,23,19,29,19,0,0,0,90,UTA,36,24,17,21,0,0,0,98,19991117
2000,LAL,22,20,17,23,0,0,0,82,DEN,17,22,30,24,0,0,0,93,19991118
2000,SAC,23,35,38,32,0,0,0,128,HOU,37,26,31,16,0,0,0,110,19991118
2000,SAS,19,25,24,20,0,0,0,88,MIL,23,22,23,31,0,0,0,99,19991118
2000,SEA,31,20,27,32,0,0,0,110,VAN,28,27,29,24,0,0,0,108,19991118
2000,TOR,19,25,21,16,0,0,0,81,WAS,25,25,20,22,0,0,0,92,19991118
2000,NJN,25,15,36,20,0,0,0,96,BOS,29,22,30,28,0,0,0,109,19991119
2000,SAC,26,29,20,28,0,0,0,103,DAL,30,24,24,16,0,0,0,94,19991119
2000,CLE,26,16,17,31,0,0,0,90,DET,33,26,21,21,0,0,0,101,19991119
2000,ATL,31,27,26,21,0,0,0,105,IND,28,28,18,25,0,0,0,99,19991119
2000,CHI,21,19,23,32,0,0,0,95,LAL,30,19,29,25,0,0,0,103,19991119
2000,UTA,12,17,28,27,0,0,0,84,MIN,20,14,31,24,0,0,0,89,19991119
2000,CHH,28,30,23,22,0,0,0,103,ORL,25,19,15,33,0,0,0,92,19991119
2000,POR,29,24,23,21,0,0,0,97,PHI,21,20,27,23,0,0,0,91,19991119
2000,NYK,24,16,18,23,0,0,0,81,PHO,27,28,20,21,0,0,0,96,19991119
2000,LAC,21,23,28,28,0,0,0,100,TOR,28,24,18,36,0,0,0,106,19991119
2000,ORL,25,25,31,26,0,0,0,107,ATL,28,25,24,26,0,0,0,103,19991120
2000,POR,29,20,19,18,14,0,0,100,CHH,27,22,22,15,10,0,0,96,19991120
2000,IND,28,24,31,24,0,0,0,107,CLE,36,22,16,24,0,0,0,98,19991120
2000,CHI,28,19,18,21,0,0,0,86,DEN,22,19,33,21,0,0,0,95,19991120
2000,NYK,29,27,8,22,0,0,0,86,GSW,18,18,19,24,0,0,0,79,19991120
2000,BOS,27,22,18,25,0,0,0,92,MIA,28,26,26,30,0,0,0,110,19991120
2000,UTA,23,30,35,23,0,0,0,111,MIL,18,25,28,29,0,0,0,100,19991120
2000,PHI,22,33,30,15,0,0,0,100,NJN,25,24,21,26,0,0,0,96,19991120
2000,DAL,21,15,23,31,0,0,0,90,SAS,26,22,29,29,0,0,0,106,19991120
2000,HOU,25,19,29,34,0,0,0,107,SEA,28,24,26,32,0,0,0,110,19991120
2000,LAC,27,29,18,24,0,0,0,98,WAS,25,16,27,21,0,0,0,89,19991120
2000,MIL,31,20,21,22,0,0,0,94,DET,35,27,27,24,0,0,0,113,19991121
2000,TOR,32,26,23,30,0,0,0,111,LAL,23,29,27,23,0,0,0,102,19991121
2000,SEA,23,23,19,21,0,0,0,86,PHO,17,30,27,25,0,0,0,99,19991121
2000,HOU,21,29,27,28,0,0,0,105,SAC,33,27,23,27,0,0,0,110,19991121
2000,MIN,33,22,25,25,0,0,0,105,VAN,27,25,16,13,0,0,0,81,19991121
2000,IND,23,17,25,20,0,0,0,85,BOS,22,21,18,34,0,0,0,95,19991122
2000,SAS,27,15,21,31,0,0,0,94,PHI,17,25,25,24,0,0,0,91,19991122
2000,MIN,30,24,26,13,0,0,0,93,UTA,33,36,17,22,0,0,0,108,19991122
2000,MIA,28,27,29,22,0,0,0,106,ATL,28,26,32,27,0,0,0,113,19991123
2000,POR,19,22,26,33,0,0,0,100,CLE,32,19,23,29,0,0,0,103,19991123
2000,DAL,24,30,25,20,0,0,0,99,HOU,32,25,37,25,0,0,0,119,19991123
2000,NYK,24,25,25,21,0,0,0,95,LAC,39,26,19,16,0,0,0,100,19991123
2000,TOR,26,27,17,23,0,0,0,93,PHO,22,25,26,21,0,0,0,94,19991123
2000,NJN,30,20,25,17,0,0,0,92,SAC,26,34,29,16,0,0,0,105,19991123
2000,VAN,16,31,23,17,0,0,0,87,WAS,24,14,26,25,0,0,0,89,19991123
2000,SAS,33,33,30,25,0,0,0,121,BOS,20,22,23,33,0,0,0,98,19991124
2000,VAN,25,16,12,20,0,0,0,73,CHH,23,23,19,24,0,0,0,89,19991124
2000,TOR,26,20,17,21,0,0,0,84,DEN,27,26,26,30,0,0,0,109,19991124
2000,NJN,21,30,13,28,0,0,0,92,GSW,22,23,18,21,0,0,0,84,19991124
2000,UTA,12,17,27,26,0,0,0,82,LAL,21,17,30,22,0,0,0,90,19991124
2000,ATL,19,27,21,24,0,0,0,91,MIA,19,20,28,26,0,0,0,93,19991124
2000,CHI,15,30,35,15,0,0,0,95,MIL,24,23,28,27,0,0,0,102,19991124
2000,POR,19,17,29,23,0,0,0,88,MIN,20,20,18,23,0,0,0,81,19991124
2000,DAL,23,26,24,27,0,0,0,100,ORL,29,32,20,31,0,0,0,112,19991124
2000,WAS,25,19,28,29,0,0,0,101,PHI,27,29,17,20,0,0,0,93,19991124
2000,DET,27,25,22,33,0,0,0,107,IND,29,30,20,20,0,0,0,99,19991125
2000,MIL,24,24,31,35,0,0,0,114,BOS,42,24,26,20,0,0,0,112,19991126
2000,WAS,24,8,25,28,0,0,0,85,CHH,32,31,25,30,0,0,0,118,19991126
2000,MIN,28,20,27,30,0,0,0,105,DEN,26,31,20,37,0,0,0,114,19991126
2000,ATL,29,16,26,20,0,0,0,91,DET,30,22,17,24,0,0,0,93,19991126
2000,VAN,24,17,24,21,0,0,0,86,IND,28,24,25,28,0,0,0,105,19991126
2000,NJN,20,18,21,21,0,0,0,80,LAL,27,20,26,30,0,0,0,103,19991126
2000,CLE,24,21,21,17,0,0,0,83,PHI,30,31,24,21,0,0,0,106,19991126
2000,HOU,15,29,17,19,8,0,0,88,POR,25,24,20,11,11,0,0,91,19991126
2000,GSW,18,25,35,17,0,0,0,95,SAC,28,34,29,33,0,0,0,124,19991126
2000,CHI,17,15,28,18,0,0,0,78,SAS,21,27,23,30,0,0,0,101,19991126
2000,LAC,21,30,27,15,0,0,0,93,SEA,27,20,33,18,0,0,0,98,19991126
2000,TOR,29,27,17,27,0,0,0,100,UTA,21,32,18,16,0,0,0,87,19991126
2000,BOS,28,21,24,11,0,0,0,84,ATL,22,20,26,26,0,0,0,94,19991127
2000,CHH,13,28,22,26,0,0,0,89,CLE,32,24,19,31,0,0,0,106,19991127
2000,CHI,20,26,10,27,0,0,0,83,DAL,24,23,22,26,0,0,0,95,19991127
2000,TOR,37,28,21,20,0,0,0,106,GSW,19,16,31,22,0,0,0,88,19991127
2000,POR,27,27,19,15,0,0,0,88,LAC,21,15,13,22,0,0,0,71,19991127
2000,WAS,22,22,23,19,0,0,0,86,MIA,30,18,17,24,0,0,0,89,19991127
2000,PHI,19,23,23,17,0,0,0,82,MIL,23,25,20,11,0,0,0,79,19991127
2000,VAN,12,18,26,26,0,0,0,82,MIN,23,33,31,26,0,0,0,113,19991127
2000,ORL,29,21,23,23,0,0,0,96,NYK,30,19,29,21,0,0,0,99,19991127
2000,NJN,16,25,30,19,0,0,0,90,PHO,30,30,37,32,0,0,0,129,19991127
2000,DEN,18,24,24,21,0,0,0,87,SAS,27,22,20,37,0,0,0,106,19991127
2000,ORL,31,26,36,15,0,0,0,108,DET,24,26,21,28,0,0,0,99,19991128
2000,IND,16,26,23,26,0,0,0,91,SEA,33,21,31,17,0,0,0,102,19991128
2000,SAC,21,18,26,23,0,0,0,88,MIA,27,25,26,20,0,0,0,98,19991129
2000,DAL,18,13,28,23,0,0,0,82,NYK,29,27,35,16,0,0,0,107,19991129
2000,IND,23,25,24,21,0,0,0,93,POR,26,18,28,19,0,0,0,91,19991129
2000,GSW,19,27,20,33,0,0,0,99,UTA,41,25,28,21,0,0,0,115,19991129
2000,HOU,28,27,20,25,18,0,0,118,VAN,33,22,16,29,10,0,0,110,19991129
2000,DAL,19,24,28,28,0,0,0,99,CLE,38,19,23,26,0,0,0,106,19991130
2000,PHO,25,17,25,27,0,0,0,94,LAC,21,21,17,21,0,0,0,80,19991130
2000,DEN,27,36,16,13,0,0,0,92,MIN,28,26,33,22,0,0,0,109,19991130
2000,WAS,18,17,24,26,0,0,0,85,NJN,25,24,18,11,0,0,0,78,19991130
2000,SAC,24,33,29,25,0,0,0,111,ORL,24,29,25,24,0,0,0,102,19991130
2000,NYK,17,14,16,23,0,0,0,70,PHI,16,15,18,25,0,0,0,74,19991130
2000,DET,25,21,17,24,0,0,0,87,SAS,22,25,40,19,0,0,0,106,19991130
2000,LAL,23,29,23,26,0,0,0,101,SEA,23,16,20,18,0,0,0,77,19991130
2000,ATL,36,28,19,24,0,0,0,107,TOR,23,20,26,20,0,0,0,89,19991130
2000,DET,30,23,22,21,0,0,0,96,DEN,30,25,23,22,0,0,0,100,19991201
2000,GSW,18,10,20,27,0,0,0,75,LAL,21,21,24,27,0,0,0,93,19991201
2000,PHI,24,20,18,21,0,0,0,83,MIA,28,16,24,22,0,0,0,90,19991201
2000,HOU,30,30,24,19,12,7,0,122,PHO,20,32,27,24,12,13,0,128,19991201
2000,CHH,20,26,28,16,0,0,0,90,POR,28,30,16,20,0,0,0,94,19991201
2000,IND,26,17,28,25,0,0,0,96,VAN,22,20,30,17,0,0,0,89,19991201
2000,CLE,22,34,21,34,0,0,0,111,WAS,30,21,28,29,0,0,0,108,19991201
2000,SAC,42,25,16,17,0,0,0,100,ATL,28,30,26,26,0,0,0,110,19991202
2000,DAL,32,23,25,21,0,0,0,101,CHI,21,16,24,34,0,0,0,95,19991202
2000,SEA,36,28,26,27,0,0,0,117,GSW,28,23,27,30,0,0,0,108,19991202
2000,HOU,27,31,21,30,0,0,0,109,LAC,24,24,23,25,0,0,0,96,19991202
2000,NYK,21,17,26,20,0,0,0,84,MIL,18,24,16,22,0,0,0,80,19991202
2000,ORL,26,29,22,26,0,0,0,103,MIN,28,22,20,23,0,0,0,93,19991202
2000,SAS,24,15,32,25,0,0,0,96,NJN,25,21,21,27,0,0,0,94,19991202
2000,MIA,21,19,21,23,0,0,0,84,BOS,23,22,24,27,0,0,0,96,19991203
2000,PHI,21,21,23,26,11,0,0,102,CLE,30,22,25,14,9,0,0,100,19991203
2000,ORL,22,32,30,28,0,0,0,112,DEN,29,24,25,22,0,0,0,100,19991203
2000,SAS,23,18,18,21,0,0,0,80,DET,25,28,25,24,0,0,0,102,19991203
2000,POR,25,11,23,21,0,0,0,80,LAL,18,19,25,31,0,0,0,93,19991203
2000,WAS,25,15,25,28,0,0,0,93,TOR,32,21,20,22,0,0,0,95,19991203
2000,IND,27,28,25,20,0,0,0,100,UTA,23,17,19,16,0,0,0,75,19991203
2000,CHH,27,29,27,30,0,0,0,113,VAN,25,21,22,26,0,0,0,94,19991203
2000,DET,31,29,23,27,0,0,0,110,ATL,28,24,33,27,0,0,0,112,19991204
2000,MIL,28,25,25,14,0,0,0,92,CHI,17,24,30,20,0,0,0,91,19991204
2000,UTA,22,23,26,23,0,0,0,94,GSW,19,24,18,21,0,0,0,82,19991204
2000,PHO,23,20,26,26,0,0,0,95,HOU,26,27,26,26,0,0,0,105,19991204
2000,SEA,31,27,27,17,0,0,0,102,LAC,31,22,16,20,0,0,0,89,19991204
2000,DAL,29,16,29,29,0,0,0,103,MIN,17,28,17,22,0,0,0,84,19991204
2000,NYK,25,21,26,20,0,0,0,92,NJN,15,19,26,22,0,0,0,82,19991204
2000,BOS,16,18,20,20,0,0,0,74,PHI,28,17,12,20,0,0,0,77,19991204
2000,SAC,35,26,27,26,0,0,0,114,WAS,27,22,28,27,0,0,0,104,19991204
2000,ORL,19,30,23,28,0,0,0,100,LAL,34,33,25,25,0,0,0,117,19991205
2000,DAL,16,26,19,36,0,0,0,97,MIL,24,29,22,28,0,0,0,103,19991205
2000,DEN,16,15,23,26,0,0,0,80,NYK,20,20,22,16,0,0,0,78,19991205
2000,POR,17,25,29,21,0,0,0,92,PHO,30,21,17,22,0,0,0,90,19991205
2000,CHH,25,24,26,28,0,0,0,103,SEA,20,24,21,16,0,0,0,81,19991205
2000,SAS,22,22,26,22,0,0,0,92,TOR,21,24,29,24,0,0,0,98,19991205
2000,VAN,31,27,18,23,0,0,0,99,HOU,26,28,31,17,0,0,0,102,19991206
2000,MIA,25,21,26,27,0,0,0,99,LAC,31,13,22,25,0,0,0,91,19991206
2000,SAC,34,20,15,26,0,0,0,95,NJN,26,26,30,27,0,0,0,109,19991206
2000,DEN,22,20,16,36,0,0,0,94,PHI,24,19,17,17,0,0,0,77,19991206
2000,WAS,30,19,22,25,0,0,0,96,UTA,32,20,29,21,0,0,0,102,19991206
2000,VAN,23,28,24,29,0,0,0,104,DAL,28,22,28,17,0,0,0,95,19991207
2000,SAS,21,18,16,22,0,0,0,77,IND,15,27,16,25,0,0,0,83,19991207
2000,WAS,19,21,13,27,0,0,0,80,LAL,19,22,17,33,0,0,0,91,19991207
2000,DET,22,24,38,32,0,0,0,116,MIL,31,31,26,24,0,0,0,112,19991207
2000,GSW,21,17,19,26,0,0,0,83,NYK,30,19,19,21,0,0,0,89,19991207
2000,ORL,27,27,26,27,0,0,0,107,PHO,34,26,20,30,0,0,0,110,19991207
2000,MIA,24,23,20,19,0,0,0,86,POR,25,18,20,13,0,0,0,76,19991207
2000,CLE,28,26,13,31,0,0,0,98,TOR,23,20,31,27,0,0,0,101,19991207
2000,LAC,23,24,16,18,0,0,0,81,ATL,21,24,26,28,0,0,0,99,19991208
2000,DEN,23,18,21,28,0,0,0,90,BOS,28,34,28,25,0,0,0,115,19991208
2000,GSW,23,33,22,28,0,0,0,106,CHH,35,26,28,24,0,0,0,113,19991208
2000,CHI,27,15,25,26,0,0,0,93,CLE,27,31,21,28,0,0,0,107,19991208
2000,MIL,18,24,27,21,0,0,0,90,NJN,31,28,18,30,0,0,0,107,19991208
2000,HOU,17,20,16,20,0,0,0,73,PHI,16,22,17,28,0,0,0,83,19991208
2000,LAL,19,23,22,27,0,0,0,91,SAC,17,32,24,30,0,0,0,103,19991208
2000,MIN,28,24,17,25,0,0,0,94,SEA,34,23,27,26,0,0,0,110,19991208
2000,DAL,25,15,11,28,0,0,0,79,UTA,22,24,16,23,0,0,0,85,19991208
2000,WAS,18,19,29,19,0,0,0,85,PHO,28,25,30,16,0,0,0,99,19991209
2000,MIN,19,13,28,26,0,0,0,86,POR,24,17,27,22,0,0,0,90,19991209
2000,VAN,24,16,27,24,0,0,0,91,SAS,17,22,33,27,0,0,0,99,19991209
2000,GSW,26,30,24,27,0,0,0,107,ATL,20,22,31,26,0,0,0,99,19991210
2000,HOU,16,29,22,29,0,0,0,96,BOS,32,30,15,23,0,0,0,100,19991210
2000,DEN,16,30,31,22,0,0,0,99,CHH,33,27,20,26,0,0,0,106,19991210
2000,NJN,21,18,21,9,0,0,0,69,CHI,22,19,15,15,0,0,0,71,19991210
2000,LAC,20,22,19,22,0,0,0,83,DET,23,27,30,27,0,0,0,107,19991210
2000,CLE,25,23,17,23,0,0,0,88,IND,42,27,37,30,0,0,0,136,19991210
2000,PHI,21,23,14,20,0,0,0,78,NYK,26,14,22,23,0,0,0,85,19991210
2000,MIA,32,22,24,29,0,0,0,107,SAC,36,15,29,17,0,0,0,97,19991210
2000,MIL,33,18,26,30,0,0,0,107,TOR,29,19,14,29,0,0,0,91,19991210
2000,SEA,21,18,24,20,0,0,0,83,UTA,23,32,20,26,0,0,0,101,19991210
2000,ATL,29,28,27,32,0,0,0,116,CLE,39,37,23,28,0,0,0,127,19991211
2000,PHO,20,24,29,42,0,0,0,115,DAL,27,30,36,27,0,0,0,120,19991211
2000,LAC,22,24,25,19,0,0,0,90,IND,23,36,20,29,0,0,0,108,19991211
2000,DEN,25,23,23,30,0,0,0,101,MIL,29,22,28,20,0,0,0,99,19991211
2000,GSW,20,32,26,26,0,0,0,104,MIN,35,20,7,14,0,0,0,76,19991211
2000,HOU,23,20,15,36,0,0,0,94,NJN,32,23,26,25,0,0,0,106,19991211
2000,CHI,26,26,23,12,0,0,0,87,ORL,20,36,31,21,0,0,0,108,19991211
2000,CHH,32,26,28,20,0,0,0,106,PHI,16,23,20,25,0,0,0,84,19991211
2000,POR,23,29,26,23,0,0,0,101,SAC,31,19,24,22,0,0,0,96,19991211
2000,WAS,24,24,23,28,0,0,0,99,SAS,22,22,24,21,0,0,0,89,19991211
2000,MIA,18,20,19,31,0,0,0,88,SEA,23,19,21,29,0,0,0,92,19991211
2000,LAL,23,26,21,36,0,0,0,106,VAN,23,27,19,25,0,0,0,94,19991211
2000,DET,25,26,13,29,0,0,0,93,LAL,25,33,19,24,0,0,0,101,19991212
2000,BOS,26,17,18,36,0,0,0,97,NYK,24,31,18,26,0,0,0,99,19991212
2000,UTA,18,20,34,31,0,0,0,103,TOR,15,15,27,31,0,0,0,88,19991212
2000,VAN,22,27,26,15,0,0,0,90,LAC,29,30,25,18,0,0,0,102,19991213
2000,MIN,22,25,24,23,0,0,0,94,ATL,25,22,33,25,0,0,0,105,19991214
2000,BOS,17,24,24,23,0,0,0,88,CLE,30,21,30,34,0,0,0,115,19991214
2000,SAS,24,27,32,28,0,0,0,111,DAL,25,21,24,23,0,0,0,93,19991214
2000,MIA,32,23,18,24,0,0,0,97,GSW,29,22,32,19,0,0,0,102,19991214
2000,NYK,28,20,28,25,0,0,0,101,HOU,23,22,25,20,0,0,0,90,19991214
2000,LAC,16,3,17,32,0,0,0,68,LAL,32,17,31,15,0,0,0,95,19991214
2000,DET,29,25,26,24,0,0,0,104,PHO,26,31,23,34,0,0,0,114,19991214
2000,DEN,22,18,19,25,0,0,0,84,SEA,22,28,35,24,0,0,0,109,19991214
2000,IND,28,24,24,21,0,0,0,97,TOR,29,24,29,23,0,0,0,105,19991214
2000,UTA,25,18,29,29,0,0,0,101,WAS,26,18,13,23,0,0,0,80,19991214
2000,UTA,17,23,27,29,0,0,0,96,BOS,21,14,28,23,0,0,0,86,19991215
2000,MIN,29,22,19,28,0,0,0,98,CHH,27,31,18,27,0,0,0,103,19991215
2000,CHI,22,21,22,26,0,0,0,91,IND,34,26,22,20,0,0,0,102,19991215
2000,CLE,26,21,21,33,0,0,0,101,NJN,29,28,30,24,0,0,0,111,19991215
2000,MIL,40,28,29,19,0,0,0,116,ORL,17,35,27,20,0,0,0,99,19991215
2000,TOR,29,26,14,22,0,0,0,91,PHI,27,14,27,25,0,0,0,93,19991215
2000,HOU,24,15,27,11,0,0,0,77,SAS,20,20,19,24,0,0,0,83,19991215
2000,SAC,30,30,25,24,0,0,0,109,VAN,26,25,34,21,0,0,0,106,19991215
2000,LAL,24,26,26,19,0,0,0,95,ATL,22,23,18,25,0,0,0,88,19991216
2000,NYK,18,25,32,25,0,0,0,100,DAL,25,18,27,23,0,0,0,93,19991216
2000,SAC,24,33,19,30,0,0,0,106,DEN,24,20,39,33,0,0,0,116,19991216
2000,DET,42,21,25,28,0,0,0,116,GSW,26,27,25,30,0,0,0,108,19991216
2000,MIL,23,24,23,26,0,0,0,96,MIA,23,26,26,20,0,0,0,95,19991216
2000,POR,28,21,30,28,0,0,0,107,SEA,26,18,20,17,0,0,0,81,19991216
2000,NJN,31,28,21,24,0,0,0,104,WAS,32,20,24,32,0,0,0,108,19991216
2000,CLE,24,21,15,26,0,0,0,86,CHH,31,15,29,24,0,0,0,99,19991217
2000,UTA,14,16,28,16,0,0,0,74,IND,15,19,28,27,0,0,0,89,19991217
2000,GSW,24,18,24,25,0,0,0,91,LAC,25,22,23,22,0,0,0,92,19991217
2000,LAL,27,29,19,22,0,0,0,97,MIN,26,12,30,20,0,0,0,88,19991217
2000,TOR,29,37,16,16,0,0,0,98,ORL,29,26,27,30,0,0,0,112,19991217
2000,CHI,19,20,24,11,0,0,0,74,PHI,23,25,14,15,0,0,0,77,19991217
2000,PHO,19,32,36,23,0,0,0,110,POR,27,26,23,26,0,0,0,102,19991217
2000,BOS,22,20,19,33,0,0,0,94,SAS,24,28,24,27,0,0,0,103,19991217
2000,UTA,25,20,30,31,0,0,0,106,ATL,26,24,27,19,0,0,0,96,19991218
2000,ORL,24,14,25,20,0,0,0,83,CHI,20,17,16,21,0,0,0,74,19991218
2000,NJN,30,16,27,25,0,0,0,98,CLE,21,22,9,22,0,0,0,74,19991218
2000,MIN,26,37,20,25,0,0,0,108,DAL,24,32,22,26,0,0,0,104,19991218
2000,SAS,22,16,20,26,0,0,0,84,DEN,11,24,24,27,0,0,0,86,19991218
2000,PHI,25,21,19,26,0,0,0,91,DET,30,32,21,21,0,0,0,104,19991218
2000,BOS,23,16,27,28,0,0,0,94,HOU,19,26,31,24,0,0,0,100,19991218
2000,CHH,22,23,25,36,0,0,0,106,MIA,14,36,17,22,0,0,0,89,19991218
2000,IND,32,20,25,18,0,0,0,95,MIL,25,31,24,29,0,0,0,109,19991218
2000,WAS,19,25,29,22,0,0,0,95,NYK,20,25,20,18,0,0,0,83,19991218
2000,SAC,26,14,38,25,0,0,0,103,PHO,31,36,20,32,0,0,0,119,19991218
2000,VAN,17,29,17,26,0,0,0,89,SEA,23,23,28,38,0,0,0,112,19991218
2000,ATL,24,32,17,15,0,0,0,88,NJN,30,24,19,23,0,0,0,96,19991219
2000,LAL,30,22,21,21,0,0,0,94,TOR,17,17,22,32,0,0,0,88,19991219
2000,LAC,22,17,28,17,0,0,0,84,VAN,22,17,26,20,0,0,0,85,19991219
2000,LAL,27,17,23,32,0,0,0,99,BOS,18,25,26,21,0,0,0,90,19991220
2000,SEA,30,27,14,22,0,0,0,93,CHI,23,30,19,12,0,0,0,84,19991220
2000,MIN,16,25,27,32,0,0,0,100,CLE,30,22,21,21,0,0,0,94,19991220
2000,MIA,27,30,19,16,0,0,0,92,DAL,28,17,24,20,0,0,0,89,19991220
2000,POR,22,24,19,23,0,0,0,88,DEN,21,23,29,24,0,0,0,97,19991220
2000,SAC,27,25,24,23,0,0,0,99,GSW,37,25,32,17,0,0,0,111,19991220
2000,CHH,25,26,23,23,12,0,0,109,NYK,17,29,27,24,15,0,0,112,19991220
2000,UTA,25,30,27,20,0,0,0,102,ORL,25,25,34,20,0,0,0,104,19991220
2000,DET,31,32,23,24,11,0,0,121,PHI,25,29,28,28,12,0,0,122,19991220
2000,MIL,31,22,28,20,0,0,0,101,PHO,29,28,26,25,0,0,0,108,19991220
2000,WAS,26,25,24,22,0,0,0,97,DET,19,24,20,20,0,0,0,83,19991221
2000,POR,27,19,26,17,0,0,0,89,HOU,24,21,23,11,0,0,0,79,19991221
2000,SEA,24,22,24,33,0,0,0,103,IND,26,29,30,28,0,0,0,113,19991221
2000,MIL,23,23,21,28,0,0,0,95,SAC,34,27,26,21,0,0,0,108,19991221
2000,PHO,23,18,25,14,10,0,0,90,SAS,24,24,12,20,11,0,0,91,19991221
2000,NJN,24,21,22,20,0,0,0,87,TOR,43,32,23,18,0,0,0,116,19991221
2000,ATL,14,18,23,26,0,0,0,81,BOS,28,22,29,19,0,0,0,98,19991222
2000,MIN,31,16,36,23,0,0,0,106,CHI,19,22,16,29,0,0,0,86,19991222
2000,ORL,22,27,23,31,0,0,0,103,CLE,27,24,28,18,0,0,0,97,19991222
2000,LAC,30,16,31,26,0,0,0,103,GSW,21,27,22,29,0,0,0,99,19991222
2000,UTA,20,20,19,13,0,0,0,72,MIA,12,22,24,16,0,0,0,74,19991222
2000,TOR,31,14,17,28,0,0,0,90,NYK,23,25,22,21,0,0,0,91,19991222
2000,CLE,32,16,23,19,0,0,0,90,ATL,25,41,18,24,0,0,0,108,19991223
2000,ORL,33,24,27,26,0,0,0,110,CHH,23,32,27,24,0,0,0,106,19991223
2000,WAS,21,29,22,17,0,0,0,89,HOU,25,27,24,29,0,0,0,105,19991223
2000,SAC,29,16,29,17,0,0,0,91,LAC,22,29,27,19,0,0,0,97,19991223
2000,SEA,27,33,18,24,0,0,0,102,MIN,26,26,27,30,0,0,0,109,19991223
2000,PHI,22,21,21,30,0,0,0,94,NJN,31,22,21,25,0,0,0,99,19991223
2000,DAL,26,31,19,35,0,0,0,111,PHO,31,29,20,30,0,0,0,110,19991223
2000,GSW,18,19,27,27,0,0,0,91,POR,25,29,32,25,0,0,0,111,19991223
2000,MIL,26,19,30,19,0,0,0,94,SAS,24,20,24,23,0,0,0,91,19991223
2000,DEN,20,29,21,21,0,0,0,91,VAN,24,22,29,18,0,0,0,93,19991223
2000,NYK,28,22,14,26,0,0,0,90,IND,22,28,23,28,0,0,0,101,19991225
2000,SAS,17,25,25,26,0,0,0,93,LAL,20,30,21,28,0,0,0,99,19991225
2000,TOR,20,26,25,27,0,0,0,98,CLE,16,24,28,27,0,0,0,95,19991226
2000,VAN,23,34,12,17,0,0,0,86,DEN,27,29,29,24,0,0,0,109,19991226
2000,CHH,30,31,18,17,0,0,0,96,DET,22,38,27,27,0,0,0,114,19991226
2000,BOS,18,24,34,24,0,0,0,100,LAC,31,17,20,35,0,0,0,103,19991226
2000,MIA,24,18,23,20,0,0,0,85,MIL,26,31,15,21,0,0,0,93,19991226
2000,CHI,18,16,22,20,0,0,0,76,NJN,32,23,25,23,0,0,0,103,19991226
2000,GSW,24,20,20,24,0,0,0,88,PHO,27,23,31,27,0,0,0,108,19991226
2000,DAL,23,26,29,33,0,0,0,111,SAC,39,31,27,21,0,0,0,118,19991226
2000,PHI,24,26,20,22,0,0,0,92,SEA,21,26,19,20,0,0,0,86,19991226
2000,HOU,21,21,24,26,0,0,0,92,WAS,29,20,31,23,0,0,0,103,19991226
2000,ATL,18,25,33,28,0,0,0,104,CHH,32,26,28,22,0,0,0,108,19991227
2000,IND,34,23,27,19,0,0,0,103,CHI,16,24,29,22,0,0,0,91,19991227
2000,SAS,26,28,22,29,0,0,0,105,GSW,24,16,27,16,0,0,0,83,19991227
2000,DAL,19,29,23,35,0,0,0,106,LAL,31,21,26,30,0,0,0,108,19991227
2000,MIN,29,30,28,20,0,0,0,107,ORL,26,30,23,26,0,0,0,105,19991227
2000,PHO,17,31,20,23,0,0,0,91,UTA,27,19,26,20,0,0,0,92,19991227
2000,PHI,25,25,21,29,0,0,0,100,VAN,20,28,23,22,0,0,0,93,19991227
2000,LAC,20,26,40,19,0,0,0,105,DEN,31,33,29,35,0,0,0,128,19991228
2000,TOR,31,20,19,30,0,0,0,100,HOU,19,31,22,27,0,0,0,99,19991228
2000,MIN,28,21,14,15,0,0,0,78,MIA,22,19,29,19,0,0,0,89,19991228
2000,NYK,22,22,17,22,0,0,0,83,NJN,23,22,25,19,0,0,0,89,19991228
2000,SEA,22,31,16,20,0,0,0,89,POR,27,24,20,23,0,0,0,94,19991228
2000,BOS,20,29,19,33,0,0,0,101,SAC,25,35,28,26,0,0,0,114,19991228
2000,IND,28,12,40,36,0,0,0,116,ATL,27,23,10,29,0,0,0,89,19991229
2000,MIL,31,28,25,21,0,0,0,105,CHH,27,35,28,19,0,0,0,109,19991229
2000,DET,18,24,28,21,0,0,0,91,CHI,19,12,21,25,0,0,0,77,19991229
2000,WAS,31,15,29,19,0,0,0,94,CLE,31,21,24,20,0,0,0,96,19991229
2000,PHI,23,26,27,21,0,0,0,97,GSW,19,28,23,24,0,0,0,94,19991229
2000,PHO,24,28,17,18,0,0,0,87,LAL,26,31,22,24,0,0,0,103,19991229
2000,MIA,26,30,27,26,0,0,0,109,ORL,24,30,25,27,0,0,0,106,19991229
2000,SAC,33,18,29,33,0,0,0,113,SEA,22,25,33,24,0,0,0,104,19991229
2000,VAN,23,18,28,21,0,0,0,90,UTA,20,25,30,26,0,0,0,101,19991229
2000,TOR,32,19,26,32,0,0,0,109,DAL,26,26,22,30,0,0,0,104,19991230
2000,BOS,30,19,27,26,0,0,0,102,DEN,21,23,24,26,0,0,0,94,19991230
2000,ATL,32,24,25,16,8,0,0,105,DET,23,35,20,19,9,0,0,106,19991230
2000,LAC,23,28,26,23,0,0,0,100,HOU,36,27,36,23,0,0,0,122,19991230
2000,CHH,28,19,24,28,0,0,0,99,IND,31,19,37,22,0,0,0,109,19991230
2000,CLE,29,18,23,20,0,0,0,90,MIL,23,22,16,30,0,0,0,91,19991230
2000,CHI,19,18,19,20,0,0,0,76,MIN,32,22,20,20,0,0,0,94,19991230
2000,ORL,28,22,26,16,0,0,0,92,NJN,29,25,25,23,0,0,0,102,19991230
2000,PHI,14,27,25,24,0,0,0,90,POR,35,21,22,30,0,0,0,108,19991230
2000,SAS,19,28,25,26,0,0,0,98,VAN,22,13,28,25,0,0,0,88,19991230
2000,NYK,27,15,24,23,0,0,0,89,WAS,25,18,21,22,0,0,0,86,19991230
2000,ORL,24,32,21,19,7,0,0,103,MIA,18,31,15,32,15,0,0,111,20000102
2000,CLE,34,24,20,20,0,0,0,98,BOS,28,30,29,18,0,0,0,105,20000103
2000,POR,24,23,22,19,0,0,0,88,CHI,12,16,13,22,0,0,0,63,20000103
2000,DET,34,23,34,27,0,0,0,118,ORL,23,24,27,32,0,0,0,106,20000103
2000,MIL,29,29,31,26,5,0,0,120,PHI,27,25,31,32,9,0,0,124,20000103
2000,DEN,16,31,30,12,0,0,0,89,UTA,27,29,26,27,0,0,0,109,20000103
2000,GSW,27,24,20,16,0,0,0,87,WAS,28,28,25,18,0,0,0,99,20000103
2000,SAC,31,24,23,33,0,0,0,111,CLE,39,22,17,29,0,0,0,107,20000104
2000,DAL,31,23,20,22,0,0,0,96,DEN,28,17,31,22,0,0,0,98,20000104
2000,SEA,34,20,28,21,0,0,0,103,HOU,31,22,23,20,0,0,0,96,20000104
2000,NJN,28,17,32,34,0,0,0,111,IND,30,33,31,22,0,0,0,116,20000104
2000,LAL,24,35,37,26,0,0,0,122,LAC,29,32,18,19,0,0,0,98,20000104
2000,VAN,23,18,34,16,0,0,0,91,MIA,31,23,15,18,0,0,0,87,20000104
2000,ATL,32,26,29,26,0,0,0,113,MIL,22,29,37,28,0,0,0,116,20000104
2000,SAS,21,29,24,14,0,0,0,88,MIN,24,18,33,16,0,0,0,91,20000104
2000,BOS,25,25,21,17,0,0,0,88,NYK,33,16,23,24,0,0,0,96,20000104
2000,CHH,23,22,17,18,0,0,0,80,PHO,26,22,25,13,0,0,0,86,20000104
2000,POR,30,23,28,33,0,0,0,114,TOR,26,26,16,22,0,0,0,90,20000104
2000,DET,26,31,30,33,0,0,0,120,ATL,27,32,28,21,0,0,0,108,20000105
2000,WAS,18,18,16,14,0,0,0,66,CHI,29,21,16,11,0,0,0,77,20000105
2000,LAC,31,21,21,28,0,0,0,101,LAL,29,23,27,39,0,0,0,118,20000105
2000,VAN,29,16,28,23,0,0,0,96,ORL,27,28,33,28,0,0,0,116,20000105
2000,GSW,23,26,25,18,0,0,0,92,PHI,29,33,23,28,0,0,0,113,20000105
2000,SEA,31,20,22,26,0,0,0,99,SAS,23,21,27,25,0,0,0,96,20000105
2000,CHH,22,25,25,24,0,0,0,96,UTA,33,27,29,29,0,0,0,118,20000105
2000,GSW,25,15,17,18,0,0,0,75,CLE,28,18,24,20,0,0,0,90,20000106
2000,UTA,21,24,26,34,0,0,0,105,DAL,18,22,27,25,0,0,0,92,20000106
2000,IND,23,25,28,26,0,0,0,102,DEN,25,20,29,13,0,0,0,87,20000106
2000,MIL,31,16,28,20,0,0,0,95,DET,26,24,18,33,0,0,0,101,20000106
2000,HOU,24,19,24,32,0,0,0,99,MIA,30,24,35,22,0,0,0,111,20000106
2000,POR,27,22,26,21,0,0,0,96,MIN,20,27,23,28,0,0,0,98,20000106
2000,SAC,16,25,34,14,0,0,0,89,TOR,30,25,21,25,0,0,0,101,20000106
2000,TOR,13,27,26,31,0,0,0,97,ATL,27,24,22,32,0,0,0,105,20000107
2000,SAC,31,21,21,20,0,0,0,93,BOS,29,30,18,24,0,0,0,101,20000107
2000,CHH,27,20,19,17,0,0,0,83,LAL,18,26,16,27,0,0,0,87,20000107
2000,VAN,28,25,25,23,0,0,0,101,NJN,27,18,25,21,0,0,0,91,20000107
2000,NYK,23,18,34,19,0,0,0,94,ORL,22,18,24,22,0,0,0,86,20000107
2000,SAS,24,28,30,20,0,0,0,102,PHO,21,25,16,21,0,0,0,83,20000107
2000,CHI,24,25,28,33,0,0,0,110,WAS,30,28,15,30,0,0,0,103,20000107
2000,BOS,15,19,23,22,0,0,0,79,CHI,19,25,23,29,0,0,0,96,20000108
2000,ATL,28,21,25,11,0,0,0,85,DAL,18,28,22,27,0,0,0,95,20000108
2000,CHH,30,18,28,16,0,0,0,92,DEN,27,21,23,26,0,0,0,97,20000108
2000,MIN,28,27,23,32,0,0,0,110,DET,25,26,25,29,0,0,0,105,20000108
2000,UTA,27,30,25,21,0,0,0,103,HOU,22,20,24,21,0,0,0,87,20000108
2000,IND,20,24,23,27,0,0,0,94,LAC,27,31,21,28,0,0,0,107,20000108
2000,NJN,23,20,31,16,0,0,0,90,MIA,24,20,21,24,0,0,0,89,20000108
2000,WAS,27,33,21,24,13,11,0,129,MIL,35,23,21,26,13,12,0,130,20000108
2000,CLE,23,21,23,22,0,0,0,89,NYK,17,23,25,21,0,0,0,86,20000108
2000,PHO,20,27,21,23,0,0,0,91,POR,20,15,30,31,0,0,0,96,20000108
2000,ORL,16,26,19,31,0,0,0,92,SAS,41,34,29,23,0,0,0,127,20000108
2000,LAL,28,21,34,27,0,0,0,110,SEA,31,35,12,22,0,0,0,100,20000108
2000,SEA,19,33,20,19,9,0,0,100,GSW,26,27,18,20,4,0,0,95,20000109
2000,MIN,39,29,31,24,0,0,0,123,PHI,19,31,25,37,0,0,0,112,20000109
2000,IND,31,23,23,36,0,0,0,113,SAC,36,29,25,26,0,0,0,116,20000109
2000,VAN,25,30,22,30,0,0,0,107,TOR,26,18,27,26,0,0,0,97,20000109
2000,VAN,23,29,31,29,0,0,0,112,BOS,30,29,23,21,0,0,0,103,20000110
2000,LAC,18,29,38,21,0,0,0,106,CLE,27,22,28,34,0,0,0,111,20000110
2000,DEN,18,29,29,19,0,0,0,95,LAL,43,29,35,23,0,0,0,130,20000110
2000,CHH,18,29,19,21,0,0,0,87,MIL,31,38,31,37,0,0,0,137,20000110
2000,NJN,25,24,31,20,0,0,0,100,ORL,30,25,15,24,0,0,0,94,20000110
2000,DAL,22,23,22,27,0,0,0,94,POR,25,21,32,29,0,0,0,107,20000110
2000,UTA,23,18,27,18,0,0,0,86,SAS,21,20,18,34,0,0,0,93,20000110
2000,DAL,34,19,28,28,0,0,0,109,GSW,16,32,27,27,0,0,0,102,20000111
2000,MIA,27,30,28,31,0,0,0,116,MIN,23,24,26,33,0,0,0,106,20000111
2000,CHI,17,21,17,33,0,0,0,88,NYK,24,28,28,15,0,0,0,95,20000111
2000,HOU,19,22,28,24,0,0,0,93,SAC,27,21,33,29,0,0,0,110,20000111
2000,PHO,25,20,17,26,0,0,0,88,SEA,19,32,22,28,0,0,0,101,20000111
2000,TOR,10,23,29,27,0,0,0,89,WAS,20,36,29,32,0,0,0,117,20000111
2000,LAC,23,19,21,25,0,0,0,88,BOS,18,23,25,29,0,0,0,95,20000112
2000,SEA,29,21,28,25,0,0,0,103,DEN,23,32,21,17,0,0,0,93,20000112
2000,NYK,33,21,19,35,0,0,0,108,DET,29,23,33,29,0,0,0,114,20000112
2000,WAS,27,25,21,29,0,0,0,102,IND,27,28,25,37,0,0,0,117,20000112
2000,LAL,26,30,21,26,0,0,0,103,MIL,26,22,16,30,0,0,0,94,20000112
2000,CLE,25,19,21,10,0,0,0,75,POR,21,30,22,22,0,0,0,95,20000112
2000,ORL,31,20,23,28,0,0,0,102,TOR,24,30,26,28,0,0,0,108,20000112
2000,PHO,27,28,20,20,0,0,0,95,VAN,27,23,21,21,0,0,0,92,20000112
2000,HOU,23,30,27,28,0,0,0,108,GSW,24,29,22,25,0,0,0,100,20000113
2000,BOS,18,24,18,25,0,0,0,85,MIN,29,22,32,20,0,0,0,103,20000113
2000,LAC,26,24,26,29,0,0,0,105,NJN,27,29,29,25,0,0,0,110,20000113
2000,SAS,30,31,23,19,0,0,0,103,SAC,26,28,27,26,0,0,0,107,20000113
2000,MIA,18,24,23,18,0,0,0,83,UTA,26,19,29,19,0,0,0,93,20000113
2000,ATL,20,19,26,24,0,0,0,89,CHI,17,27,13,26,0,0,0,83,20000114
2000,MIA,20,27,15,30,0,0,0,92,DEN,32,21,16,18,0,0,0,87,20000114
2000,WAS,22,27,22,27,0,0,0,98,DET,33,20,28,24,0,0,0,105,20000114
2000,LAL,30,28,19,25,0,0,0,102,IND,33,24,18,36,0,0,0,111,20000114
2000,ORL,28,31,18,23,0,0,0,100,PHI,27,19,22,34,0,0,0,102,20000114
2000,POR,14,29,29,33,0,0,0,105,PHO,27,25,18,13,0,0,0,83,20000114
2000,SAS,15,27,27,16,0,0,0,85,SEA,32,17,24,18,0,0,0,91,20000114
2000,MIL,30,29,22,29,0,0,0,110,TOR,38,20,24,33,0,0,0,115,20000114
2000,CLE,26,20,21,15,0,0,0,82,VAN,20,22,16,22,0,0,0,80,20000114
2000,PHI,26,26,25,24,0,0,0,101,ATL,27,26,14,31,0,0,0,98,20000115
2000,HOU,37,18,10,28,0,0,0,93,CHI,22,19,22,27,0,0,0,90,20000115
2000,POR,17,26,28,34,0,0,0,105,DAL,26,35,22,30,0,0,0,113,20000115
2000,SAC,29,34,27,24,0,0,0,114,GSW,28,30,26,15,0,0,0,99,20000115
2000,TOR,18,25,26,28,0,0,0,97,MIL,42,19,27,30,0,0,0,118,20000115
2000,LAL,30,27,23,24,0,0,0,104,MIN,20,29,31,11,0,0,0,91,20000115
2000,BOS,24,21,25,29,0,0,0,99,NJN,29,18,23,26,0,0,0,96,20000115
2000,CHH,13,24,24,18,0,0,0,79,NYK,28,24,11,28,0,0,0,91,20000115
2000,IND,25,27,17,27,0,0,0,96,ORL,22,24,29,14,0,0,0,89,20000115
2000,LAC,28,16,20,11,0,0,0,75,UTA,28,28,26,30,0,0,0,112,20000115
2000,DET,26,25,26,35,0,0,0,112,WAS,31,30,22,24,0,0,0,107,20000115
2000,DEN,19,36,31,14,0,0,0,100,PHO,34,27,30,22,0,0,0,113,20000116
2000,CLE,26,27,27,22,0,0,0,102,SAC,37,32,18,26,0,0,0,113,20000116
2000,MIA,25,21,19,29,0,0,0,94,VAN,31,14,20,18,0,0,0,83,20000116
2000,MIL,31,21,29,26,0,0,0,107,ATL,24,30,19,28,0,0,0,101,20000117
2000,TOR,30,20,20,24,0,0,0,94,CHH,28,20,40,27,0,0,0,115,20000117
2000,HOU,35,25,30,31,0,0,0,121,DAL,22,20,40,29,0,0,0,111,20000117
2000,ORL,30,21,25,24,0,0,0,100,GSW,26,26,23,38,0,0,0,113,20000117
2000,SAS,27,31,23,18,0,0,0,99,LAC,33,19,23,18,0,0,0,93,20000117
2000,SEA,28,18,20,16,0,0,0,82,LAL,25,20,17,19,0,0,0,81,20000117
2000,IND,28,20,29,23,0,0,0,100,MIN,29,16,22,34,0,0,0,101,20000117
2000,DET,24,19,25,26,0,0,0,94,NYK,19,32,28,26,0,0,0,105,20000117
2000,NJN,29,19,28,20,0,0,0,96,PHI,31,26,25,19,0,0,0,101,20000117
2000,BOS,23,24,31,27,0,0,0,105,WAS,28,23,23,27,0,0,0,101,20000117
2000,POR,22,25,24,18,0,0,0,89,HOU,22,21,30,17,0,0,0,90,20000118
2000,CHI,12,23,15,30,12,0,0,92,MIA,20,18,22,20,5,0,0,85,20000118
2000,LAC,22,25,25,26,0,0,0,98,SAC,25,32,30,17,0,0,0,104,20000118
2000,CLE,15,25,27,13,0,0,0,80,SEA,29,17,26,27,0,0,0,99,20000118
2000,TOR,26,27,22,15,0,0,0,90,BOS,26,23,13,32,0,0,0,94,20000119
2000,CHH,29,24,19,24,0,0,0,96,CHI,15,28,16,27,0,0,0,86,20000119
2000,MIL,27,27,16,14,0,0,0,84,IND,32,29,17,28,0,0,0,106,20000119
2000,CLE,24,26,23,13,0,0,0,86,LAL,21,21,25,28,0,0,0,95,20000119
2000,NJN,24,14,24,27,0,0,0,89,NYK,20,23,27,20,0,0,0,90,20000119
2000,ATL,27,22,12,28,0,0,0,89,PHI,30,28,29,20,0,0,0,107,20000119
2000,POR,26,28,23,28,0,0,0,105,SAS,21,23,24,27,0,0,0,95,20000119
2000,MIN,31,17,18,25,0,0,0,91,UTA,19,26,18,25,0,0,0,88,20000119
2000,DAL,23,25,34,22,0,0,0,104,WAS,17,30,18,21,0,0,0,86,20000119
2000,PHI,31,18,19,32,0,0,0,100,CHH,24,23,40,22,0,0,0,109,20000120
2000,DEN,33,24,32,26,0,0,0,115,HOU,35,23,32,32,0,0,0,122,20000120
2000,SEA,29,24,24,27,0,0,0,104,MIL,19,24,28,25,0,0,0,96,20000120
2000,DET,26,26,37,31,0,0,0,120,NJN,35,31,27,29,0,0,0,122,20000120
2000,ORL,32,27,30,14,0,0,0,103,SAC,33,28,23,27,0,0,0,111,20000120
2000,UTA,25,12,34,23,0,0,0,94,VAN,20,19,25,25,0,0,0,89,20000120
2000,SEA,18,23,14,31,0,0,0,86,BOS,28,33,25,25,0,0,0,111,20000121
2000,PHO,27,26,27,21,0,0,0,101,DEN,21,36,18,24,0,0,0,99,20000121
2000,CLE,26,33,22,22,0,0,0,103,GSW,26,30,35,24,0,0,0,115,20000121
2000,MIN,26,23,20,26,0,0,0,95,LAC,24,30,18,17,0,0,0,89,20000121
2000,ATL,20,22,16,21,0,0,0,79,MIA,26,13,28,34,0,0,0,101,20000121
2000,IND,27,34,32,20,0,0,0,113,WAS,33,23,31,36,0,0,0,123,20000121
2000,WAS,29,22,23,19,0,0,0,93,ATL,32,26,30,23,0,0,0,111,20000122
2000,BOS,19,24,28,25,0,0,0,96,CHH,28,30,25,27,0,0,0,110,20000122
2000,DET,25,22,25,20,0,0,0,92,CHI,27,15,25,31,0,0,0,98,20000122
2000,POR,30,17,26,22,0,0,0,95,LAL,30,27,21,13,0,0,0,91,20000122
2000,DAL,23,29,23,20,0,0,0,95,NJN,19,31,24,24,0,0,0,98,20000122
2000,IND,27,23,19,28,0,0,0,97,PHI,23,29,23,28,0,0,0,103,20000122
2000,CLE,15,17,30,26,0,0,0,88,PHO,21,24,28,28,0,0,0,101,20000122
2000,UTA,30,27,21,26,0,0,0,104,SAC,19,30,29,23,0,0,0,101,20000122
2000,NYK,26,22,11,24,0,0,0,83,SAS,25,27,25,19,0,0,0,96,20000122
2000,ORL,20,28,23,14,0,0,0,85,VAN,19,23,18,22,0,0,0,82,20000122
2000,DAL,25,26,19,29,0,0,0,99,DET,19,30,27,15,0,0,0,91,20000123
2000,MIN,31,25,24,19,0,0,0,99,GSW,19,26,14,22,0,0,0,81,20000123
2000,MIA,22,18,21,27,0,0,0,88,HOU,16,30,32,23,0,0,0,101,20000123
2000,ORL,23,27,29,23,0,0,0,102,LAC,22,27,20,20,0,0,0,89,20000123
2000,SEA,18,25,18,16,0,0,0,77,TOR,24,32,14,24,0,0,0,94,20000123
2000,IND,27,24,14,17,0,0,0,82,CHI,17,20,29,17,0,0,0,83,20000124
2000,VAN,23,25,28,22,0,0,0,98,DEN,27,23,36,24,0,0,0,110,20000124
2000,SEA,28,23,28,27,0,0,0,106,NYK,28,28,22,34,0,0,0,112,20000124
2000,NJN,22,28,18,19,0,0,0,87,POR,26,17,28,30,0,0,0,101,20000124
2000,LAL,26,17,18,20,10,10,0,101,UTA,17,27,22,15,10,14,0,105,20000124
2000,CHI,19,27,18,25,0,0,0,89,ATL,18,19,27,32,0,0,0,96,20000125
2000,SAC,36,26,21,27,0,0,0,110,CHH,32,27,18,22,0,0,0,99,20000125
2000,DET,21,18,34,23,11,0,0,107,CLE,26,27,15,28,20,0,0,116,20000125
2000,GSW,20,28,24,31,0,0,0,103,DAL,31,28,30,28,0,0,0,117,20000125
2000,MIN,16,27,27,22,0,0,0,92,HOU,18,18,22,26,0,0,0,84,20000125
2000,PHO,22,20,18,27,0,0,0,87,IND,19,28,25,21,0,0,0,93,20000125
2000,BOS,20,19,27,23,0,0,0,89,MIA,31,28,31,25,0,0,0,115,20000125
2000,LAC,27,23,17,15,0,0,0,82,SAS,21,33,23,28,0,0,0,105,20000125
2000,SAC,28,24,25,27,0,0,0,104,MIL,28,35,28,21,0,0,0,112,20000126
2000,BOS,20,26,17,26,0,0,0,89,ORL,28,18,35,30,0,0,0,111,20000126
2000,PHO,22,27,21,23,0,0,0,93,PHI,17,26,20,24,0,0,0,87,20000126
2000,NJN,31,21,14,26,0,0,0,92,SEA,23,20,25,27,0,0,0,95,20000126
2000,WAS,28,23,18,36,0,0,0,105,TOR,31,27,32,30,0,0,0,120,20000126
2000,VAN,26,29,33,28,0,0,0,116,UTA,26,17,28,28,0,0,0,99,20000126
2000,DET,31,23,24,24,0,0,0,102,CHH,29,30,32,26,0,0,0,117,20000127
2000,ORL,25,26,13,26,0,0,0,90,CLE,28,27,21,26,0,0,0,102,20000127
2000,LAC,28,21,23,18,0,0,0,90,DAL,23,33,24,19,0,0,0,99,20000127
2000,GSW,37,25,25,28,0,0,0,115,HOU,32,30,26,22,0,0,0,110,20000127
2000,UTA,22,20,18,15,0,0,0,75,POR,17,25,21,22,0,0,0,85,20000127
2000,MIN,26,19,18,17,0,0,0,80,SAS,35,14,26,17,0,0,0,92,20000127
2000,NJN,31,14,27,34,0,0,0,106,VAN,34,24,20,30,0,0,0,108,20000127
2000,NYK,25,25,24,17,5,0,0,96,ATL,25,25,19,22,7,0,0,98,20000128
2000,PHO,21,25,28,14,0,0,0,88,BOS,26,23,26,16,0,0,0,91,20000128
2000,SAC,25,22,31,24,0,0,0,102,CHI,28,20,21,21,0,0,0,90,20000128
2000,HOU,19,21,27,31,0,0,0,98,DEN,23,23,29,29,0,0,0,104,20000128
2000,MIL,31,24,20,14,0,0,0,89,LAL,36,31,23,27,0,0,0,117,20000128
2000,MIA,28,23,25,17,0,0,0,93,TOR,29,32,27,20,0,0,0,108,20000128
2000,PHO,30,17,15,17,0,0,0,79,CHH,25,27,21,27,0,0,0,100,20000129
2000,TOR,20,26,36,24,0,0,0,106,CHI,21,17,24,27,0,0,0,89,20000129
2000,DEN,10,27,24,35,0,0,0,96,DAL,28,30,29,20,0,0,0,107,20000129
2000,PHI,23,21,27,17,0,0,0,88,DET,32,19,19,20,0,0,0,90,20000129
2000,MIA,18,27,26,13,0,0,0,84,IND,36,20,23,15,0,0,0,94,20000129
2000,NJN,21,21,24,27,0,0,0,93,LAC,21,22,26,29,0,0,0,98,20000129
2000,UTA,17,12,28,37,0,0,0,94,MIN,18,23,25,30,0,0,0,96,20000129
2000,ATL,16,23,21,27,0,0,0,87,ORL,16,42,18,27,0,0,0,103,20000129
2000,SAS,25,15,18,9,0,0,0,67,POR,24,25,17,15,0,0,0,81,20000129
2000,MIL,29,29,26,17,0,0,0,101,SEA,26,31,27,15,0,0,0,99,20000129
2000,CLE,30,24,23,21,0,0,0,98,WAS,30,19,26,28,0,0,0,103,20000129
2000,LAL,16,23,27,17,0,0,0,83,HOU,25,17,23,24,0,0,0,89,20000130
2000,SAC,30,21,23,37,0,0,0,111,NYK,30,36,28,26,0,0,0,120,20000130
2000,PHI,26,15,16,23,0,0,0,80,DEN,19,24,18,22,0,0,0,83,20000131
2000,DET,28,13,17,24,0,0,0,82,MIA,22,32,26,24,0,0,0,104,20000131
2000,SAC,21,28,17,24,0,0,0,90,MIN,32,28,24,21,0,0,0,105,20000131
2000,PHO,30,32,31,24,0,0,0,117,ORL,30,20,24,39,0,0,0,113,20000131
2000,MIL,22,20,19,31,0,0,0,92,VAN,27,23,17,20,0,0,0,87,20000131
2000,WAS,25,20,24,39,0,0,0,108,CLE,22,22,31,37,0,0,0,112,20000201
2000,PHI,22,28,25,26,0,0,0,101,DAL,26,26,31,17,0,0,0,100,20000201
2000,CHH,17,27,25,14,0,0,0,83,HOU,30,21,24,24,0,0,0,99,20000201
2000,BOS,23,22,27,24,0,0,0,96,IND,26,27,22,24,0,0,0,99,20000201
2000,GSW,21,27,25,34,0,0,0,107,LAC,23,19,9,25,0,0,0,76,20000201
2000,ORL,20,33,17,28,0,0,0,98,NYK,10,28,14,25,0,0,0,77,20000201
2000,CHI,21,20,19,21,0,0,0,81,POR,27,24,21,20,0,0,0,92,20000201
2000,LAL,21,24,18,18,0,0,0,81,SAS,26,29,25,25,0,0,0,105,20000201
2000,SEA,19,30,26,29,0,0,0,104,UTA,28,18,25,25,0,0,0,96,20000201
2000,MIA,30,31,30,14,0,0,0,105,BOS,26,33,22,22,0,0,0,103,20000202
2000,MIL,31,31,26,24,0,0,0,112,DEN,45,27,28,35,0,0,0,135,20000202
2000,SAC,27,26,37,23,0,0,0,113,DET,29,27,25,29,0,0,0,110,20000202
2000,VAN,22,23,31,19,0,0,0,95,GSW,24,27,21,29,0,0,0,101,20000202
2000,ATL,21,20,27,29,0,0,0,97,NJN,29,25,20,15,0,0,0,89,20000202
2000,LAC,19,15,14,20,0,0,0,68,PHO,25,33,29,27,0,0,0,114,20000202
2000,CHI,23,17,17,31,0,0,0,88,SEA,25,15,22,19,0,0,0,81,20000202
2000,MIN,28,21,18,26,0,0,0,93,WAS,27,27,25,24,0,0,0,103,20000202
2000,CHH,23,27,25,21,0,0,0,96,DAL,21,36,24,25,0,0,0,106,20000203
2000,PHI,32,20,27,27,0,0,0,106,HOU,39,22,23,25,0,0,0,109,20000203
2000,POR,29,17,18,24,0,0,0,88,NYK,28,17,28,25,0,0,0,98,20000203
2000,TOR,34,17,17,27,0,0,0,95,SAS,27,29,30,26,0,0,0,112,20000203
2000,MIL,27,25,25,25,0,0,0,102,UTA,22,29,24,24,0,0,0,99,20000203
2000,POR,24,19,21,33,0,0,0,97,ATL,14,19,27,30,0,0,0,90,20000204
2000,NJN,25,32,25,13,0,0,0,95,BOS,32,16,22,30,0,0,0,100,20000204
2000,CLE,18,26,22,30,0,0,0,96,DET,20,26,32,27,0,0,0,105,20000204
2000,DEN,20,30,23,28,0,0,0,101,GSW,24,23,27,29,0,0,0,103,20000204
2000,SAC,28,20,21,25,0,0,0,94,IND,30,19,21,34,0,0,0,104,20000204
2000,UTA,14,7,32,14,0,0,0,67,LAL,33,23,32,25,0,0,0,113,20000204
2000,WAS,27,30,18,17,0,0,0,92,MIA,27,15,29,28,0,0,0,99,20000204
2000,HOU,20,15,26,24,0,0,0,85,MIN,26,26,26,24,0,0,0,102,20000204
2000,PHO,21,24,21,20,0,0,0,86,SEA,33,21,15,25,0,0,0,94,20000204
2000,CHI,20,24,17,15,0,0,0,76,VAN,37,21,28,15,0,0,0,101,20000204
2000,ATL,26,18,33,25,0,0,0,102,CLE,16,32,23,23,0,0,0,94,20000205
2000,MIN,23,10,20,35,17,0,0,105,DEN,26,20,24,18,9,0,0,97,20000205
2000,DAL,30,37,31,21,0,0,0,119,LAC,22,29,23,32,0,0,0,106,20000205
2000,TOR,21,27,22,28,0,0,0,98,MIL,19,15,25,36,0,0,0,95,20000205
2000,IND,20,30,23,29,0,0,0,102,ORL,30,23,16,38,0,0,0,107,20000205
2000,CHH,25,30,23,32,0,0,0,110,WAS,23,30,22,27,0,0,0,102,20000205
2000,POR,25,17,29,29,0,0,0,100,BOS,26,19,25,24,0,0,0,94,20000206
2000,HOU,23,18,26,38,0,0,0,105,DET,26,20,34,29,0,0,0,109,20000206
2000,CHI,13,32,27,28,0,0,0,100,LAC,29,19,15,27,0,0,0,90,20000206
2000,GSW,27,24,24,15,0,0,0,90,NJN,28,26,31,25,0,0,0,110,20000206
2000,MIA,25,20,18,17,0,0,0,80,NYK,15,24,28,27,0,0,0,94,20000206
2000,SAC,24,37,12,35,0,0,0,108,PHI,36,26,26,31,0,0,0,119,20000206
2000,SEA,22,23,17,31,0,0,0,93,PHO,20,26,31,28,0,0,0,105,20000206
2000,SAS,27,24,21,18,0,0,0,90,UTA,27,17,32,17,0,0,0,93,20000206
2000,DAL,16,36,13,26,12,0,0,103,VAN,24,20,21,26,8,0,0,99,20000206
2000,NYK,25,22,16,22,0,0,0,85,CHH,29,22,26,18,0,0,0,95,20000207
2000,PHI,24,20,24,16,0,0,0,84,IND,23,39,24,23,0,0,0,109,20000207
2000,DEN,25,37,17,19,0,0,0,98,LAL,27,23,21,35,0,0,0,106,20000207
2000,POR,29,26,23,37,0,0,0,115,MIL,30,30,24,27,0,0,0,111,20000207
2000,GSW,18,26,24,32,0,0,0,100,ORL,33,33,26,28,0,0,0,120,20000207
2000,CLE,22,17,25,19,0,0,0,83,HOU,20,25,16,30,0,0,0,91,20000208
2000,BOS,23,30,21,39,0,0,0,113,NJN,46,28,21,36,0,0,0,131,20000208
2000,VAN,20,23,19,14,0,0,0,76,PHO,26,26,24,18,0,0,0,94,20000208
2000,CHI,25,22,18,15,0,0,0,80,SAC,35,27,34,23,0,0,0,119,20000208
2000,SEA,22,23,11,21,0,0,0,77,SAS,27,19,15,18,0,0,0,79,20000208
2000,ATL,20,28,14,26,0,0,0,88,TOR,31,23,31,24,0,0,0,109,20000208
2000,HOU,17,27,23,33,0,0,0,100,ATL,30,35,30,21,0,0,0,116,20000209
2000,IND,28,27,30,28,0,0,0,113,BOS,30,23,28,23,0,0,0,104,20000209
2000,CLE,29,16,17,33,0,0,0,95,CHH,30,20,22,31,0,0,0,103,20000209
2000,SEA,36,23,28,30,0,0,0,117,DAL,25,26,28,27,0,0,0,106,20000209
2000,SAS,37,27,24,18,0,0,0,106,DEN,22,19,30,26,0,0,0,97,20000209
2000,TOR,20,24,30,26,8,0,0,108,DET,26,30,22,22,15,0,0,115,20000209
2000,MIN,18,23,18,22,0,0,0,81,LAL,24,30,26,34,0,0,0,114,20000209
2000,GSW,30,28,19,23,0,0,0,100,MIA,28,31,29,27,0,0,0,115,20000209
2000,NYK,23,22,31,33,0,0,0,109,MIL,33,29,17,24,0,0,0,103,20000209
2000,WAS,27,25,20,24,0,0,0,96,ORL,32,21,33,21,0,0,0,107,20000209
2000,NJN,26,30,19,15,0,0,0,90,PHI,18,30,22,22,0,0,0,92,20000209
2000,LAC,38,17,24,21,0,0,0,100,POR,20,25,32,30,0,0,0,107,20000209
2000,CHI,32,21,17,16,0,0,0,86,UTA,32,31,28,22,0,0,0,113,20000209
2000,VAN,24,27,24,37,0,0,0,112,LAC,19,20,21,30,0,0,0,90,20000210
2000,MIN,25,14,18,28,0,0,0,85,PHO,27,32,19,23,0,0,0,101,20000210
2000,DEN,15,30,20,19,0,0,0,84,SAC,24,21,25,26,0,0,0,96,20000210
2000,NJN,12,26,24,24,0,0,0,86,ATL,26,20,28,29,0,0,0,103,20000215
2000,LAL,22,14,22,30,0,0,0,88,CHI,18,21,18,19,0,0,0,76,20000215
2000,SAS,22,24,15,20,0,0,0,81,CLE,21,22,27,22,0,0,0,92,20000215
2000,MIL,19,35,28,30,0,0,0,112,DAL,24,32,21,22,0,0,0,99,20000215
2000,POR,25,22,26,19,0,0,0,92,GSW,27,12,30,14,0,0,0,83,20000215
2000,DET,19,22,33,28,0,0,0,102,HOU,27,28,24,28,0,0,0,107,20000215
2000,LAC,26,18,17,27,0,0,0,88,MIA,30,29,28,20,0,0,0,107,20000215
2000,DEN,30,26,28,16,7,0,0,107,MIN,30,29,18,23,4,0,0,104,20000215
2000,CHH,20,27,22,26,0,0,0,95,PHI,25,23,25,20,0,0,0,93,20000215
2000,PHO,29,34,27,27,0,0,0,117,SAC,30,28,28,22,0,0,0,108,20000215
2000,WAS,19,19,27,20,0,0,0,85,SEA,37,27,33,17,0,0,0,114,20000215
2000,NYK,16,29,8,17,0,0,0,70,TOR,32,21,23,15,0,0,0,91,20000215
2000,BOS,22,11,33,35,0,0,0,101,UTA,14,28,30,27,0,0,0,99,20000215
2000,LAL,20,22,22,28,0,0,0,92,CHH,22,22,24,17,0,0,0,85,20000216
2000,TOR,24,24,33,20,0,0,0,101,IND,40,28,21,20,0,0,0,109,20000216
2000,MIN,21,27,18,23,0,0,0,89,NYK,27,16,23,27,0,0,0,93,20000216
2000,LAC,27,21,24,24,0,0,0,96,ORL,34,31,34,30,0,0,0,129,20000216
2000,GSW,22,22,25,26,0,0,0,95,POR,19,26,30,24,0,0,0,99,20000216
2000,WAS,21,32,19,15,0,0,0,87,VAN,26,15,24,27,0,0,0,92,20000216
2000,MIA,23,17,13,23,0,0,0,76,CHI,16,21,18,28,0,0,0,83,20000217
2000,DEN,28,25,30,18,0,0,0,101,CLE,27,32,35,25,0,0,0,119,20000217
2000,DET,34,28,18,17,0,0,0,97,DAL,27,28,24,27,0,0,0,106,20000217
2000,IND,27,20,25,20,0,0,0,92,MIL,19,21,25,25,0,0,0,90,20000217
2000,SAC,25,22,38,23,0,0,0,108,UTA,25,39,29,26,0,0,0,119,20000217
2000,LAC,24,25,23,15,0,0,0,87,CHH,33,27,24,31,0,0,0,115,20000218
2000,BOS,30,29,13,28,0,0,0,100,GSW,21,30,36,35,0,0,0,122,20000218
2000,VAN,25,20,18,28,0,0,0,91,MIN,21,41,22,19,0,0,0,103,20000218
2000,MIA,25,16,22,21,0,0,0,84,NJN,25,25,20,21,0,0,0,91,20000218
2000,LAL,31,22,15,20,19,0,0,107,ORL,22,24,20,22,11,0,0,99,20000218
2000,CLE,22,13,23,17,0,0,0,75,PHI,25,28,20,31,0,0,0,104,20000218
2000,ATL,21,14,13,25,0,0,0,73,PHO,15,22,26,22,0,0,0,85,20000218
2000,WAS,24,16,24,21,0,0,0,85,POR,24,23,16,30,0,0,0,93,20000218
2000,SEA,23,21,20,21,0,0,0,85,SAC,29,33,20,36,0,0,0,118,20000218
2000,HOU,24,17,20,31,0,0,0,92,SAS,33,24,33,26,0,0,0,116,20000218
2000,DEN,29,20,25,21,0,0,0,95,TOR,16,22,26,27,0,0,0,91,20000218
2000,LAC,18,20,20,14,0,0,0,72,CHI,23,17,14,20,0,0,0,74,20000219
2000,VAN,22,29,28,32,0,0,0,111,MIL,26,20,23,31,0,0,0,100,20000219
2000,IND,17,22,14,20,0,0,0,73,NYK,21,25,24,17,0,0,0,87,20000219
2000,BOS,28,21,22,20,0,0,0,91,SEA,23,21,25,25,0,0,0,94,20000219
2000,DET,23,25,25,14,0,0,0,87,UTA,29,19,23,20,0,0,0,91,20000219
2000,MIA,28,16,21,20,0,0,0,85,CHH,20,24,21,15,0,0,0,80,20000220
2000,WAS,23,24,32,24,0,0,0,103,GSW,29,32,28,23,0,0,0,112,20000220
2000,SAS,29,18,29,27,10,0,0,113,HOU,25,31,25,22,8,0,0,111,20000220
2000,NJN,26,20,30,15,0,0,0,91,MIN,24,18,23,24,0,0,0,89,20000220
2000,LAL,18,30,20,19,0,0,0,87,PHI,18,26,22,18,0,0,0,84,20000220
2000,POR,24,27,30,15,12,0,0,108,SAC,21,22,31,22,7,0,0,103,20000220
2000,DAL,30,23,25,22,0,0,0,100,TOR,30,28,16,22,0,0,0,96,20000220
2000,VAN,27,26,28,21,6,0,0,108,CLE,31,18,24,29,7,0,0,109,20000221
2000,SAC,31,31,21,25,9,0,0,117,DEN,26,23,28,31,15,0,0,123,20000221
2000,MIA,27,15,22,23,0,0,0,87,DET,29,18,28,20,0,0,0,95,20000221
2000,DAL,24,27,19,23,0,0,0,93,IND,27,17,24,26,0,0,0,94,20000221
2000,LAC,12,21,17,26,0,0,0,76,NYK,23,22,23,19,0,0,0,87,20000221
2000,BOS,23,20,24,25,0,0,0,92,POR,26,23,29,27,0,0,0,105,20000221
2000,PHO,24,18,23,33,0,0,0,98,SAS,20,23,28,18,0,0,0,89,20000221
2000,ATL,24,25,25,20,0,0,0,94,UTA,23,22,28,23,0,0,0,96,20000221
2000,HOU,20,24,30,23,0,0,0,97,CHH,27,26,22,27,0,0,0,102,20000222
2000,VAN,28,19,21,17,0,0,0,85,CHI,21,23,20,17,0,0,0,81,20000222
2000,GSW,19,23,23,24,0,0,0,89,MIN,30,27,22,33,0,0,0,112,20000222
2000,LAL,18,26,29,24,0,0,0,97,NJN,16,17,31,25,0,0,0,89,20000222
2000,DEN,16,9,12,30,0,0,0,67,PHO,29,21,25,11,0,0,0,86,20000222
2000,ORL,24,11,25,31,0,0,0,91,SEA,25,37,37,28,0,0,0,127,20000222
2000,MIL,23,22,28,28,0,0,0,101,WAS,32,40,31,23,0,0,0,126,20000222
2000,LAL,25,32,24,35,0,0,0,116,CLE,24,27,27,20,0,0,0,98,20000223
2000,IND,26,29,29,34,0,0,0,118,DET,30,26,26,29,0,0,0,111,20000223
2000,NJN,29,22,20,14,0,0,0,85,MIA,27,32,24,16,0,0,0,99,20000223
2000,GSW,20,27,21,23,0,0,0,91,MIL,23,30,18,15,0,0,0,86,20000223
2000,TOR,26,16,29,28,0,0,0,99,NYK,22,25,20,21,0,0,0,88,20000223
2000,LAC,14,17,29,18,0,0,0,78,PHI,25,22,23,24,0,0,0,94,20000223
2000,ATL,39,26,21,14,0,0,0,100,SAC,31,23,20,20,0,0,0,94,20000223
2000,SAS,10,28,18,16,0,0,0,72,CHH,16,16,19,19,0,0,0,70,20000224
2000,UTA,22,18,22,30,0,0,0,92,DAL,16,22,21,26,0,0,0,85,20000224
2000,DEN,34,27,24,21,0,0,0,106,HOU,21,16,27,33,0,0,0,97,20000224
2000,CHI,30,14,21,18,0,0,0,83,IND,22,23,26,29,0,0,0,100,20000224
2000,LAC,22,28,17,24,0,0,0,91,MIN,25,44,25,22,0,0,0,116,20000224
2000,ORL,26,15,16,35,0,0,0,92,POR,25,26,20,40,0,0,0,111,20000224
2000,BOS,25,27,24,25,0,0,0,101,VAN,11,23,20,23,0,0,0,77,20000224
2000,PHO,35,19,19,19,0,0,0,92,WAS,19,28,18,18,0,0,0,83,20000224
2000,SAS,22,22,19,28,0,0,0,91,CHI,23,15,20,20,0,0,0,78,20000225
2000,GSW,24,27,30,18,0,0,0,99,DET,38,28,35,30,0,0,0,131,20000225
2000,BOS,17,24,25,30,0,0,0,96,LAL,30,23,31,25,0,0,0,109,20000225
2000,CLE,18,21,23,20,0,0,0,82,MIA,28,20,15,24,0,0,0,87,20000225
2000,PHI,24,25,22,26,0,0,0,97,MIL,20,22,23,18,0,0,0,83,20000225
2000,PHO,23,19,20,17,0,0,0,79,NYK,19,20,21,24,0,0,0,84,20000225
2000,ATL,24,21,21,29,0,0,0,95,SEA,24,26,24,13,0,0,0,87,20000225
2000,MIN,35,24,24,24,0,0,0,107,TOR,27,19,14,25,0,0,0,85,20000225
2000,ORL,28,16,19,25,0,0,0,88,UTA,31,24,14,27,0,0,0,96,20000225
2000,DEN,28,18,29,21,0,0,0,96,DAL,27,24,26,21,0,0,0,98,20000226
2000,GSW,23,20,21,24,0,0,0,88,IND,25,27,24,28,0,0,0,104,20000226
2000,ATL,17,17,22,21,0,0,0,77,LAC,24,22,19,13,0,0,0,78,20000226
2000,CHH,30,20,31,12,0,0,0,93,NJN,29,27,26,22,0,0,0,104,20000226
2000,SAC,29,25,21,15,0,0,0,90,VAN,23,23,27,29,0,0,0,102,20000226
2000,MIA,22,30,23,23,0,0,0,98,WAS,23,31,20,14,0,0,0,88,20000226
2000,CHI,27,25,20,18,0,0,0,90,DET,32,21,23,17,0,0,0,93,20000227
2000,HOU,13,16,25,31,0,0,0,85,LAL,30,18,25,28,0,0,0,101,20000227
2000,ORL,29,29,13,24,0,0,0,95,MIL,26,29,19,28,0,0,0,102,20000227
2000,SAS,24,27,23,24,0,0,0,98,MIN,36,25,22,19,0,0,0,102,20000227
2000,PHI,28,23,21,16,0,0,0,88,NYK,21,26,23,19,0,0,0,89,20000227
2000,UTA,22,20,28,22,0,0,0,92,POR,24,28,26,23,0,0,0,101,20000227
2000,PHO,17,30,32,23,0,0,0,102,TOR,23,30,23,27,0,0,0,103,20000227
2000,DAL,26,21,32,29,0,0,0,108,BOS,29,34,22,15,0,0,0,100,20000228
2000,SEA,21,21,22,20,0,0,0,84,CHH,27,20,18,16,0,0,0,81,20000228
2000,ATL,22,19,20,14,0,0,0,75,GSW,14,19,25,22,0,0,0,80,20000228
2000,HOU,22,36,16,22,0,0,0,96,LAC,15,21,26,15,0,0,0,77,20000228
2000,NYK,33,10,17,16,0,0,0,76,MIA,17,20,24,24,0,0,0,85,20000228
2000,NJN,35,14,28,24,0,0,0,101,UTA,28,27,21,30,0,0,0,106,20000228
2000,PHO,29,25,30,16,0,0,0,100,CLE,26,22,25,20,0,0,0,93,20000229
2000,DET,15,34,31,25,0,0,0,105,IND,32,25,31,27,0,0,0,115,20000229
2000,CHH,26,25,21,20,0,0,0,92,MIN,26,18,24,19,0,0,0,87,20000229
2000,SEA,22,23,26,23,0,0,0,94,ORL,30,27,28,18,0,0,0,103,20000229
2000,DAL,28,14,17,28,0,0,0,87,PHI,29,24,27,26,0,0,0,106,20000229
2000,LAL,20,24,24,22,0,0,0,90,POR,22,15,25,25,0,0,0,87,20000229
2000,VAN,29,16,26,16,0,0,0,87,SAC,26,35,25,26,0,0,0,112,20000229
2000,MIA,12,20,20,17,0,0,0,69,SAS,24,21,29,19,0,0,0,93,20000229
2000,CHI,14,28,18,20,0,0,0,80,TOR,16,26,21,24,0,0,0,87,20000229
2000,WAS,31,20,23,28,0,0,0,102,ATL,23,27,13,20,0,0,0,83,20000301
2000,TOR,24,22,19,31,0,0,0,96,BOS,22,18,26,28,0,0,0,94,20000301
2000,NJN,24,26,19,25,0,0,0,94,DEN,21,14,21,25,0,0,0,81,20000301
2000,UTA,33,27,28,19,0,0,0,107,DET,32,16,20,26,0,0,0,94,20000301
2000,VAN,22,25,22,22,0,0,0,91,LAL,23,25,29,26,0,0,0,103,20000301
2000,CLE,35,20,33,15,11,0,0,114,CHI,29,27,31,16,7,0,0,110,20000302
2000,NJN,24,25,30,24,0,0,0,103,DAL,30,24,30,18,0,0,0,102,20000302
2000,SAC,19,28,26,26,0,0,0,99,HOU,30,29,16,27,0,0,0,102,20000302
2000,SEA,13,28,25,17,0,0,0,83,MIA,31,20,23,27,0,0,0,101,20000302
2000,MIL,29,26,17,22,0,0,0,94,NYK,21,28,36,24,0,0,0,109,20000302
2000,CHH,29,21,20,26,0,0,0,96,ORL,24,29,25,26,0,0,0,104,20000302
2000,IND,16,29,21,21,0,0,0,87,PHO,27,28,29,34,0,0,0,118,20000302
2000,MIN,31,22,29,26,0,0,0,108,SAS,29,27,21,25,0,0,0,102,20000302
2000,PHI,17,18,24,28,0,0,0,87,WAS,21,23,19,21,0,0,0,84,20000302
2000,NYK,19,20,20,11,0,0,0,70,ATL,18,28,18,19,0,0,0,83,20000303
2000,UTA,23,22,19,25,0,0,0,89,CHH,29,18,13,27,0,0,0,87,20000303
2000,GSW,24,22,21,21,0,0,0,88,DEN,34,20,34,34,0,0,0,122,20000303
2000,IND,16,23,27,26,0,0,0,92,LAL,30,26,24,27,0,0,0,107,20000303
2000,VAN,25,20,21,25,0,0,0,91,POR,35,17,23,26,0,0,0,101,20000303
2000,BOS,25,25,23,31,0,0,0,104,TOR,37,20,29,28,0,0,0,114,20000303
2000,SEA,18,31,21,23,0,0,0,93,ATL,21,17,18,25,0,0,0,81,20000304
2000,PHI,24,24,26,21,0,0,0,95,CHI,27,21,15,21,0,0,0,84,20000304
2000,NJN,18,21,26,21,6,0,0,92,HOU,27,20,17,22,13,0,0,99,20000304
2000,CLE,20,32,27,30,0,0,0,109,LAC,29,28,18,24,0,0,0,99,20000304
2000,MIN,24,22,29,16,0,0,0,91,MIL,21,25,16,22,0,0,0,84,20000304
2000,DAL,20,32,22,22,0,0,0,96,PHO,31,29,24,26,0,0,0,110,20000304
2000,SAC,25,26,22,19,16,0,0,108,SAS,28,17,23,24,11,0,0,103,20000304
2000,DET,26,16,31,21,0,0,0,94,WAS,24,20,29,27,0,0,0,100,20000304
2000,ORL,19,21,19,32,0,0,0,91,BOS,18,27,27,25,0,0,0,97,20000305
2000,CHI,21,28,25,20,0,0,0,94,CHH,26,24,23,27,0,0,0,100,20000305
2000,CLE,27,24,24,25,0,0,0,100,DEN,22,29,26,15,0,0,0,92,20000305
2000,IND,34,25,25,30,0,0,0,114,GSW,31,22,17,25,0,0,0,95,20000305
2000,MIA,23,17,20,20,0,0,0,80,LAL,37,20,15,21,0,0,0,93,20000305
2000,SEA,14,21,26,33,6,0,0,100,MIN,27,25,25,17,11,0,0,105,20000305
2000,UTA,21,17,24,26,0,0,0,88,NYK,14,16,25,24,0,0,0,79,20000305
2000,TOR,20,26,24,24,0,0,0,94,VAN,28,19,23,22,0,0,0,92,20000305
2000,LAL,24,32,36,31,0,0,0,123,LAC,29,26,25,23,0,0,0,103,20000306
2000,ATL,19,17,17,25,0,0,0,78,MIL,30,28,29,24,0,0,0,111,20000306
2000,MIA,25,15,29,23,0,0,0,92,PHO,35,27,14,24,0,0,0,100,20000306
2000,TOR,18,29,34,28,0,0,0,109,POR,24,28,18,20,0,0,0,90,20000306
2000,DAL,20,29,33,27,0,0,0,109,SAC,38,21,33,38,0,0,0,130,20000306
2000,NJN,27,32,22,23,0,0,0,104,SAS,28,29,27,22,0,0,0,106,20000306
2000,ORL,28,24,14,21,0,0,0,87,WAS,22,27,17,19,0,0,0,85,20000306
2000,ATL,22,26,19,15,0,0,0,82,CHI,20,30,16,23,0,0,0,89,20000307
2000,CHH,25,28,23,26,0,0,0,102,GSW,21,24,26,28,0,0,0,99,20000307
2000,PHO,32,19,29,28,0,0,0,108,HOU,25,30,25,21,0,0,0,101,20000307
2000,DEN,32,17,23,17,0,0,0,89,IND,18,29,24,19,0,0,0,90,20000307
2000,WAS,21,20,20,29,0,0,0,90,MIN,22,24,23,17,0,0,0,86,20000307
2000,VAN,16,21,29,20,0,0,0,86,NYK,26,27,32,26,0,0,0,111,20000307
2000,DAL,18,20,26,22,0,0,0,86,SEA,25,32,17,27,0,0,0,101,20000307
2000,CLE,31,24,17,23,0,0,0,95,UTA,36,26,24,27,0,0,0,113,20000307
2000,MIL,25,34,25,17,0,0,0,101,BOS,26,26,31,29,0,0,0,112,20000308
2000,DEN,38,28,17,33,0,0,0,116,DET,29,34,41,26,0,0,0,130,20000308
2000,TOR,18,25,26,26,0,0,0,95,LAC,21,30,24,19,0,0,0,94,20000308
2000,POR,25,22,23,33,0,0,0,103,NJN,30,31,33,21,0,0,0,115,20000308
2000,CHI,16,20,11,20,0,0,0,67,ORL,30,23,23,27,0,0,0,103,20000308
2000,VAN,34,22,15,19,0,0,0,90,PHI,26,27,30,24,0,0,0,107,20000308
2000,CHH,25,30,21,16,0,0,0,92,SAC,21,23,29,32,0,0,0,105,20000308
2000,NYK,26,27,20,29,11,0,0,113,WAS,30,22,27,23,16,0,0,118,20000308
2000,SAS,30,33,23,19,0,0,0,105,ATL,14,19,29,17,0,0,0,79,20000309
2000,MIN,23,23,23,31,0,0,0,100,DAL,21,16,21,21,0,0,0,79,20000309
2000,LAL,23,36,27,23,0,0,0,109,GSW,25,24,24,19,0,0,0,92,20000309
2000,POR,25,29,32,20,13,0,0,119,IND,33,27,29,17,21,0,0,127,20000309
2000,HOU,18,26,20,18,0,0,0,82,UTA,22,24,23,32,0,0,0,101,20000309
2000,CHI,20,21,16,17,0,0,0,74,BOS,31,31,23,19,0,0,0,104,20000310
2000,IND,25,21,26,23,0,0,0,95,CLE,33,18,19,22,0,0,0,92,20000310
2000,VAN,24,20,20,33,0,0,0,97,DET,31,29,16,35,0,0,0,111,20000310
2000,CHH,26,23,37,32,0,0,0,118,LAC,32,26,25,18,0,0,0,101,20000310
2000,DEN,27,19,24,18,0,0,0,88,MIA,32,23,20,21,0,0,0,96,20000310
2000,NJN,28,31,23,26,0,0,0,108,MIL,23,18,21,18,0,0,0,80,20000310
2000,NYK,21,15,24,22,0,0,0,82,PHI,11,32,17,17,0,0,0,77,20000310
2000,UTA,28,16,22,33,0,0,0,99,PHO,21,19,27,29,0,0,0,96,20000310
2000,TOR,26,22,20,20,0,0,0,88,SAC,31,27,27,18,0,0,0,103,20000310
2000,GSW,30,13,20,22,0,0,0,85,SEA,21,24,23,31,0,0,0,99,20000310
2000,SAS,23,29,15,28,11,0,0,106,WAS,25,21,25,24,4,0,0,99,20000310
2000,VAN,16,23,31,16,0,0,0,86,ATL,22,28,23,18,0,0,0,91,20000311
2000,PHO,25,26,26,22,0,0,0,99,DAL,24,26,23,31,0,0,0,104,20000311
2000,POR,21,23,20,35,0,0,0,99,DET,17,26,25,26,0,0,0,94,20000311
2000,MIN,25,28,25,22,0,0,0,100,HOU,17,28,20,21,0,0,0,86,20000311
2000,DEN,22,30,30,25,0,0,0,107,ORL,34,29,25,22,0,0,0,110,20000311
2000,PHI,21,17,19,20,0,0,0,77,BOS,31,21,21,20,0,0,0,93,20000312
2000,LAC,24,24,28,36,0,0,0,112,GSW,24,25,29,25,0,0,0,103,20000312
2000,MIA,25,28,26,26,0,0,0,105,IND,28,21,18,29,0,0,0,96,20000312
2000,SAC,31,28,27,20,0,0,0,106,LAL,22,30,22,35,0,0,0,109,20000312
2000,CLE,19,9,24,20,0,0,0,72,MIL,27,23,22,31,0,0,0,103,20000312
2000,ORL,30,19,23,19,0,0,0,91,NJN,28,33,31,37,0,0,0,129,20000312
2000,SAS,22,25,20,13,0,0,0,80,NYK,34,20,25,14,0,0,0,93,20000312
2000,TOR,31,19,28,21,0,0,0,99,SEA,17,30,25,25,0,0,0,97,20000312
2000,POR,27,28,17,30,0,0,0,102,WAS,17,26,22,21,0,0,0,86,20000312
2000,UTA,26,15,23,23,0,0,0,87,CHI,26,22,11,20,0,0,0,79,20000313
2000,LAL,25,34,29,30,0,0,0,118,DEN,23,27,32,26,0,0,0,108,20000313
2000,BOS,23,24,34,34,0,0,0,115,DET,32,40,22,30,0,0,0,124,20000313
2000,SEA,29,31,32,21,0,0,0,113,VAN,28,30,22,23,0,0,0,103,20000313
2000,PHI,24,23,15,27,9,0,0,98,CLE,28,22,16,23,8,0,0,97,20000314
2000,IND,18,28,15,29,0,0,0,90,DAL,36,24,26,25,0,0,0,111,20000314
2000,DEN,24,31,31,20,0,0,0,106,LAC,27,28,21,34,0,0,0,110,20000314
2000,MIL,32,35,12,25,0,0,0,104,MIA,23,31,26,28,0,0,0,108,20000314
2000,HOU,15,19,25,26,0,0,0,85,NYK,21,24,17,29,0,0,0,91,20000314
2000,WAS,27,28,11,32,0,0,0,98,ORL,30,32,21,24,0,0,0,107,20000314
2000,MIN,25,26,19,30,0,0,0,100,PHO,23,24,28,32,0,0,0,107,20000314
2000,SAC,23,26,19,23,0,0,0,91,POR,28,25,21,22,0,0,0,96,20000314
2000,ATL,22,25,19,13,0,0,0,79,SAS,25,19,20,30,0,0,0,94,20000314
2000,GSW,24,21,16,17,0,0,0,78,TOR,26,13,17,29,0,0,0,85,20000314
2000,IND,26,29,25,33,0,0,0,113,ATL,30,25,16,36,0,0,0,107,20000315
2000,GSW,27,22,24,31,0,0,0,104,BOS,25,26,41,29,0,0,0,121,20000315
2000,CHI,17,23,15,19,0,0,0,74,CHH,26,18,19,14,0,0,0,77,20000315
2000,ORL,29,22,18,22,0,0,0,91,DET,32,27,22,32,0,0,0,113,20000315
2000,LAC,19,14,21,24,0,0,0,78,SAC,27,28,19,24,0,0,0,98,20000315
2000,UTA,24,17,36,30,0,0,0,107,CLE,18,27,12,29,0,0,0,86,20000316
2000,PHI,21,22,16,18,0,0,0,77,MIA,29,21,21,21,0,0,0,92,20000316
2000,HOU,22,26,20,28,0,0,0,96,MIL,22,18,31,35,0,0,0,106,20000316
2000,MIN,16,25,30,25,0,0,0,96,POR,25,24,19,24,0,0,0,92,20000316
2000,DAL,34,25,33,18,0,0,0,110,SAS,22,23,24,19,0,0,0,88,20000316
2000,VAN,26,31,17,29,0,0,0,103,SEA,40,24,24,29,0,0,0,117,20000316
2000,LAL,20,25,28,29,0,0,0,102,WAS,36,28,18,27,0,0,0,109,20000316
2000,BOS,33,21,29,31,0,0,0,114,ATL,25,18,24,23,0,0,0,90,20000317
2000,NYK,30,26,34,28,0,0,0,118,CHH,22,23,24,30,0,0,0,99,20000317
2000,GSW,17,21,24,13,7,13,0,95,CHI,22,16,16,21,7,10,0,92,20000317
2000,LAC,21,29,23,14,0,0,0,87,DEN,30,24,33,27,0,0,0,114,20000317
2000,LAL,22,32,26,30,0,0,0,110,DET,19,23,19,21,0,0,0,82,20000317
2000,HOU,21,24,31,26,0,0,0,102,IND,35,31,24,21,0,0,0,111,20000317
2000,UTA,24,23,23,27,0,0,0,97,PHI,22,23,25,29,0,0,0,99,20000317
2000,ORL,24,23,23,21,0,0,0,91,TOR,25,22,20,28,0,0,0,95,20000317
2000,PHO,24,18,31,28,0,0,0,101,VAN,16,20,23,27,0,0,0,86,20000317
2000,MIA,32,15,12,21,12,0,0,92,CLE,26,18,17,19,10,0,0,90,20000318
2000,BOS,25,24,31,24,0,0,0,104,DAL,24,23,25,27,0,0,0,99,20000318
2000,CHH,23,28,26,22,0,0,0,99,IND,35,31,30,17,0,0,0,113,20000318
2000,SAC,8,33,27,36,0,0,0,104,LAC,24,21,23,15,0,0,0,83,20000318
2000,MIL,22,19,16,27,6,0,0,90,NJN,16,23,20,25,8,0,0,92,20000318
2000,DEN,14,25,20,23,0,0,0,82,SAS,24,23,26,29,0,0,0,102,20000318
2000,POR,26,28,23,20,0,0,0,97,SEA,19,39,17,21,0,0,0,96,20000318
2000,CHI,21,22,22,23,0,0,0,88,WAS,25,21,25,30,0,0,0,101,20000318
2000,DAL,30,23,21,15,0,0,0,89,ATL,24,23,22,16,0,0,0,85,20000319
2000,PHO,32,22,22,23,0,0,0,99,GSW,21,26,19,16,0,0,0,82,20000319
2000,MIL,22,24,12,24,0,0,0,82,MIN,28,24,41,16,0,0,0,109,20000319
2000,UTA,22,23,24,23,0,0,0,92,NJN,20,25,21,22,0,0,0,88,20000319
2000,LAL,23,20,26,23,0,0,0,92,NYK,24,20,14,27,0,0,0,85,20000319
2000,ORL,22,19,31,13,0,0,0,85,PHI,21,31,17,20,0,0,0,89,20000319
2000,HOU,27,13,36,22,0,0,0,98,TOR,28,24,20,28,0,0,0,100,20000319
2000,DET,23,30,26,22,0,0,0,101,VAN,36,21,19,23,0,0,0,99,20000319
2000,PHI,27,34,18,23,0,0,0,102,CHH,26,24,22,24,0,0,0,96,20000320
2000,ORL,21,19,24,17,7,0,0,88,CHI,11,19,33,18,5,0,0,86,20000320
2000,HOU,17,22,23,23,0,0,0,85,CLE,18,21,30,29,0,0,0,98,20000320
2000,WAS,24,31,23,27,0,0,0,105,LAC,25,14,31,23,0,0,0,93,20000320
2000,LAL,21,21,33,25,0,0,0,100,MIA,23,32,14,20,0,0,0,89,20000320
2000,BOS,30,22,31,23,0,0,0,106,PHO,28,34,22,26,0,0,0,110,20000320
2000,MIA,21,21,16,19,0,0,0,77,ATL,16,19,24,23,0,0,0,82,20000321
2000,SAS,25,35,10,26,0,0,0,96,DAL,21,22,22,32,0,0,0,97,20000321
2000,NYK,25,26,26,14,0,0,0,91,IND,22,29,20,24,0,0,0,95,20000321
2000,CLE,24,32,24,19,8,0,0,107,MIN,26,24,25,24,12,0,0,111,20000321
2000,WAS,32,20,23,11,0,0,0,86,SAC,23,32,17,26,0,0,0,98,20000321
2000,DET,23,28,20,29,0,0,0,100,SEA,28,23,18,21,0,0,0,90,20000321
2000,NJN,30,16,28,26,0,0,0,100,TOR,22,28,23,20,0,0,0,93,20000321
2000,DEN,21,26,25,11,0,0,0,83,UTA,28,21,18,29,0,0,0,96,20000321
2000,GSW,24,13,20,25,0,0,0,82,VAN,34,25,27,12,0,0,0,98,20000321
2000,MIN,25,30,25,29,0,0,0,109,BOS,26,30,29,21,0,0,0,106,20000322
2000,NJN,27,29,23,24,0,0,0,103,CHH,37,28,31,23,0,0,0,119,20000322
2000,GSW,19,26,27,24,0,0,0,96,LAL,37,28,31,23,0,0,0,119,20000322
2000,CHI,15,26,14,12,0,0,0,67,NYK,25,22,14,17,0,0,0,78,20000322
2000,ATL,22,33,15,20,0,0,0,90,ORL,32,23,25,23,0,0,0,103,20000322
2000,TOR,20,16,34,23,0,0,0,93,PHI,18,25,35,28,0,0,0,106,20000322
2000,SAC,25,27,22,19,0,0,0,93,PHO,34,16,38,26,0,0,0,114,20000322
2000,DET,24,24,28,28,0,0,0,104,POR,33,28,20,14,0,0,0,95,20000322
2000,LAC,21,21,23,13,0,0,0,78,SAS,23,30,25,25,0,0,0,103,20000322
2000,CLE,22,34,18,30,0,0,0,104,DAL,14,19,30,35,0,0,0,98,20000323
2000,WAS,26,30,23,21,0,0,0,100,DEN,21,21,19,25,0,0,0,86,20000323
2000,LAC,22,18,30,25,0,0,0,95,HOU,23,23,35,29,0,0,0,110,20000323
2000,MIL,33,29,23,20,0,0,0,105,IND,19,21,28,16,0,0,0,84,20000323
2000,DEN,19,16,17,16,0,0,0,68,CHI,19,16,17,18,0,0,0,70,20000324
2000,POR,30,24,23,19,0,0,0,96,GSW,19,25,18,21,0,0,0,83,20000324
2000,PHO,23,22,26,30,0,0,0,101,LAL,29,22,28,30,0,0,0,109,20000324
2000,MIA,23,22,26,28,0,0,0,99,MIL,20,18,30,19,0,0,0,87,20000324
2000,MIN,30,26,29,23,8,0,0,116,NJN,21,27,30,30,7,0,0,115,20000324
2000,ATL,23,26,17,17,0,0,0,83,NYK,22,30,26,17,0,0,0,95,20000324
2000,HOU,20,24,20,32,0,0,0,96,ORL,27,31,23,31,0,0,0,112,20000324
2000,BOS,18,23,29,27,10,8,0,115,PHI,22,17,34,24,10,10,0,117,20000324
2000,DET,24,28,27,24,0,0,0,103,SAC,28,26,30,29,0,0,0,113,20000324
2000,UTA,26,16,23,33,0,0,0,98,SEA,20,25,28,22,0,0,0,95,20000324
2000,CHH,18,30,34,20,0,0,0,102,TOR,17,26,23,18,0,0,0,84,20000324
2000,CHH,20,18,24,24,0,0,0,86,ATL,22,13,19,16,0,0,0,70,20000325
2000,WAS,23,24,20,26,0,0,0,93,DAL,21,18,23,24,0,0,0,86,20000325
2000,DET,35,33,30,28,0,0,0,126,LAC,25,27,31,24,0,0,0,107,20000325
2000,CLE,29,20,12,15,0,0,0,76,SAS,21,27,23,25,0,0,0,96,20000325
2000,UTA,17,17,23,27,0,0,0,84,VAN,15,19,24,17,0,0,0,75,20000325
2000,CHI,13,21,19,25,0,0,0,78,HOU,27,33,42,21,0,0,0,123,20000326
2000,PHI,36,26,27,22,0,0,0,111,IND,23,22,19,37,0,0,0,101,20000326
2000,BOS,19,21,23,21,0,0,0,84,MIL,25,28,21,25,0,0,0,99,20000326
2000,TOR,16,20,23,28,14,0,0,101,MIN,23,21,20,23,19,0,0,106,20000326
2000,DEN,37,23,17,35,0,0,0,112,NJN,27,29,30,24,0,0,0,110,20000326
2000,MIA,27,23,12,7,0,0,0,69,ORL,22,27,23,22,0,0,0,94,20000326
2000,GSW,23,17,20,22,0,0,0,82,PHO,30,33,12,15,0,0,0,90,20000326
2000,NYK,25,31,12,25,0,0,0,93,POR,26,17,17,29,0,0,0,89,20000326
2000,LAL,18,29,21,22,0,0,0,90,SAC,25,25,23,16,0,0,0,89,20000326
2000,SAS,18,24,19,29,0,0,0,90,SEA,22,22,22,16,0,0,0,82,20000327
2000,DAL,25,30,33,25,0,0,0,113,UTA,22,26,28,29,0,0,0,105,20000327
2000,DEN,33,23,32,23,0,0,0,111,ATL,33,32,26,25,0,0,0,116,20000328
2000,TOR,22,18,26,33,0,0,0,99,CLE,24,27,28,17,0,0,0,96,20000328
2000,GSW,19,20,27,20,0,0,0,86,HOU,32,32,27,30,0,0,0,121,20000328
2000,DAL,32,19,31,30,0,0,0,112,LAC,25,30,23,24,0,0,0,102,20000328
2000,PHO,12,16,22,28,0,0,0,78,MIA,30,24,13,14,0,0,0,81,20000328
2000,PHI,30,29,23,20,0,0,0,102,MIN,24,25,23,28,0,0,0,100,20000328
2000,IND,21,22,27,36,0,0,0,106,NJN,27,21,37,26,0,0,0,111,20000328
2000,BOS,32,20,11,24,0,0,0,87,ORL,24,26,40,32,0,0,0,122,20000328
2000,SAS,20,23,18,28,0,0,0,89,POR,15,25,26,19,0,0,0,85,20000328
2000,NYK,34,22,20,19,0,0,0,95,SAC,30,27,25,21,0,0,0,103,20000328
2000,CLE,22,22,16,26,0,0,0,86,CHI,24,13,18,26,0,0,0,81,20000329
2000,CHH,19,24,26,29,0,0,0,98,DET,25,22,24,20,0,0,0,91,20000329
2000,NYK,30,29,25,26,0,0,0,110,SEA,30,19,22,24,0,0,0,95,20000329
2000,PHI,15,26,21,22,0,0,0,84,UTA,27,18,23,30,0,0,0,98,20000329
2000,LAL,31,29,26,22,0,0,0,108,VAN,30,16,26,27,0,0,0,99,20000329
2000,DEN,23,15,35,28,0,0,0,101,WAS,27,20,17,29,0,0,0,93,20000329
2000,PHO,26,36,29,27,0,0,0,118,ATL,22,14,17,21,0,0,0,74,20000330
2000,MIL,21,26,33,24,0,0,0,104,LAC,18,24,20,23,0,0,0,85,20000330
2000,CHI,19,20,22,19,0,0,0,80,MIA,29,24,23,29,0,0,0,105,20000330
2000,HOU,28,21,22,19,0,0,0,90,MIN,35,30,24,33,0,0,0,122,20000330
2000,TOR,24,15,34,30,0,0,0,103,NJN,28,30,19,30,0,0,0,107,20000330
2000,DAL,19,26,24,16,0,0,0,85,POR,25,29,23,19,0,0,0,96,20000330
2000,GSW,31,21,13,25,0,0,0,90,SAS,26,27,23,26,0,0,0,102,20000330
2000,WAS,21,36,25,22,0,0,0,104,BOS,34,28,21,19,0,0,0,102,20000331
2000,TOR,23,34,18,19,7,0,0,101,CHH,27,30,21,16,16,0,0,110,20000331
2000,PHO,24,27,21,26,0,0,0,98,DET,21,23,22,31,0,0,0,97,20000331
2000,MIN,25,26,12,22,0,0,0,85,IND,23,34,20,32,0,0,0,109,20000331
2000,PHI,21,25,23,19,0,0,0,88,LAL,25,26,27,22,0,0,0,100,20000331
2000,NJN,23,27,23,24,0,0,0,97,ORL,27,33,17,26,0,0,0,103,20000331
2000,SAC,22,27,30,29,0,0,0,108,SEA,36,33,26,28,0,0,0,123,20000331
2000,GSW,24,27,27,19,0,0,0,97,UTA,35,28,30,21,0,0,0,114,20000331
2000,NYK,12,26,27,24,0,0,0,89,VAN,20,19,19,25,0,0,0,83,20000331
2000,CHH,21,18,32,19,0,0,0,90,CHI,20,23,17,27,0,0,0,87,20000401
2000,BOS,22,28,26,27,0,0,0,103,CLE,24,23,26,36,0,0,0,109,20000401
2000,UTA,21,18,23,30,0,0,0,92,DEN,27,20,34,31,0,0,0,112,20000401
2000,ATL,29,18,23,23,0,0,0,93,HOU,31,34,21,29,0,0,0,115,20000401
2000,MIL,18,20,16,25,0,0,0,79,POR,31,34,21,27,0,0,0,113,20000401
2000,CHI,20,23,16,24,0,0,0,83,CLE,16,24,22,12,0,0,0,74,20000402
2000,MIL,33,30,27,27,0,0,0,117,GSW,26,28,28,31,0,0,0,113,20000402
2000,NYK,21,19,20,22,0,0,0,82,LAL,28,30,17,31,0,0,0,106,20000402
2000,SAS,21,23,26,14,0,0,0,84,MIA,30,23,19,16,0,0,0,88,20000402
2000,PHO,17,20,20,30,0,0,0,87,MIN,30,16,22,18,0,0,0,86,20000402
2000,DET,27,33,29,24,0,0,0,113,NJN,24,24,23,21,0,0,0,92,20000402
2000,SEA,18,25,18,21,0,0,0,82,POR,19,26,22,28,0,0,0,95,20000402
2000,PHI,27,24,22,22,0,0,0,95,SAC,25,31,34,27,0,0,0,117,20000402
2000,IND,26,28,23,27,0,0,0,104,TOR,20,19,22,22,0,0,0,83,20000402
2000,DAL,18,24,32,26,0,0,0,100,VAN,22,11,25,28,0,0,0,86,20000402
2000,BOS,23,30,33,19,0,0,0,105,CHH,27,27,28,30,0,0,0,112,20000404
2000,SAC,25,21,29,27,0,0,0,102,DAL,29,29,22,25,0,0,0,105,20000404
2000,UTA,29,22,25,27,0,0,0,103,LAC,20,30,32,11,0,0,0,93,20000404
2000,CLE,33,15,17,20,0,0,0,85,MIA,25,31,32,23,0,0,0,111,20000404
2000,CHI,18,15,17,23,0,0,0,73,MIL,24,27,27,14,0,0,0,92,20000404
2000,ATL,18,25,15,15,3,0,0,76,MIN,17,23,17,16,13,0,0,86,20000404
2000,SAS,18,35,17,27,0,0,0,97,ORL,29,22,27,29,0,0,0,107,20000404
2000,LAL,17,23,27,17,0,0,0,84,PHO,23,16,27,17,0,0,0,83,20000404
2000,DEN,24,27,25,17,0,0,0,93,SEA,31,29,25,21,0,0,0,106,20000404
2000,DET,28,30,22,24,0,0,0,104,TOR,29,21,20,18,0,0,0,88,20000404
2000,HOU,28,26,23,23,0,0,0,100,VAN,20,26,22,34,0,0,0,102,20000404
2000,NJN,31,23,18,21,0,0,0,93,WAS,21,27,29,25,0,0,0,102,20000404
2000,BOS,12,38,21,35,0,0,0,106,DET,23,23,34,31,0,0,0,111,20000405
2000,LAL,21,26,30,34,0,0,0,111,GSW,24,27,24,29,0,0,0,104,20000405
2000,NJN,20,23,22,36,0,0,0,101,IND,25,24,30,26,0,0,0,105,20000405
2000,ATL,22,31,13,20,0,0,0,86,PHI,32,24,25,26,0,0,0,107,20000405
2000,HOU,22,28,35,33,0,0,0,118,POR,25,28,27,25,0,0,0,105,20000405
2000,SAC,26,21,29,32,0,0,0,108,SAS,16,42,18,22,0,0,0,98,20000405
2000,MIL,23,19,22,24,0,0,0,88,CHI,27,19,24,20,0,0,0,90,20000406
2000,DAL,35,23,21,27,10,0,0,116,DEN,20,33,24,29,9,0,0,115,20000406
2000,MIN,34,27,25,26,0,0,0,112,LAC,24,23,14,29,0,0,0,90,20000406
2000,CHH,17,17,15,21,0,0,0,70,MIA,20,21,13,22,0,0,0,76,20000406
2000,WAS,22,17,24,29,0,0,0,92,NYK,23,33,22,23,0,0,0,101,20000406
2000,PHO,19,26,12,28,0,0,0,85,UTA,24,26,27,28,0,0,0,105,20000406
2000,POR,18,23,28,18,0,0,0,87,VAN,32,24,19,14,0,0,0,89,20000406
2000,TOR,28,17,33,26,0,0,0,104,ATL,25,22,22,15,0,0,0,84,20000407
2000,PHI,23,32,23,24,0,0,0,102,BOS,34,26,20,17,0,0,0,97,20000407
2000,DET,28,28,26,15,0,0,0,97,CHH,22,16,25,19,0,0,0,82,20000407
2000,UTA,25,30,29,21,0,0,0,105,GSW,16,21,24,23,0,0,0,84,20000407
2000,CLE,28,18,23,25,0,0,0,94,IND,24,34,21,16,0,0,0,95,20000407
2000,MIA,33,26,29,15,0,0,0,103,NJN,19,20,20,26,0,0,0,85,20000407
2000,NYK,19,28,19,30,0,0,0,96,ORL,12,27,24,26,0,0,0,89,20000407
2000,MIN,25,13,33,24,0,0,0,95,SAC,21,26,20,25,0,0,0,92,20000407
2000,HOU,32,22,37,28,0,0,0,119,SEA,32,28,30,26,0,0,0,116,20000407
2000,TOR,29,26,25,18,0,0,0,98,CHI,20,13,28,18,0,0,0,79,20000408
2000,DET,34,19,21,24,0,0,0,98,CLE,34,21,31,31,0,0,0,117,20000408
2000,LAC,19,21,23,33,0,0,0,96,DAL,25,22,25,26,0,0,0,98,20000408
2000,SEA,30,18,26,23,0,0,0,97,DEN,18,27,32,28,0,0,0,105,20000408
2000,SAS,25,29,30,14,0,0,0,98,LAL,25,16,26,13,0,0,0,80,20000408
2000,NJN,21,29,20,31,0,0,0,101,MIL,32,29,28,20,0,0,0,109,20000408
2000,VAN,26,28,9,22,0,0,0,85,POR,25,22,29,22,0,0,0,98,20000408
2000,ATL,16,26,21,35,0,0,0,98,WAS,32,30,19,27,0,0,0,108,20000408
2000,IND,18,22,27,13,0,0,0,80,CHH,27,30,20,19,0,0,0,96,20000409
2000,DEN,18,29,30,26,0,0,0,103,GSW,41,25,22,29,0,0,0,117,20000409
2000,UTA,18,17,32,23,0,0,0,90,HOU,23,22,31,23,0,0,0,99,20000409
2000,NYK,28,21,23,16,6,0,0,94,MIA,21,25,18,24,7,0,0,95,20000409
2000,PHI,14,25,19,22,0,0,0,80,ORL,24,24,23,21,0,0,0,92,20000409
2000,PHO,27,25,26,24,0,0,0,102,SAC,31,15,21,30,0,0,0,97,20000409
2000,SAS,24,33,30,20,0,0,0,107,VAN,29,26,16,28,0,0,0,99,20000409
2000,ATL,25,24,19,26,0,0,0,94,BOS,18,26,28,27,0,0,0,99,20000410
2000,SEA,22,18,20,34,9,0,0,103,LAL,23,16,34,21,12,0,0,106,20000410
2000,ORL,27,13,23,24,0,0,0,87,MIL,33,23,26,22,0,0,0,104,20000410
2000,DET,23,26,25,26,0,0,0,100,MIN,31,21,17,33,0,0,0,102,20000410
2000,IND,21,19,24,17,0,0,0,81,NYK,24,20,19,20,0,0,0,83,20000410
2000,MIA,22,15,21,22,0,0,0,80,PHI,18,27,30,21,0,0,0,96,20000410
2000,CLE,28,19,26,30,0,0,0,103,TOR,32,29,29,22,0,0,0,112,20000410
2000,POR,20,25,21,24,0,0,0,90,UTA,18,18,22,28,0,0,0,86,20000410
2000,CHH,30,25,24,28,0,0,0,107,WAS,25,24,26,30,0,0,0,105,20000410
2000,NJN,22,23,22,26,0,0,0,93,CHI,24,30,27,19,0,0,0,100,20000411
2000,POR,22,17,15,27,0,0,0,81,DAL,27,16,21,28,0,0,0,92,20000411
2000,HOU,22,29,23,29,0,0,0,103,DEN,16,29,33,15,0,0,0,93,20000411
2000,VAN,34,20,23,20,0,0,0,97,GSW,30,23,25,31,0,0,0,109,20000411
2000,PHO,15,28,22,30,0,0,0,95,LAC,22,18,25,23,0,0,0,88,20000411
2000,SAS,22,27,24,11,14,0,0,98,SAC,30,18,23,13,8,0,0,92,20000411
2000,ORL,29,24,23,15,0,0,0,91,BOS,26,23,24,22,0,0,0,95,20000412
2000,ATL,21,24,16,26,0,0,0,87,CHH,20,29,27,43,0,0,0,119,20000412
2000,MIL,27,26,29,19,0,0,0,101,CLE,31,31,18,20,0,0,0,100,20000412
2000,MIA,15,23,22,13,0,0,0,73,DET,26,27,24,13,0,0,0,90,20000412
2000,TOR,16,27,14,16,0,0,0,73,IND,19,21,14,23,0,0,0,77,20000412
2000,NJN,29,23,15,14,8,0,0,89,NYK,22,18,22,19,10,0,0,91,20000412
2000,WAS,15,28,19,22,0,0,0,84,PHI,21,26,24,22,0,0,0,93,20000412
2000,VAN,32,28,26,23,7,0,0,116,PHO,39,29,20,21,13,0,0,122,20000412
2000,MIN,16,23,24,20,0,0,0,83,SEA,27,27,20,36,0,0,0,110,20000412
2000,LAC,23,10,32,28,0,0,0,93,UTA,33,17,28,24,0,0,0,102,20000412
2000,WAS,24,34,30,21,0,0,0,109,CHI,19,33,28,23,0,0,0,103,20000413
2000,DAL,22,20,33,27,0,0,0,102,HOU,23,29,25,34,0,0,0,111,20000413
2000,GSW,26,22,22,37,0,0,0,107,SAC,32,33,26,39,0,0,0,130,20000413
2000,POR,25,30,22,16,0,0,0,93,SAS,20,19,20,18,0,0,0,77,20000413
2000,PHI,25,28,24,27,0,0,0,104,ATL,25,20,19,28,0,0,0,92,20000414
2000,CHI,15,27,25,24,0,0,0,91,BOS,27,24,35,20,0,0,0,106,20000414
2000,SEA,23,27,23,30,0,0,0,103,DAL,35,38,32,12,0,0,0,117,20000414
2000,GSW,24,31,21,21,0,0,0,97,DEN,23,28,23,31,0,0,0,105,20000414
2000,SAC,39,26,21,28,0,0,0,114,LAL,28,29,37,27,0,0,0,121,20000414
2000,IND,28,30,23,24,0,0,0,105,MIA,33,22,20,26,0,0,0,101,20000414
2000,CHH,20,26,31,16,16,0,0,109,MIL,36,20,11,26,13,0,0,106,20000414
2000,ORL,24,21,25,26,0,0,0,96,NJN,20,19,28,21,0,0,0,88,20000414
2000,LAC,23,17,24,24,0,0,0,88,PHO,29,23,28,32,0,0,0,112,20000414
2000,NYK,11,16,20,24,0,0,0,71,TOR,28,19,22,17,0,0,0,86,20000414
2000,MIN,27,25,16,12,8,16,0,104,VAN,21,21,22,16,8,6,0,94,20000414
2000,NYK,22,23,25,26,0,0,0,96,CLE,31,28,26,21,0,0,0,106,20000415
2000,DEN,29,21,28,20,17,0,0,115,LAC,27,28,24,19,16,0,0,114,20000415
2000,DET,24,23,19,28,0,0,0,94,PHI,24,26,27,23,0,0,0,100,20000415
2000,UTA,23,17,19,24,0,0,0,83,SAS,23,28,24,31,0,0,0,106,20000415
2000,MIL,31,27,27,25,10,0,0,120,WAS,37,28,24,21,6,0,0,116,20000415
2000,CLE,30,19,18,34,0,0,0,101,ATL,25,22,34,23,0,0,0,104,20000416
2000,CHH,24,31,28,22,0,0,0,105,BOS,22,24,27,29,0,0,0,102,20000416
2000,VAN,23,25,26,32,0,0,0,106,DAL,20,32,26,36,0,0,0,114,20000416
2000,IND,33,28,26,25,0,0,0,112,DET,22,28,28,23,0,0,0,101,20000416
2000,SEA,38,22,28,33,0,0,0,121,HOU,19,35,21,37,0,0,0,112,20000416
2000,MIN,25,18,30,22,0,0,0,95,LAL,23,26,25,27,0,0,0,101,20000416
2000,ORL,19,28,20,17,0,0,0,84,MIA,24,22,25,24,0,0,0,95,20000416
2000,UTA,19,21,28,28,0,0,0,96,PHO,21,19,14,28,0,0,0,82,20000416
2000,SAC,20,30,27,18,0,0,0,95,POR,32,16,29,25,0,0,0,102,20000416
2000,CHI,25,26,16,17,0,0,0,84,TOR,14,27,20,24,0,0,0,85,20000416
2000,MIN,17,25,36,23,0,0,0,101,GSW,28,19,22,27,0,0,0,96,20000417
2000,MIL,24,19,25,17,0,0,0,85,ORL,9,27,28,19,0,0,0,83,20000417
2000,IND,33,19,16,24,0,0,0,92,PHI,19,27,32,12,0,0,0,90,20000417
2000,VAN,25,28,25,15,0,0,0,93,SAS,28,22,22,28,0,0,0,100,20000417
2000,NJN,21,30,21,27,6,4,0,109,ATL,21,22,34,22,6,6,0,111,20000418
2000,PHI,19,25,32,17,0,0,0,93,CHI,24,18,13,34,0,0,0,89,20000418
2000,CHH,26,24,34,19,0,0,0,103,CLE,22,27,17,22,0,0,0,88,20000418
2000,LAL,29,30,16,27,0,0,0,102,DAL,27,30,23,32,0,0,0,112,20000418
2000,UTA,22,32,20,22,8,0,0,104,DEN,26,25,26,19,9,0,0,105,20000418
2000,POR,36,21,31,28,0,0,0,116,LAC,20,25,25,30,0,0,0,100,20000418
2000,TOR,12,29,18,14,0,0,0,73,MIA,17,28,26,26,0,0,0,97,20000418
2000,DET,24,23,15,26,0,0,0,88,NYK,23,24,28,25,0,0,0,100,20000418
2000,HOU,26,25,23,33,0,0,0,107,PHO,18,20,33,27,0,0,0,98,20000418
2000,SEA,33,23,25,26,12,0,0,119,SAC,25,32,18,32,5,0,0,112,20000418
2000,BOS,28,27,28,31,0,0,0,114,WAS,19,21,21,20,0,0,0,81,20000418
2000,NYK,23,33,11,18,0,0,0,85,BOS,29,26,29,28,0,0,0,112,20000419
2000,MIA,15,16,22,20,0,0,0,73,CHH,18,26,15,24,0,0,0,83,20000419
2000,CHI,25,22,26,18,0,0,0,91,DET,24,33,30,25,0,0,0,112,20000419
2000,PHO,17,28,27,27,0,0,0,99,GSW,23,23,23,19,0,0,0,88,20000419
2000,VAN,24,26,26,20,0,0,0,96,HOU,22,24,20,26,0,0,0,92,20000419
2000,ATL,24,22,22,24,0,0,0,92,IND,28,23,30,30,0,0,0,111,20000419
2000,WAS,19,32,29,25,0,0,0,105,MIL,36,23,22,29,0,0,0,110,20000419
2000,DAL,31,31,20,31,0,0,0,113,MIN,29,30,28,20,0,0,0,107,20000419
2000,CLE,30,33,19,29,0,0,0,111,NJN,34,27,22,25,0,0,0,108,20000419
2000,TOR,28,18,26,28,0,0,0,100,ORL,30,22,30,24,0,0,0,106,20000419
2000,DEN,31,24,20,21,0,0,0,96,POR,27,32,18,18,0,0,0,95,20000419
2000,LAL,22,26,26,15,9,0,0,98,SAS,21,19,21,28,14,0,0,103,20000419
2000,LAC,34,20,28,32,0,0,0,114,SEA,36,26,19,25,0,0,0,106,20000419
2000,SAC,27,22,26,11,0,0,0,86,UTA,29,18,27,21,0,0,0,95,20000419
2000,PHI,17,24,34,17,0,0,0,92,CHH,22,22,22,16,0,0,0,82,20000422
2000,DET,18,22,18,27,0,0,0,85,MIA,24,20,24,27,0,0,0,95,20000422
2000,PHO,13,28,15,16,0,0,0,72,SAS,17,18,18,17,0,0,0,70,20000422
2000,SEA,25,24,19,25,0,0,0,93,UTA,22,30,31,21,0,0,0,104,20000422
2000,MIL,18,16,28,23,0,0,0,85,IND,28,17,17,26,0,0,0,88,20000423
2000,SAC,28,27,24,28,0,0,0,107,LAL,34,31,26,26,0,0,0,117,20000423
2000,TOR,12,25,25,26,0,0,0,88,NYK,27,19,25,21,0,0,0,92,20000423
2000,MIN,22,25,28,13,0,0,0,88,POR,33,15,21,22,0,0,0,91,20000423
2000,PHI,20,27,27,17,7,0,0,98,CHH,24,25,22,20,17,0,0,108,20000424
2000,SEA,19,21,19,28,0,0,0,87,UTA,25,32,29,15,0,0,0,101,20000424
2000,DET,19,26,23,14,0,0,0,82,MIA,24,20,21,19,0,0,0,84,20000425
2000,PHO,20,17,14,19,0,0,0,70,SAS,24,27,9,25,0,0,0,85,20000425
2000,TOR,26,15,26,16,0,0,0,83,NYK,15,19,21,29,0,0,0,84,20000426
2000,MIN,24,17,17,24,0,0,0,82,POR,19,21,27,19,0,0,0,86,20000426
2000,MIL,35,26,27,16,0,0,0,104,IND,19,19,26,27,0,0,0,91,20000427
2000,SAC,24,17,23,25,0,0,0,89,LAL,35,21,27,30,0,0,0,113,20000427
2000,CHH,18,22,17,19,0,0,0,76,PHI,18,20,19,24,0,0,0,81,20000428
2000,MIA,18,24,28,21,0,0,0,91,DET,22,15,15,20,0,0,0,72,20000429
2000,IND,23,28,30,28,0,0,0,109,MIL,26,32,20,18,0,0,0,96,20000429
2000,SAS,27,22,30,15,0,0,0,94,PHO,21,29,19,32,0,0,0,101,20000429
2000,UTA,16,18,18,26,0,0,0,78,SEA,20,20,24,25,0,0,0,89,20000429
2000,POR,20,20,28,19,0,0,0,87,MIN,24,23,21,26,0,0,0,94,20000430
2000,LAL,28,23,20,20,0,0,0,91,SAC,22,24,20,33,0,0,0,99,20000430
2000,NYK,21,25,15,26,0,0,0,87,TOR,20,25,18,17,0,0,0,80,20000430
2000,IND,21,16,25,25,0,0,0,87,MIL,33,31,24,12,0,0,0,100,20000501
2000,CHH,25,25,29,20,0,0,0,99,PHI,30,24,21,30,0,0,0,105,20000501
2000,POR,18,18,21,28,0,0,0,85,MIN,22,18,24,13,0,0,0,77,20000502
2000,SAS,21,16,19,22,0,0,0,78,PHO,15,27,26,21,0,0,0,89,20000502
2000,LAL,18,27,21,22,0,0,0,88,SAC,27,29,17,28,0,0,0,101,20000502
2000,UTA,29,7,35,22,0,0,0,93,SEA,26,24,28,26,0,0,0,104,20000503
2000,MIL,30,17,23,25,0,0,0,95,IND,25,21,25,25,0,0,0,96,20000504
2000,SAC,20,24,18,24,0,0,0,86,LAL,31,28,30,24,0,0,0,113,20000505
2000,SEA,18,31,21,23,0,0,0,93,UTA,23,30,26,17,0,0,0,96,20000505
2000,PHI,15,22,32,22,0,0,0,91,IND,34,20,24,30,0,0,0,108,20000506
2000,PHO,18,23,19,17,0,0,0,77,LAL,18,28,29,30,0,0,0,105,20000507
2000,NYK,19,26,23,15,0,0,0,83,MIA,25,21,22,19,0,0,0,87,20000507
2000,UTA,15,19,27,14,0,0,0,75,POR,23,21,21,29,0,0,0,94,20000507
2000,PHI,26,14,23,34,0,0,0,97,IND,31,24,29,19,0,0,0,103,20000508
2000,NYK,23,15,21,23,0,0,0,82,MIA,15,19,16,26,0,0,0,76,20000509
2000,UTA,16,19,23,27,0,0,0,85,POR,24,32,24,23,0,0,0,103,20000509
2000,PHO,26,18,21,31,0,0,0,96,LAL,24,26,24,23,0,0,0,97,20000510
2000,IND,22,24,19,32,0,0,0,97,PHI,23,24,23,19,0,0,0,89,20000510
2000,POR,30,25,20,28,0,0,0,103,UTA,23,26,21,14,0,0,0,84,20000511
2000,MIA,25,11,19,13,9,0,0,77,NYK,21,16,19,12,8,0,0,76,20000512
2000,LAL,18,34,23,30,0,0,0,105,PHO,28,22,26,23,0,0,0,99,20000512
2000,IND,18,29,24,19,0,0,0,90,PHI,33,25,21,13,0,0,0,92,20000513
2000,MIA,21,19,17,26,0,0,0,83,NYK,26,16,24,25,0,0,0,91,20000514
2000,LAL,24,24,23,27,0,0,0,98,PHO,38,33,22,24,0,0,0,117,20000514
2000,POR,26,23,20,16,0,0,0,85,UTA,31,23,21,13,0,0,0,88,20000514
2000,PHI,29,31,23,24,0,0,0,107,IND,16,21,25,24,0,0,0,86,20000515
2000,PHO,14,9,17,25,0,0,0,65,LAL,21,28,19,19,0,0,0,87,20000516
2000,UTA,21,20,22,16,0,0,0,79,POR,19,14,28,20,0,0,0,81,20000516
2000,NYK,22,13,25,21,0,0,0,81,MIA,19,22,23,23,0,0,0,87,20000517
2000,MIA,21,24,13,12,0,0,0,70,NYK,16,14,23,19,0,0,0,72,20000519
2000,IND,37,19,29,21,0,0,0,106,PHI,25,28,16,21,0,0,0,90,20000519
2000,POR,26,16,30,22,0,0,0,94,LAL,26,37,22,24,0,0,0,109,20000520
2000,NYK,16,29,20,18,0,0,0,83,MIA,25,14,26,17,0,0,0,82,20000521
2000,POR,22,26,28,30,0,0,0,106,LAL,23,22,8,24,0,0,0,77,20000522
2000,NYK,17,31,23,17,0,0,0,88,IND,35,17,26,24,0,0,0,102,20000523
2000,NYK,22,21,23,18,0,0,0,84,IND,22,20,19,27,0,0,0,88,20000525
2000,LAL,22,23,27,21,0,0,0,93,POR,30,25,16,20,0,0,0,91,20000526
2000,IND,19,23,22,31,0,0,0,95,NYK,24,17,30,27,0,0,0,98,20000527
2000,LAL,16,26,34,27,0,0,0,103,POR,26,21,19,25,0,0,0,91,20000528
2000,IND,19,21,25,24,0,0,0,89,NYK,33,24,16,18,0,0,0,91,20000529
2000,POR,26,27,27,16,0,0,0,96,LAL,24,21,22,21,0,0,0,88,20000530
2000,NYK,32,8,15,24,0,0,0,79,IND,17,25,21,25,0,0,0,88,20000531
2000,IND,30,20,12,31,0,0,0,93,NYK,25,16,21,18,0,0,0,80,20000602
2000,LAL,15,24,24,30,0,0,0,93,POR,26,23,22,32,0,0,0,103,20000602
2000,POR,23,19,29,13,0,0,0,84,LAL,16,23,19,31,0,0,0,89,20000604
2000,IND,18,25,28,16,0,0,0,87,LAL,33,22,22,27,0,0,0,104,20000607
2000,IND,28,21,20,35,0,0,0,104,LAL,28,24,21,38,0,0,0,111,20000609
2000,LAL,15,27,24,25,0,0,0,91,IND,23,30,26,21,0,0,0,100,20000611
2000,LAL,23,28,29,24,16,0,0,120,IND,33,21,23,27,14,0,0,118,20000614
2000,LAL,28,17,22,20,0,0,0,87,IND,39,25,22,34,0,0,0,120,20000616
2000,IND,26,30,28,27,0,0,0,111,LAL,24,29,26,37,0,0,0,116,20000619
2001,CHH,28,22,33,23,0,0,0,106,ATL,13,34,15,20,0,0,0,82,20001031
2001,SAC,25,21,23,31,0,0,0,100,CHI,19,23,22,17,0,0,0,81,20001031
2001,MIL,21,25,27,20,0,0,0,93,DAL,30,23,28,16,0,0,0,97,20001031
2001,PHO,23,33,23,15,0,0,0,94,GSW,34,15,24,23,0,0,0,96,20001031
2001,MIN,35,30,19,22,0,0,0,106,HOU,25,19,23,31,0,0,0,98,20001031
2001,CLE,18,26,18,24,0,0,0,86,NJN,25,19,18,20,0,0,0,82,20001031
2001,PHI,26,25,29,21,0,0,0,101,NYK,23,18,13,18,0,0,0,72,20001031
2001,WAS,22,27,19,18,0,0,0,86,ORL,31,23,17,26,0,0,0,97,20001031
2001,LAL,27,26,14,29,0,0,0,96,POR,22,22,23,19,0,0,0,86,20001031
2001,IND,12,29,19,25,0,0,0,85,SAS,24,27,23,24,0,0,0,98,20001031
2001,DET,27,29,29,19,0,0,0,104,TOR,24,22,24,25,0,0,0,95,20001031
2001,LAC,19,27,21,27,0,0,0,94,UTA,22,28,34,23,0,0,0,107,20001031
2001,SEA,18,18,28,24,0,0,0,88,VAN,34,22,9,29,0,0,0,94,20001031
2001,DET,19,21,22,21,0,0,0,83,BOS,29,27,18,29,0,0,0,103,20001101
2001,WAS,32,19,17,27,0,0,0,95,CHH,21,21,14,21,0,0,0,77,20001101
2001,SAC,23,23,16,26,8,4,0,100,CLE,27,23,19,19,8,6,0,102,20001101
2001,UTA,24,20,21,32,0,0,0,97,LAL,16,15,25,36,0,0,0,92,20001101
2001,ORL,14,21,18,26,0,0,0,79,MIA,37,22,25,21,0,0,0,105,20001101
2001,TOR,31,22,20,25,0,0,0,98,PHI,25,34,16,29,0,0,0,104,20001101
2001,DEN,32,18,29,20,0,0,0,99,SEA,42,26,22,22,0,0,0,112,20001101
2001,IND,19,24,20,25,0,0,0,88,DAL,32,15,21,26,0,0,0,94,20001102
2001,GSW,20,33,21,23,0,0,0,97,DEN,24,23,29,25,0,0,0,101,20001102
2001,MIL,26,23,25,19,0,0,0,93,HOU,37,33,15,30,0,0,0,115,20001102
2001,VAN,28,26,23,22,0,0,0,99,LAC,21,20,22,28,0,0,0,91,20001102
2001,ATL,24,17,15,13,0,0,0,69,NYK,31,20,16,27,0,0,0,94,20001102
2001,POR,25,20,18,19,0,0,0,82,PHO,29,35,19,25,0,0,0,108,20001102
2001,MIN,24,31,19,17,0,0,0,91,SAS,23,22,29,29,0,0,0,103,20001102
2001,TOR,33,16,17,25,0,0,0,91,BOS,13,29,26,25,0,0,0,93,20001103
2001,MIA,16,20,21,22,0,0,0,79,CHH,19,23,20,21,0,0,0,83,20001103
2001,NJN,29,18,22,23,0,0,0,92,CHI,16,17,23,26,0,0,0,82,20001103
2001,SAC,25,31,22,22,0,0,0,100,DET,22,27,22,22,0,0,0,93,20001103
2001,PHI,24,25,18,20,0,0,0,87,ORL,20,24,22,14,0,0,0,80,20001103
2001,NYK,21,17,21,21,0,0,0,80,WAS,20,13,22,21,0,0,0,76,20001103
2001,ORL,33,30,18,26,0,0,0,107,ATL,22,29,27,26,0,0,0,104,20001104
2001,BOS,25,15,29,20,0,0,0,89,CLE,23,29,25,14,0,0,0,91,20001104
2001,UTA,30,19,33,30,0,0,0,112,DAL,24,22,30,30,0,0,0,106,20001104
2001,PHO,27,23,15,37,0,0,0,102,DEN,19,26,25,29,0,0,0,99,20001104
2001,SAS,24,35,34,24,0,0,0,117,GSW,21,25,27,32,0,0,0,105,20001104
2001,CHI,25,14,23,19,0,0,0,81,IND,24,26,21,23,0,0,0,94,20001104
2001,HOU,22,18,19,15,0,0,0,74,LAC,21,18,16,22,0,0,0,77,20001104
2001,PHI,21,20,27,16,0,0,0,84,MIA,24,25,15,18,0,0,0,82,20001104
2001,DET,19,22,18,29,0,0,0,88,MIL,24,27,29,17,0,0,0,97,20001104
2001,SAC,23,21,26,21,0,0,0,91,MIN,32,31,16,20,0,0,0,99,20001104
2001,CHH,24,29,19,26,0,0,0,98,NJN,32,19,19,17,0,0,0,87,20001104
2001,POR,27,25,25,20,0,0,0,97,SEA,22,20,20,28,0,0,0,90,20001104
2001,WAS,25,21,23,27,0,0,0,96,TOR,27,26,23,27,0,0,0,103,20001104
2001,LAL,23,24,30,21,0,0,0,98,VAN,18,22,20,29,0,0,0,89,20001104
2001,LAC,14,31,23,35,0,0,0,103,LAL,23,25,17,43,0,0,0,108,20001105
2001,HOU,22,21,21,35,0,0,0,99,PHO,26,25,24,29,0,0,0,104,20001105
2001,DAL,28,29,18,33,0,0,0,108,DEN,25,21,23,27,0,0,0,96,20001106
2001,SEA,24,21,22,32,0,0,0,99,ORL,24,16,33,37,0,0,0,110,20001106
2001,POR,18,18,18,21,0,0,0,75,SAC,19,19,25,16,0,0,0,79,20001106
2001,MIN,29,22,27,14,0,0,0,92,UTA,20,29,20,29,0,0,0,98,20001106
2001,ATL,19,17,19,32,0,0,0,87,VAN,20,30,21,26,0,0,0,97,20001106
2001,WAS,14,26,22,26,0,0,0,88,CHI,22,19,15,27,0,0,0,83,20001107
2001,LAL,20,17,15,22,0,0,0,74,HOU,22,21,15,26,0,0,0,84,20001107
2001,NYK,32,24,24,23,0,0,0,103,MIL,20,23,20,26,0,0,0,89,20001107
2001,SAS,21,17,23,20,0,0,0,81,PHO,25,28,25,22,0,0,0,100,20001107
2001,ATL,15,30,17,26,0,0,0,88,POR,25,26,27,19,0,0,0,97,20001107
2001,BOS,23,17,18,17,0,0,0,75,TOR,30,18,41,16,0,0,0,105,20001107
2001,VAN,29,25,27,20,0,0,0,101,DAL,23,15,10,26,0,0,0,74,20001108
2001,MIN,29,22,29,18,9,0,0,107,DEN,21,35,26,16,11,0,0,109,20001108
2001,MIL,21,27,26,23,0,0,0,97,IND,27,23,32,26,0,0,0,108,20001108
2001,UTA,25,16,17,18,17,0,0,93,LAC,20,14,25,17,11,0,0,87,20001108
2001,SEA,19,19,22,21,0,0,0,81,MIA,23,21,24,19,0,0,0,87,20001108
2001,CLE,21,33,20,25,0,0,0,99,NYK,27,28,22,20,0,0,0,97,20001108
2001,CHH,23,27,26,20,0,0,0,96,ORL,27,17,17,29,0,0,0,90,20001108
2001,DET,13,18,31,32,0,0,0,94,PHI,24,31,22,26,0,0,0,103,20001108
2001,GSW,14,24,28,18,0,0,0,84,SAC,31,34,27,23,0,0,0,115,20001108
2001,LAL,26,15,19,21,0,0,0,81,SAS,22,28,18,23,0,0,0,91,20001108
2001,NJN,30,22,24,26,0,0,0,102,WAS,13,26,26,21,0,0,0,86,20001108
2001,SEA,24,34,23,21,0,0,0,102,CHH,27,23,18,26,0,0,0,94,20001109
2001,ORL,14,28,20,28,0,0,0,90,CHI,24,24,26,21,0,0,0,95,20001109
2001,VAN,24,16,23,15,0,0,0,78,HOU,21,14,28,22,0,0,0,85,20001109
2001,PHI,16,14,24,30,0,0,0,84,MIN,17,19,17,29,0,0,0,82,20001109
2001,DET,26,22,36,24,0,0,0,108,NJN,17,23,30,24,0,0,0,94,20001109
2001,ATL,16,24,18,21,0,0,0,79,PHO,25,19,24,20,0,0,0,88,20001109
2001,DEN,16,25,31,19,0,0,0,91,POR,22,28,31,26,0,0,0,107,20001109
2001,NYK,23,27,18,24,11,0,0,103,BOS,26,24,15,27,9,0,0,101,20001110
2001,SAS,19,16,23,19,0,0,0,77,DAL,24,16,21,18,0,0,0,79,20001110
2001,SAC,37,15,19,26,17,0,0,114,GSW,25,25,22,25,10,0,0,107,20001110
2001,ATL,26,32,18,30,0,0,0,106,LAC,27,23,32,33,0,0,0,115,20001110
2001,CLE,21,17,25,25,0,0,0,88,TOR,27,28,38,22,0,0,0,115,20001110
2001,MIA,23,23,28,13,0,0,0,87,UTA,23,11,24,22,0,0,0,80,20001110
2001,IND,20,21,27,18,0,0,0,86,WAS,19,22,21,12,0,0,0,74,20001110
2001,TOR,21,19,24,34,0,0,0,98,CHI,15,22,19,19,0,0,0,75,20001111
2001,WAS,20,17,23,13,0,0,0,73,CLE,28,22,6,30,0,0,0,86,20001111
2001,DET,25,22,22,15,0,0,0,84,IND,26,21,21,26,0,0,0,94,20001111
2001,MIN,22,25,27,29,0,0,0,103,MIL,20,30,21,21,0,0,0,92,20001111
2001,SEA,35,20,20,16,0,0,0,91,NJN,32,35,38,21,0,0,0,126,20001111
2001,CHH,17,31,7,12,0,0,0,67,NYK,31,18,19,13,0,0,0,81,20001111
2001,BOS,19,21,16,27,0,0,0,83,PHI,12,23,21,29,0,0,0,85,20001111
2001,MIA,15,19,31,17,0,0,0,82,PHO,26,19,16,23,0,0,0,84,20001111
2001,HOU,22,20,22,24,0,0,0,88,POR,30,25,30,26,0,0,0,111,20001111
2001,VAN,16,39,9,14,0,0,0,78,SAS,19,23,20,29,0,0,0,91,20001111
2001,LAC,29,14,20,16,0,0,0,79,DEN,23,27,21,24,0,0,0,95,20001112
2001,SEA,16,27,21,28,0,0,0,92,DET,17,37,23,24,0,0,0,101,20001112
2001,ORL,25,24,23,19,14,0,0,105,GSW,17,24,31,19,8,0,0,99,20001112
2001,HOU,27,17,28,27,0,0,0,99,LAL,25,29,28,23,0,0,0,105,20001112
2001,DAL,24,17,18,25,0,0,0,84,SAC,29,25,28,27,0,0,0,109,20001112
2001,DAL,28,22,24,16,0,0,0,90,LAC,21,17,20,18,0,0,0,76,20001113
2001,POR,31,21,25,17,0,0,0,94,NJN,14,34,20,14,0,0,0,82,20001113
2001,POR,26,31,14,26,0,0,0,97,ATL,19,30,26,24,0,0,0,99,20001114
2001,GSW,22,16,27,21,0,0,0,86,CLE,25,18,20,33,0,0,0,96,20001114
2001,CHI,22,26,16,19,0,0,0,83,HOU,33,26,22,29,0,0,0,110,20001114
2001,DEN,29,28,18,28,0,0,0,103,LAL,32,28,31,28,0,0,0,119,20001114
2001,CHH,26,15,20,21,4,0,0,86,MIA,24,30,12,16,7,0,0,89,20001114
2001,ORL,33,18,17,14,0,0,0,82,SAC,27,27,21,21,0,0,0,96,20001114
2001,UTA,17,23,16,23,0,0,0,79,SAS,25,21,23,17,0,0,0,86,20001114
2001,NYK,23,20,20,12,0,0,0,75,SEA,28,20,24,24,0,0,0,96,20001114
2001,WAS,22,34,26,27,0,0,0,109,BOS,37,28,27,24,0,0,0,116,20001115
2001,IND,25,21,28,18,0,0,0,92,DET,19,36,21,12,0,0,0,88,20001115
2001,NYK,23,19,16,16,0,0,0,74,LAC,13,22,21,22,0,0,0,78,20001115
2001,ATL,18,30,10,16,0,0,0,74,MIL,21,26,25,12,0,0,0,84,20001115
2001,GSW,22,30,12,26,0,0,0,90,MIN,26,24,23,19,0,0,0,92,20001115
2001,MIA,17,22,23,29,0,0,0,91,NJN,27,18,21,27,0,0,0,93,20001115
2001,CLE,31,22,18,27,0,0,0,98,PHI,24,28,29,26,0,0,0,107,20001115
2001,DAL,22,18,18,20,0,0,0,78,PHO,22,20,28,29,0,0,0,99,20001115
2001,CHI,15,20,29,21,0,0,0,85,DEN,30,22,13,24,0,0,0,89,20001116
2001,CHH,21,20,24,15,0,0,0,80,HOU,19,28,17,20,0,0,0,84,20001116
2001,LAL,30,23,19,30,10,0,0,112,SAC,30,27,25,20,8,0,0,110,20001116
2001,POR,21,23,18,24,0,0,0,86,TOR,21,14,23,22,0,0,0,80,20001116
2001,ORL,28,23,16,17,0,0,0,84,UTA,27,28,18,26,0,0,0,99,20001116
2001,LAC,22,25,12,17,0,0,0,76,VAN,22,16,21,13,0,0,0,72,20001116
2001,SAS,27,28,18,26,0,0,0,99,WAS,31,26,18,20,0,0,0,95,20001116
2001,ATL,27,22,22,28,0,0,0,99,BOS,19,23,32,32,0,0,0,106,20001117
2001,DET,19,19,26,32,0,0,0,96,CHH,26,22,17,24,0,0,0,89,20001117
2001,GSW,22,24,25,21,0,0,0,92,IND,22,20,19,29,0,0,0,90,20001117
2001,CLE,18,21,26,11,0,0,0,76,MIL,20,20,27,22,0,0,0,89,20001117
2001,SAS,16,27,19,22,10,0,0,94,MIN,22,21,30,11,15,0,0,99,20001117
2001,MIA,24,23,14,12,0,0,0,73,PHI,19,24,29,22,0,0,0,94,20001117
2001,NYK,15,25,20,30,0,0,0,90,PHO,12,15,26,32,0,0,0,85,20001117
2001,DAL,29,16,27,27,0,0,0,99,SEA,28,30,21,16,0,0,0,95,20001117
2001,MIN,32,12,29,21,0,0,0,94,ATL,22,23,20,19,0,0,0,84,20001118
2001,LAL,18,33,20,15,0,0,0,86,DEN,29,18,15,25,0,0,0,87,20001118
2001,PHO,20,20,21,28,0,0,0,89,HOU,24,23,19,28,0,0,0,94,20001118
2001,SEA,22,22,19,23,0,0,0,86,LAC,17,23,16,27,0,0,0,83,20001118
2001,POR,27,19,16,18,0,0,0,80,MIA,21,22,15,28,0,0,0,86,20001118
2001,IND,32,16,28,16,0,0,0,92,NJN,30,33,19,15,0,0,0,97,20001118
2001,MIL,26,32,24,20,0,0,0,102,TOR,28,23,27,33,0,0,0,111,20001118
2001,CHI,18,17,15,14,0,0,0,64,UTA,26,29,28,26,0,0,0,109,20001118
2001,DAL,23,24,15,29,0,0,0,91,VAN,25,24,19,20,0,0,0,88,20001118
2001,BOS,21,25,21,22,0,0,0,89,WAS,33,26,34,16,0,0,0,109,20001118
2001,CHH,25,27,28,25,0,0,0,105,DET,20,25,20,31,0,0,0,96,20001119
2001,CHI,24,28,23,21,0,0,0,96,LAL,28,26,29,21,0,0,0,104,20001119
2001,GSW,16,24,18,13,0,0,0,71,NYK,25,23,19,21,0,0,0,88,20001119
2001,POR,29,27,14,28,12,0,0,110,ORL,25,25,22,26,4,0,0,102,20001119
2001,PHI,27,32,27,28,0,0,0,114,BOS,21,23,24,22,0,0,0,90,20001120
2001,NJN,22,19,23,22,0,0,0,86,LAC,24,15,17,29,0,0,0,85,20001120
2001,CHH,24,28,18,30,0,0,0,100,TOR,18,16,14,16,0,0,0,64,20001120
2001,DAL,22,34,30,21,0,0,0,107,UTA,22,26,25,25,0,0,0,98,20001120
2001,DEN,32,23,20,20,0,0,0,95,VAN,30,24,11,27,0,0,0,92,20001120
2001,DET,21,30,27,20,0,0,0,98,CLE,25,25,33,34,0,0,0,117,20001121
2001,SEA,25,39,30,22,0,0,0,116,DAL,28,22,40,20,0,0,0,110,20001121
2001,CHI,29,21,13,14,0,0,0,77,GSW,17,27,26,19,0,0,0,89,20001121
2001,HOU,21,16,35,29,0,0,0,101,IND,22,22,25,20,0,0,0,89,20001121
2001,NYK,18,27,22,18,0,0,0,85,ORL,29,24,20,11,0,0,0,84,20001121
2001,POR,26,36,22,20,0,0,0,104,WAS,26,29,24,15,0,0,0,94,20001121
2001,NYK,17,13,17,27,0,0,0,74,ATL,19,20,27,12,0,0,0,78,20001122
2001,HOU,17,11,23,30,0,0,0,81,BOS,30,14,30,22,0,0,0,96,20001122
2001,PHI,18,14,21,20,0,0,0,73,CHH,19,23,27,19,0,0,0,88,20001122
2001,GSW,19,24,24,24,0,0,0,91,LAL,35,35,26,15,0,0,0,111,20001122
2001,CLE,15,21,27,23,0,0,0,86,MIA,12,17,17,21,0,0,0,67,20001122
2001,POR,26,28,23,16,0,0,0,93,MIL,18,29,16,21,0,0,0,84,20001122
2001,VAN,27,23,22,28,0,0,0,100,MIN,23,24,32,22,0,0,0,101,20001122
2001,NJN,29,14,16,26,0,0,0,85,PHO,24,24,29,20,0,0,0,97,20001122
2001,CHI,18,21,18,14,0,0,0,71,SAC,25,20,23,32,0,0,0,100,20001122
2001,SEA,29,11,18,27,0,0,0,85,SAS,25,36,27,24,0,0,0,112,20001122
2001,DEN,25,17,17,19,0,0,0,78,UTA,28,31,30,27,0,0,0,116,20001122
2001,TOR,11,35,39,26,0,0,0,111,IND,16,19,28,28,0,0,0,91,20001123
2001,PHI,25,15,22,14,0,0,0,76,ATL,17,22,14,14,0,0,0,67,20001124
2001,ORL,22,24,24,19,9,0,0,98,BOS,20,29,21,19,14,0,0,103,20001124
2001,MIA,21,20,21,18,0,0,0,80,CLE,21,19,24,21,0,0,0,85,20001124
2001,SAS,25,27,21,19,0,0,0,92,DEN,21,29,36,16,0,0,0,102,20001124
2001,VAN,19,31,20,26,0,0,0,96,DET,37,33,18,30,0,0,0,118,20001124
2001,WAS,26,18,20,23,0,0,0,87,IND,23,29,23,24,0,0,0,99,20001124
2001,MIN,28,27,21,32,0,0,0,108,LAL,30,24,33,28,0,0,0,115,20001124
2001,CHH,30,32,21,23,0,0,0,106,MIL,27,16,19,28,0,0,0,90,20001124
2001,GSW,23,20,12,19,0,0,0,74,PHO,18,14,23,25,0,0,0,80,20001124
2001,LAC,26,22,17,16,0,0,0,81,SEA,26,26,25,21,0,0,0,98,20001124
2001,NJN,24,26,17,18,0,0,0,85,UTA,31,28,17,21,0,0,0,97,20001124
2001,CLE,32,18,20,28,0,0,0,98,CHH,30,30,23,26,0,0,0,109,20001125
2001,DEN,29,14,19,22,0,0,0,84,DAL,31,21,28,28,0,0,0,108,20001125
2001,MIN,18,21,19,35,0,0,0,93,GSW,32,24,26,32,0,0,0,114,20001125
2001,PHO,30,15,18,19,13,0,0,95,LAC,14,24,14,30,7,0,0,89,20001125
2001,HOU,21,26,21,23,0,0,0,91,MIA,16,16,30,18,0,0,0,80,20001125
2001,TOR,23,16,22,18,0,0,0,79,NYK,21,19,12,23,0,0,0,75,20001125
2001,ATL,29,15,24,24,0,0,0,92,ORL,39,27,29,19,0,0,0,114,20001125
2001,NJN,17,26,21,20,0,0,0,84,POR,28,18,26,14,0,0,0,86,20001125
2001,SEA,18,35,24,24,0,0,0,101,SAC,31,23,35,36,0,0,0,125,20001125
2001,PHI,16,21,17,22,0,0,0,76,SAS,29,30,17,20,0,0,0,96,20001125
2001,MIL,20,30,32,18,0,0,0,100,WAS,21,27,27,32,0,0,0,107,20001125
2001,VAN,16,37,27,18,0,0,0,98,BOS,27,28,12,20,0,0,0,87,20001126
2001,UTA,28,14,21,31,0,0,0,94,DET,29,13,25,12,0,0,0,79,20001126
2001,CHI,27,18,20,24,0,0,0,89,TOR,29,24,21,27,0,0,0,101,20001126
2001,LAL,21,23,28,26,0,0,0,98,LAC,23,15,22,23,0,0,0,83,20001127
2001,VAN,19,20,13,20,0,0,0,72,NYK,27,18,25,27,0,0,0,97,20001127
2001,MIL,26,30,25,23,0,0,0,104,ORL,26,17,20,32,0,0,0,95,20001127
2001,MIN,27,25,20,24,0,0,0,96,CHI,20,25,17,14,0,0,0,76,20001128
2001,BOS,20,29,16,22,0,0,0,87,CLE,27,4,18,23,0,0,0,72,20001128
2001,TOR,23,25,20,25,0,0,0,93,DAL,20,33,20,34,0,0,0,107,20001128
2001,SAC,28,24,22,14,0,0,0,88,HOU,13,22,21,25,0,0,0,81,20001128
2001,IND,33,24,19,31,0,0,0,107,LAL,38,31,28,27,0,0,0,124,20001128
2001,MIL,23,19,19,41,0,0,0,102,MIA,25,26,30,20,0,0,0,101,20001128
2001,UTA,18,30,18,32,0,0,0,98,NJN,24,18,24,26,0,0,0,92,20001128
2001,SEA,30,34,12,29,0,0,0,105,POR,19,27,22,25,0,0,0,93,20001128
2001,ATL,25,25,23,29,0,0,0,102,WAS,18,12,19,26,0,0,0,75,20001128
2001,TOR,20,20,24,15,0,0,0,79,CHH,27,31,17,28,0,0,0,103,20001129
2001,NJN,24,17,24,11,0,0,0,76,DET,34,9,30,24,0,0,0,97,20001129
2001,GSW,16,23,23,21,0,0,0,83,LAC,29,25,24,28,0,0,0,106,20001129
2001,DEN,27,24,31,25,0,0,0,107,MIN,22,25,25,28,0,0,0,100,20001129
2001,MIA,26,25,16,17,0,0,0,84,NYK,19,17,20,25,0,0,0,81,20001129
2001,UTA,29,17,16,26,0,0,0,88,ORL,27,20,24,15,0,0,0,86,20001129
2001,WAS,19,24,22,22,0,0,0,87,PHI,28,24,24,17,0,0,0,93,20001129
2001,SAC,20,17,22,20,0,0,0,79,SAS,19,21,24,18,0,0,0,82,20001129
2001,PHO,29,21,19,18,14,5,0,106,VAN,19,31,17,20,14,8,0,109,20001129
2001,CHI,26,19,20,26,0,0,0,91,ATL,21,19,20,22,0,0,0,82,20001130
2001,HOU,25,25,26,22,11,0,0,109,DEN,28,23,25,22,7,0,0,105,20001130
2001,IND,23,32,13,27,0,0,0,95,GSW,31,24,28,16,0,0,0,99,20001130
2001,BOS,19,23,28,27,0,0,0,97,MIL,36,23,21,28,0,0,0,108,20001130
2001,DAL,19,26,23,16,0,0,0,84,POR,27,25,27,16,0,0,0,95,20001130
2001,LAL,25,18,29,16,0,0,0,88,SEA,34,40,22,25,0,0,0,121,20001130
2001,MIN,30,25,19,28,0,0,0,102,BOS,24,22,23,29,0,0,0,98,20001201
2001,NYK,33,18,19,21,0,0,0,91,CHI,22,24,23,17,0,0,0,86,20001201
2001,CLE,24,24,27,18,0,0,0,93,DET,28,29,22,24,0,0,0,103,20001201
2001,SAS,21,21,36,22,0,0,0,100,LAL,30,32,20,27,0,0,0,109,20001201
2001,UTA,20,23,23,28,0,0,0,94,MIA,19,26,33,14,0,0,0,92,20001201
2001,NJN,13,22,25,20,0,0,0,80,ORL,19,20,25,19,0,0,0,83,20001201
2001,CHH,20,16,19,19,0,0,0,74,PHI,22,22,26,25,0,0,0,95,20001201
2001,PHO,23,25,17,33,0,0,0,98,SAC,30,27,28,20,0,0,0,105,20001201
2001,LAC,23,28,21,21,2,0,0,95,TOR,18,23,24,28,11,0,0,104,20001201
2001,IND,29,16,16,15,10,0,0,86,VAN,21,13,22,20,0,0,0,76,20001201
2001,MIL,19,34,21,20,0,0,0,94,ATL,28,21,27,25,0,0,0,101,20001202
2001,UTA,20,26,20,23,0,0,0,89,CHH,21,23,21,29,0,0,0,94,20001202
2001,PHI,27,31,27,27,0,0,0,112,CLE,20,19,15,24,0,0,0,78,20001202
2001,SEA,19,22,24,27,0,0,0,92,DEN,30,25,15,33,0,0,0,103,20001202
2001,DAL,30,21,23,23,0,0,0,97,GSW,13,20,25,20,0,0,0,78,20001202
2001,POR,21,25,26,24,0,0,0,96,HOU,22,22,14,27,0,0,0,85,20001202
2001,ORL,26,23,22,24,0,0,0,95,NJN,19,22,22,11,0,0,0,74,20001202
2001,MIN,18,27,20,25,0,0,0,90,NYK,28,21,20,31,0,0,0,100,20001202
2001,MIA,26,16,17,34,0,0,0,93,WAS,25,14,28,23,0,0,0,90,20001202
2001,LAC,18,21,20,28,0,0,0,87,BOS,25,29,17,25,0,0,0,96,20001203
2001,WAS,23,29,17,18,0,0,0,87,DET,25,27,18,23,0,0,0,93,20001203
2001,DAL,19,18,26,34,0,0,0,97,LAL,23,24,24,28,0,0,0,99,20001203
2001,IND,25,19,17,19,0,0,0,80,MIL,23,20,26,23,0,0,0,92,20001203
2001,POR,19,17,22,21,0,0,0,79,PHO,18,13,29,24,0,0,0,84,20001203
2001,GSW,29,27,30,16,0,0,0,102,SEA,31,36,28,23,0,0,0,118,20001203
2001,SAS,21,14,35,27,0,0,0,97,VAN,14,20,23,22,0,0,0,79,20001203
2001,PHI,31,23,24,20,0,0,0,98,DEN,25,29,31,20,0,0,0,105,20001204
2001,LAC,20,18,17,23,0,0,0,78,NYK,28,29,26,23,0,0,0,106,20001204
2001,MIA,16,29,22,33,0,0,0,100,ATL,17,15,27,33,0,0,0,92,20001205
2001,CHH,18,17,10,21,0,0,0,66,CLE,16,23,20,12,0,0,0,71,20001205
2001,DAL,25,26,25,26,0,0,0,102,HOU,31,23,31,24,0,0,0,109,20001205
2001,NJN,18,17,17,12,0,0,0,64,IND,31,17,22,18,0,0,0,88,20001205
2001,PHI,18,20,19,28,0,0,0,85,LAL,17,26,21,32,0,0,0,96,20001205
2001,CHI,26,20,23,21,0,0,0,90,MIN,30,32,18,20,0,0,0,100,20001205
2001,BOS,29,27,21,21,0,0,0,98,ORL,28,24,25,24,0,0,0,101,20001205
2001,SAS,22,26,14,13,0,0,0,75,SAC,22,20,20,19,0,0,0,81,20001205
2001,TOR,11,33,21,19,0,0,0,84,UTA,24,25,21,28,0,0,0,98,20001205
2001,DET,16,26,19,22,0,0,0,83,VAN,22,20,22,27,0,0,0,91,20001205
2001,IND,23,27,25,13,0,0,0,88,CHH,22,24,20,25,0,0,0,91,20001206
2001,CLE,21,19,29,23,0,0,0,92,CHI,27,15,22,24,0,0,0,88,20001206
2001,NYK,11,24,23,27,0,0,0,85,DAL,32,23,15,24,0,0,0,94,20001206
2001,LAL,27,30,35,15,15,0,0,122,GSW,31,32,19,25,18,0,0,125,20001206
2001,DEN,25,10,18,25,0,0,0,78,MIA,20,33,18,24,0,0,0,95,20001206
2001,MIL,37,25,21,26,0,0,0,109,NJN,21,24,24,18,0,0,0,87,20001206
2001,TOR,19,16,25,28,0,0,0,88,POR,19,24,25,27,0,0,0,95,20001206
2001,DET,27,31,24,30,0,0,0,112,SEA,24,33,22,20,0,0,0,99,20001206
2001,LAC,11,19,26,37,0,0,0,93,WAS,24,23,25,16,0,0,0,88,20001206
2001,PHO,23,25,28,28,0,0,0,104,MIL,26,31,26,13,0,0,0,96,20001207
2001,WAS,23,26,17,22,0,0,0,88,MIN,34,20,26,25,0,0,0,105,20001207
2001,DEN,26,29,24,14,0,0,0,93,ORL,23,23,30,27,0,0,0,103,20001207
2001,NYK,17,24,25,20,0,0,0,86,SAS,25,26,18,14,0,0,0,83,20001207
2001,VAN,20,21,19,27,0,0,0,87,UTA,16,28,24,30,0,0,0,98,20001207
2001,IND,30,27,21,26,0,0,0,104,BOS,24,18,30,19,0,0,0,91,20001208
2001,LAC,17,28,18,24,0,0,0,87,CHH,17,24,25,26,0,0,0,92,20001208
2001,CHI,23,17,18,28,0,0,0,86,DAL,26,27,31,21,0,0,0,105,20001208
2001,TOR,27,30,24,27,0,0,0,108,GSW,15,31,22,24,0,0,0,92,20001208
2001,SEA,30,27,25,21,0,0,0,103,LAL,26,31,19,19,0,0,0,95,20001208
2001,ATL,16,13,22,25,0,0,0,76,MIA,18,27,12,23,0,0,0,80,20001208
2001,PHO,17,21,23,23,0,0,0,84,NJN,18,25,25,18,0,0,0,86,20001208
2001,PHI,32,33,20,22,0,0,0,107,POR,30,28,15,21,0,0,0,94,20001208
2001,HOU,28,23,21,26,0,0,0,98,SAC,25,29,33,24,0,0,0,111,20001208
2001,ATL,31,20,20,19,0,0,0,90,CLE,27,28,17,25,0,0,0,97,20001209
2001,CHH,26,17,21,22,10,0,0,96,IND,23,22,23,18,13,0,0,99,20001209
2001,WAS,25,16,21,29,0,0,0,91,MIL,30,29,23,17,0,0,0,99,20001209
2001,LAC,12,19,15,27,0,0,0,73,MIN,20,24,20,21,0,0,0,85,20001209
2001,DEN,31,16,18,23,0,0,0,88,NYK,22,24,28,22,0,0,0,96,20001209
2001,DET,17,18,20,28,0,0,0,83,POR,30,25,32,27,0,0,0,114,20001209
2001,CHI,19,17,28,17,0,0,0,81,SAS,32,28,28,17,0,0,0,105,20001209
2001,HOU,22,43,23,23,0,0,0,111,SEA,26,32,27,19,0,0,0,104,20001209
2001,GSW,36,29,26,23,0,0,0,114,UTA,31,36,24,34,0,0,0,125,20001209
2001,PHI,20,26,17,20,0,0,0,83,VAN,13,30,27,9,0,0,0,79,20001209
2001,DEN,21,29,24,17,11,0,0,102,BOS,27,29,18,17,13,0,0,104,20001210
2001,DET,25,19,23,21,0,0,0,88,LAL,33,23,29,27,0,0,0,112,20001210
2001,DAL,30,21,27,21,0,0,0,99,NJN,22,21,19,11,0,0,0,73,20001210
2001,MIA,40,19,16,22,0,0,0,97,SAC,17,33,30,21,0,0,0,101,20001210
2001,PHO,26,19,26,24,0,0,0,95,TOR,14,27,25,21,0,0,0,87,20001210
2001,PHO,19,25,20,22,0,0,0,86,CHI,25,19,13,23,0,0,0,80,20001211
2001,ORL,25,21,13,21,0,0,0,80,LAC,26,19,25,22,0,0,0,92,20001211
2001,MIN,22,23,24,15,12,0,0,96,PHI,32,17,19,16,7,0,0,91,20001211
2001,SAS,18,23,24,26,0,0,0,91,UTA,18,23,20,22,0,0,0,83,20001211
2001,HOU,15,24,15,28,0,0,0,82,VAN,20,14,18,23,0,0,0,75,20001211
2001,SAC,21,25,34,19,0,0,0,99,ATL,21,29,27,30,0,0,0,107,20001212
2001,DAL,24,25,14,24,0,0,0,87,CLE,23,23,19,27,0,0,0,92,20001212
2001,MIA,17,21,31,27,0,0,0,96,DEN,23,15,19,28,0,0,0,85,20001212
2001,POR,21,27,27,26,0,0,0,101,GSW,23,20,24,26,0,0,0,93,20001212
2001,MIL,25,23,30,31,0,0,0,109,LAL,26,27,30,22,0,0,0,105,20001212
2001,MIN,24,22,24,24,0,0,0,94,NJN,36,22,28,30,0,0,0,116,20001212
2001,ORL,24,34,17,17,0,0,0,92,SEA,21,32,23,21,0,0,0,97,20001212
2001,IND,21,17,37,15,0,0,0,90,TOR,21,35,22,26,0,0,0,104,20001212
2001,CHI,27,24,34,19,0,0,0,104,BOS,24,20,28,14,0,0,0,86,20001213
2001,SAC,21,22,21,26,0,0,0,90,CHH,29,25,29,18,0,0,0,101,20001213
2001,ATL,14,17,24,14,0,0,0,69,DET,30,22,22,18,0,0,0,92,20001213
2001,DAL,30,15,24,23,0,0,0,92,IND,24,19,29,25,0,0,0,97,20001213
2001,MIA,24,16,28,15,11,0,0,94,LAC,20,23,14,26,5,0,0,88,20001213
2001,SAS,18,26,27,22,0,0,0,93,PHO,28,32,23,20,0,0,0,103,20001213
2001,LAL,20,24,20,22,0,0,0,86,POR,30,14,20,32,0,0,0,96,20001213
2001,MIL,23,26,30,32,0,0,0,111,UTA,20,21,33,28,0,0,0,102,20001213
2001,SEA,25,31,23,15,0,0,0,94,VAN,17,33,24,19,0,0,0,93,20001213
2001,PHI,27,22,28,25,0,0,0,102,WAS,25,13,24,20,0,0,0,82,20001213
2001,HOU,26,31,24,17,0,0,0,98,GSW,29,18,21,27,0,0,0,95,20001214
2001,DEN,21,30,25,26,0,0,0,102,SAS,24,31,23,18,0,0,0,96,20001214
2001,NYK,19,18,15,16,0,0,0,68,TOR,20,19,19,12,0,0,0,70,20001214
2001,SAC,23,28,28,25,0,0,0,104,BOS,21,22,18,20,0,0,0,81,20001215
2001,ATL,23,17,20,25,0,0,0,85,CHI,20,13,23,18,0,0,0,74,20001215
2001,MIN,24,19,28,28,0,0,0,99,DET,31,16,19,24,0,0,0,90,20001215
2001,CLE,29,25,21,28,0,0,0,103,IND,28,29,24,14,0,0,0,95,20001215
2001,VAN,16,21,18,21,0,0,0,76,LAL,22,26,26,24,0,0,0,98,20001215
2001,TOR,30,16,18,33,0,0,0,97,MIL,23,24,25,32,0,0,0,104,20001215
2001,UTA,24,16,31,18,0,0,0,89,NYK,13,12,23,10,0,0,0,58,20001215
2001,DAL,27,35,30,20,0,0,0,112,PHI,30,27,23,14,0,0,0,94,20001215
2001,LAC,24,24,24,26,0,0,0,98,PHO,19,22,15,32,0,0,0,88,20001215
2001,ORL,22,19,29,26,0,0,0,96,POR,28,29,28,21,0,0,0,106,20001215
2001,MIA,23,21,15,22,0,0,0,81,SEA,21,23,31,24,0,0,0,99,20001215
2001,CHH,30,25,26,22,0,0,0,103,WAS,24,21,17,27,0,0,0,89,20001215
2001,NJN,20,21,27,21,0,0,0,89,ATL,25,21,21,16,0,0,0,83,20001216
2001,BOS,25,26,17,19,0,0,0,87,CHH,18,29,26,26,0,0,0,99,20001216
2001,PHI,18,34,24,23,0,0,0,99,CHI,19,22,32,18,0,0,0,91,20001216
2001,UTA,19,21,23,29,0,0,0,92,CLE,16,27,28,28,0,0,0,99,20001216
2001,MIA,30,17,26,20,0,0,0,93,GSW,23,17,21,24,0,0,0,85,20001216
2001,DEN,33,23,20,26,0,0,0,102,HOU,21,23,32,24,0,0,0,100,20001216
2001,IND,24,27,25,25,9,0,0,110,MIN,28,29,21,23,12,0,0,113,20001216
2001,PHO,21,31,17,13,0,0,0,82,SAS,25,23,18,24,0,0,0,90,20001216
2001,DAL,31,16,19,33,0,0,0,99,DET,16,29,20,25,0,0,0,90,20001217
2001,WAS,26,20,31,26,0,0,0,103,LAC,26,16,30,22,0,0,0,94,20001217
2001,SAC,31,28,17,19,0,0,0,95,NJN,15,27,25,12,0,0,0,79,20001217
2001,MIL,29,15,24,27,2,0,0,97,NYK,31,29,10,25,5,0,0,100,20001217
2001,LAL,25,28,23,15,13,0,0,104,TOR,23,26,15,27,10,0,0,101,20001217
2001,ORL,24,28,30,19,0,0,0,101,VAN,28,21,25,17,0,0,0,91,20001217
2001,DAL,32,27,25,22,0,0,0,106,BOS,15,35,29,19,0,0,0,98,20001218
2001,NYK,13,27,13,24,0,0,0,77,ATL,24,22,18,23,0,0,0,87,20001219
2001,IND,17,21,27,25,0,0,0,90,CHI,18,21,17,29,0,0,0,85,20001219
2001,MIN,27,25,22,25,0,0,0,99,GSW,30,35,21,34,0,0,0,120,20001219
2001,SAS,14,20,22,30,0,0,0,86,HOU,20,16,17,26,0,0,0,79,20001219
2001,LAL,29,15,21,16,0,0,0,81,MIA,21,23,23,12,0,0,0,79,20001219
2001,DET,26,21,29,13,0,0,0,89,PHO,25,22,15,22,0,0,0,84,20001219
2001,WAS,23,11,20,18,0,0,0,72,SAC,21,28,27,30,0,0,0,106,20001219
2001,UTA,21,28,15,31,0,0,0,95,TOR,29,25,26,23,0,0,0,103,20001219
2001,NJN,22,16,26,22,0,0,0,86,BOS,37,18,24,20,0,0,0,99,20001220
2001,MIA,16,10,11,19,0,0,0,56,CHH,21,14,16,14,0,0,0,65,20001220
2001,POR,28,23,27,23,0,0,0,101,DAL,26,24,26,30,0,0,0,106,20001220
2001,DET,29,34,26,17,0,0,0,106,DEN,34,18,28,28,0,0,0,108,20001220
2001,TOR,22,28,24,18,7,0,0,99,IND,25,30,19,18,6,0,0,98,20001220
2001,MIN,22,31,29,14,0,0,0,96,LAC,25,27,23,28,0,0,0,103,20001220
2001,UTA,14,24,23,30,0,0,0,91,PHI,28,19,21,21,0,0,0,89,20001220
2001,CLE,19,21,25,12,0,0,0,77,SAS,24,31,20,19,0,0,0,94,20001220
2001,SAC,27,26,16,16,0,0,0,85,SEA,20,20,31,18,0,0,0,89,20001220
2001,WAS,36,21,22,25,0,0,0,104,VAN,34,30,26,28,0,0,0,118,20001220
2001,LAL,28,24,22,25,0,0,0,99,HOU,26,21,27,20,0,0,0,94,20001221
2001,NJN,17,12,18,31,0,0,0,78,MIL,25,26,19,10,0,0,0,80,20001221
2001,BOS,21,26,22,23,0,0,0,92,NYK,25,15,18,28,0,0,0,86,20001221
2001,CHI,22,19,27,20,0,0,0,88,ORL,15,27,34,23,0,0,0,99,20001221
2001,LAL,29,32,19,28,0,0,0,108,DAL,23,18,27,35,0,0,0,103,20001222
2001,POR,25,25,21,25,0,0,0,96,DEN,30,32,31,23,0,0,0,116,20001222
2001,UTA,31,16,34,28,0,0,0,109,IND,20,23,33,25,0,0,0,101,20001222
2001,CLE,28,24,18,25,0,0,0,95,MIA,24,32,26,21,0,0,0,103,20001222
2001,CHH,22,17,22,22,0,0,0,83,MIN,23,15,16,20,0,0,0,74,20001222
2001,NYK,23,18,30,20,0,0,0,91,PHI,16,23,11,21,0,0,0,71,20001222
2001,GSW,24,18,17,28,0,0,0,87,SAS,29,25,17,34,0,0,0,105,20001222
2001,WAS,26,27,14,20,0,0,0,87,SEA,33,27,22,25,0,0,0,107,20001222
2001,ATL,18,20,20,20,0,0,0,78,TOR,17,14,25,16,0,0,0,72,20001222
2001,SAC,22,24,22,27,0,0,0,95,VAN,23,21,29,20,0,0,0,93,20001222
2001,IND,21,29,22,15,0,0,0,87,ATL,27,29,20,15,0,0,0,91,20001223
2001,SAS,19,24,14,22,5,0,0,84,CHH,17,21,28,13,9,0,0,88,20001223
2001,CHI,21,25,25,22,0,0,0,93,DET,32,17,29,28,0,0,0,106,20001223
2001,GSW,23,28,21,23,0,0,0,95,HOU,27,24,20,16,0,0,0,87,20001223
2001,VAN,16,21,32,21,0,0,0,90,LAC,32,16,17,27,0,0,0,92,20001223
2001,BOS,25,22,30,22,0,0,0,99,MIL,27,26,23,28,0,0,0,104,20001223
2001,UTA,17,26,19,36,0,0,0,98,MIN,30,17,27,18,0,0,0,92,20001223
2001,MIA,19,24,23,20,0,0,0,86,NJN,16,22,21,21,0,0,0,80,20001223
2001,CLE,19,27,17,29,0,0,0,92,ORL,33,23,25,30,0,0,0,111,20001223
2001,DEN,21,23,28,21,0,0,0,93,PHO,22,31,21,28,0,0,0,102,20001223
2001,WAS,20,23,16,11,0,0,0,70,POR,22,16,22,27,0,0,0,87,20001223
2001,SEA,21,22,29,20,0,0,0,92,SAC,23,28,22,24,0,0,0,97,20001223
2001,ORL,23,27,26,17,0,0,0,93,IND,24,30,33,16,0,0,0,103,20001225
2001,POR,21,34,25,29,0,0,0,109,LAL,30,31,20,23,0,0,0,104,20001225
2001,CLE,25,22,26,26,11,0,0,110,CHH,27,23,29,20,16,0,0,115,20001226
2001,SEA,19,32,29,13,0,0,0,93,DAL,26,31,35,22,0,0,0,114,20001226
2001,LAC,31,30,26,21,0,0,0,108,DEN,27,35,22,25,0,0,0,109,20001226
2001,BOS,30,19,19,28,0,0,0,96,DET,25,24,23,29,0,0,0,101,20001226
2001,ORL,21,12,24,20,0,0,0,77,MIL,23,22,13,31,0,0,0,89,20001226
2001,TOR,21,17,24,35,0,0,0,97,MIN,26,23,26,25,0,0,0,100,20001226
2001,ATL,18,20,28,15,0,0,0,81,NJN,19,16,22,19,0,0,0,76,20001226
2001,HOU,28,22,22,23,0,0,0,95,SAS,34,22,30,17,0,0,0,103,20001226
2001,PHI,23,28,26,20,0,0,0,97,UTA,17,23,23,28,0,0,0,91,20001226
2001,PHO,19,30,19,29,0,0,0,97,VAN,20,15,31,29,0,0,0,95,20001226
2001,PHI,27,25,29,37,0,0,0,118,GSW,26,31,26,27,0,0,0,110,20001227
2001,SEA,26,24,28,29,0,0,0,107,HOU,31,21,22,18,0,0,0,92,20001227
2001,IND,13,19,20,27,0,0,0,79,MIA,23,23,19,26,0,0,0,91,20001227
2001,NYK,26,21,28,14,0,0,0,89,WAS,22,21,24,15,0,0,0,82,20001227
2001,SAS,23,33,20,28,0,0,0,104,CHI,23,26,23,33,0,0,0,105,20001228
2001,MIL,25,24,30,28,0,0,0,107,CLE,20,20,22,27,0,0,0,89,20001228
2001,LAC,15,28,21,32,0,0,0,96,DAL,28,30,28,19,0,0,0,105,20001228
2001,TOR,23,26,20,25,0,0,0,94,DEN,27,24,22,20,0,0,0,93,20001228
2001,ATL,17,23,27,14,0,0,0,81,MIN,17,22,24,25,0,0,0,88,20001228
2001,BOS,29,24,26,33,0,0,0,112,NJN,33,22,32,24,0,0,0,111,20001228
2001,DET,27,24,21,24,0,0,0,96,ORL,23,32,23,24,0,0,0,102,20001228
2001,LAL,21,30,34,30,0,0,0,115,PHO,22,18,19,19,0,0,0,78,20001228
2001,CHH,20,21,29,17,0,0,0,87,SAC,27,18,21,25,0,0,0,91,20001228
2001,POR,20,26,28,18,11,0,0,103,UTA,25,28,24,15,10,0,0,102,20001228
2001,CLE,26,27,20,24,0,0,0,97,ATL,19,24,29,13,0,0,0,85,20001229
2001,UTA,8,21,36,24,0,0,0,89,GSW,19,19,30,32,0,0,0,100,20001229
2001,WAS,22,23,23,23,0,0,0,91,MIA,14,31,26,27,0,0,0,98,20001229
2001,CHI,22,14,14,18,0,0,0,68,NYK,27,28,16,24,0,0,0,95,20001229
2001,VAN,21,16,22,22,0,0,0,81,POR,21,25,33,25,0,0,0,104,20001229
2001,ORL,27,23,24,21,0,0,0,95,BOS,18,26,21,25,0,0,0,90,20001230
2001,HOU,25,28,23,38,0,0,0,114,DAL,14,17,30,38,0,0,0,99,20001230
2001,MIL,21,22,32,38,0,0,0,113,DEN,38,31,18,33,0,0,0,120,20001230
2001,MIA,22,27,25,21,15,0,0,110,DET,20,20,27,28,7,0,0,102,20001230
2001,SAS,16,28,21,24,0,0,0,89,IND,17,20,17,23,0,0,0,77,20001230
2001,LAL,28,26,26,23,13,0,0,116,LAC,21,30,24,28,11,0,0,114,20001230
2001,NYK,24,22,24,18,0,0,0,88,MIN,21,17,24,17,0,0,0,79,20001230
2001,TOR,29,21,22,31,0,0,0,103,PHO,18,27,34,30,0,0,0,109,20001230
2001,PHI,35,19,29,15,9,0,0,107,SAC,19,27,20,32,6,0,0,104,20001230
2001,CHH,33,19,21,29,0,0,0,102,SEA,25,28,22,29,0,0,0,104,20001230
2001,GSW,35,26,17,24,0,0,0,102,VAN,21,35,25,20,0,0,0,101,20001230
2001,NJN,22,12,16,27,0,0,0,77,CHI,23,20,16,27,0,0,0,86,20001231
2001,DET,27,32,19,18,0,0,0,96,WAS,36,24,34,16,0,0,0,110,20001231
2001,HOU,29,16,30,21,0,0,0,96,MIN,25,23,34,24,0,0,0,106,20010101
2001,CHH,12,25,12,18,0,0,0,67,POR,19,29,19,22,0,0,0,89,20010101
2001,BOS,27,19,20,15,0,0,0,81,ATL,23,24,21,24,0,0,0,92,20010102
2001,MIL,36,21,27,20,0,0,0,104,CHI,15,17,19,19,0,0,0,70,20010102
2001,HOU,20,23,30,27,0,0,0,100,CLE,18,21,27,29,0,0,0,95,20010102
2001,TOR,19,32,23,23,0,0,0,97,LAC,36,25,25,24,0,0,0,110,20010102
2001,NJN,35,27,29,29,0,0,0,120,ORL,19,25,25,41,0,0,0,110,20010102
2001,PHO,26,25,35,20,11,0,0,117,SAC,29,37,21,19,15,0,0,121,20010102
2001,MIA,23,15,15,19,0,0,0,72,SAS,20,21,18,21,0,0,0,80,20010102
2001,IND,27,17,24,23,0,0,0,91,SEA,26,24,19,14,0,0,0,83,20010102
2001,MIN,29,30,18,31,0,0,0,108,WAS,27,32,22,34,0,0,0,115,20010102
2001,NYK,18,32,23,27,0,0,0,100,BOS,27,23,22,19,0,0,0,91,20010103
2001,DET,35,22,25,25,0,0,0,107,DAL,26,23,27,28,0,0,0,104,20010103
2001,DEN,32,28,25,26,0,0,0,111,GSW,33,21,32,14,0,0,0,100,20010103
2001,UTA,18,10,19,24,0,0,0,71,LAL,15,18,19,30,0,0,0,82,20010103
2001,CLE,20,27,18,18,0,0,0,83,MIL,26,17,26,19,0,0,0,88,20010103
2001,ATL,18,15,22,25,0,0,0,80,PHI,28,32,23,15,0,0,0,98,20010103
2001,LAC,21,23,21,20,0,0,0,85,PHO,25,23,17,25,0,0,0,90,20010103
2001,IND,16,24,18,28,0,0,0,86,POR,22,23,30,27,0,0,0,102,20010103
2001,CHH,17,21,23,28,0,0,0,89,VAN,28,25,26,20,0,0,0,99,20010103
2001,WAS,22,21,20,33,0,0,0,96,CHI,22,28,19,29,0,0,0,98,20010104
2001,DET,22,29,25,21,0,0,0,97,HOU,30,27,26,24,0,0,0,107,20010104
2001,NJN,23,26,8,21,0,0,0,78,MIA,31,15,24,11,0,0,0,81,20010104
2001,SEA,22,26,20,24,0,0,0,92,MIN,26,29,25,25,0,0,0,105,20010104
2001,ORL,26,20,21,19,6,0,0,92,NYK,11,35,24,16,9,0,0,95,20010104
2001,GSW,30,17,30,23,0,0,0,100,BOS,30,22,26,10,0,0,0,88,20010105
2001,UTA,25,16,25,21,0,0,0,87,DEN,27,20,27,26,0,0,0,100,20010105
2001,CHH,20,22,21,23,0,0,0,86,LAC,19,11,15,28,0,0,0,73,20010105
2001,SEA,26,15,23,25,0,0,0,89,PHI,32,32,26,31,0,0,0,121,20010105
2001,VAN,19,19,18,20,0,0,0,76,PHO,31,19,33,25,0,0,0,108,20010105
2001,MIL,22,20,33,40,0,0,0,115,POR,30,22,27,40,0,0,0,119,20010105
2001,IND,24,28,18,19,4,0,0,93,SAC,22,21,24,22,2,0,0,91,20010105
2001,DAL,27,27,33,28,0,0,0,115,TOR,34,28,20,23,0,0,0,105,20010105
2001,ORL,29,14,24,15,0,0,0,82,ATL,20,22,22,19,0,0,0,83,20010106
2001,PHI,27,29,27,24,0,0,0,107,CLE,25,23,27,28,0,0,0,103,20010106
2001,UTA,24,27,24,24,0,0,0,99,HOU,22,31,19,25,0,0,0,97,20010106
2001,BOS,25,18,19,24,0,0,0,86,MIA,35,23,31,23,0,0,0,112,20010106
2001,GSW,30,20,19,23,0,0,0,92,NJN,26,19,22,30,0,0,0,97,20010106
2001,DET,28,13,25,35,0,0,0,101,SAS,33,23,22,30,0,0,0,108,20010106
2001,DAL,22,32,21,28,0,0,0,103,WAS,25,24,17,19,0,0,0,85,20010106
2001,CHH,21,25,25,16,0,0,0,87,DEN,29,21,24,20,0,0,0,94,20010107
2001,LAC,30,24,34,30,0,0,0,118,LAL,20,27,26,22,0,0,0,95,20010107
2001,WAS,22,25,18,22,0,0,0,87,NYK,27,30,31,15,0,0,0,103,20010107
2001,MIN,19,29,35,25,0,0,0,108,PHO,17,23,21,27,0,0,0,88,20010107
2001,SEA,18,29,22,23,0,0,0,92,TOR,28,22,27,17,0,0,0,94,20010107
2001,MIL,36,27,31,23,0,0,0,117,VAN,31,31,32,26,0,0,0,120,20010107
2001,POR,22,22,25,29,0,0,0,98,BOS,23,23,26,18,0,0,0,90,20010108
2001,DAL,29,26,25,24,0,0,0,104,CHI,24,26,22,19,0,0,0,91,20010108
2001,NJN,20,24,25,21,0,0,0,90,CLE,25,24,29,14,0,0,0,92,20010108
2001,IND,27,19,19,20,0,0,0,85,LAC,15,28,24,15,0,0,0,82,20010108
2001,GSW,24,11,16,27,0,0,0,78,MIA,18,22,29,19,0,0,0,88,20010108
2001,MIN,36,21,20,20,0,0,0,97,SAC,32,29,19,20,0,0,0,100,20010108
2001,SEA,26,35,11,23,0,0,0,95,ATL,20,23,22,21,0,0,0,86,20010109
2001,CHI,29,16,18,11,10,6,5,95,CHH,19,14,19,22,10,6,12,102,20010109
2001,WAS,23,21,22,29,0,0,0,95,MIL,27,24,27,21,0,0,0,99,20010109
2001,PHI,26,29,25,24,0,0,0,104,NJN,20,24,21,22,0,0,0,87,20010109
2001,SAS,23,33,25,31,0,0,0,112,ORL,17,18,34,26,0,0,0,95,20010109
2001,HOU,24,34,23,29,0,0,0,110,TOR,22,18,24,27,0,0,0,91,20010109
2001,IND,24,25,21,29,0,0,0,99,UTA,20,26,28,29,0,0,0,103,20010109
2001,DEN,27,26,29,30,0,0,0,112,VAN,28,23,33,21,0,0,0,105,20010109
2001,MIA,12,21,25,18,0,0,0,76,BOS,27,23,20,18,0,0,0,88,20010110
2001,TOR,33,29,28,20,0,0,0,110,DET,16,22,25,22,0,0,0,85,20010110
2001,DEN,26,12,20,28,0,0,0,86,LAC,23,29,17,23,0,0,0,92,20010110
2001,DAL,30,28,24,24,0,0,0,106,MIN,20,23,17,26,0,0,0,86,20010110
2001,POR,25,22,23,23,0,0,0,93,PHI,18,23,24,10,0,0,0,75,20010110
2001,CLE,34,21,22,26,0,0,0,103,SAC,36,23,23,26,0,0,0,108,20010110
2001,SEA,25,34,26,19,0,0,0,104,WAS,19,32,26,24,0,0,0,101,20010110
2001,GSW,25,22,34,15,0,0,0,96,ATL,28,30,30,19,0,0,0,107,20010111
2001,POR,32,11,15,25,0,0,0,83,CHH,18,24,16,12,0,0,0,70,20010111
2001,DAL,29,18,23,24,0,0,0,94,MIL,36,19,25,22,0,0,0,102,20010111
2001,ORL,30,20,27,24,0,0,0,101,NJN,24,33,13,17,0,0,0,87,20010111
2001,HOU,18,12,25,21,0,0,0,76,NYK,18,24,18,15,0,0,0,75,20010111
2001,IND,21,25,21,18,0,0,0,85,PHO,15,29,24,25,0,0,0,93,20010111
2001,TOR,30,24,9,30,0,0,0,93,BOS,28,18,9,17,0,0,0,72,20010112
2001,CHH,19,26,13,28,0,0,0,86,CHI,25,16,26,18,0,0,0,85,20010112
2001,SAC,28,25,18,22,0,0,0,93,DEN,31,20,27,28,0,0,0,106,20010112
2001,SAS,24,30,26,31,0,0,0,111,DET,34,16,16,24,0,0,0,90,20010112
2001,CLE,23,21,23,31,0,0,0,98,LAL,27,22,22,30,0,0,0,101,20010112
2001,LAC,19,25,25,20,0,0,0,89,MIN,23,17,30,25,0,0,0,95,20010112
2001,VAN,32,16,32,22,0,0,0,102,SEA,27,33,27,28,0,0,0,115,20010112
2001,PHI,19,24,27,16,0,0,0,86,WAS,15,23,18,26,0,0,0,82,20010112
2001,LAC,20,20,27,21,0,0,0,88,ATL,27,27,23,31,0,0,0,108,20010113
2001,PHO,24,27,25,27,0,0,0,103,DAL,21,23,21,21,0,0,0,86,20010113
2001,SAC,31,21,17,15,0,0,0,84,HOU,23,18,20,20,0,0,0,81,20010113
2001,MIA,25,15,21,10,0,0,0,71,IND,27,13,28,19,0,0,0,87,20010113
2001,NJN,28,14,26,13,0,0,0,81,MIL,26,27,38,24,0,0,0,115,20010113
2001,POR,12,25,17,24,0,0,0,78,NYK,31,18,23,19,0,0,0,91,20010113
2001,GSW,28,21,18,27,0,0,0,94,ORL,28,32,28,23,0,0,0,111,20010113
2001,SAS,27,21,16,19,0,0,0,83,PHI,28,26,22,24,0,0,0,100,20010113
2001,LAL,30,25,19,29,0,0,0,103,UTA,26,32,29,24,0,0,0,111,20010113
2001,CLE,29,18,32,28,0,0,0,107,VAN,30,26,32,31,0,0,0,119,20010113
2001,POR,37,22,17,27,0,0,0,103,DET,26,23,17,30,0,0,0,96,20010114
2001,CHI,20,20,28,13,0,0,0,81,MIA,20,21,22,27,0,0,0,90,20010114
2001,SEA,25,34,22,25,0,0,0,106,PHO,10,30,27,20,0,0,0,87,20010114
2001,CHH,26,24,19,30,0,0,0,99,TOR,23,24,37,23,0,0,0,107,20010114
2001,NJN,23,15,24,22,0,0,0,84,ATL,25,21,15,17,0,0,0,78,20010115
2001,SAC,39,26,30,21,0,0,0,116,DAL,33,25,18,29,0,0,0,105,20010115
2001,SEA,21,27,35,28,0,0,0,111,DEN,37,28,23,34,0,0,0,122,20010115
2001,CLE,29,29,18,31,0,0,0,107,GSW,23,30,29,19,0,0,0,101,20010115
2001,LAC,19,21,21,13,0,0,0,74,IND,21,22,23,23,0,0,0,89,20010115
2001,VAN,21,28,30,21,12,0,0,112,LAL,31,26,23,20,13,0,0,113,20010115
2001,BOS,20,31,25,31,0,0,0,107,MIN,28,24,24,26,0,0,0,102,20010115
2001,SAS,19,20,22,21,0,0,0,82,NYK,22,32,31,19,0,0,0,104,20010115
2001,CHI,26,32,20,26,0,0,0,104,ORL,16,31,28,38,0,0,0,113,20010115
2001,CHH,22,23,16,18,0,0,0,79,PHI,23,18,23,20,0,0,0,84,20010115
2001,HOU,18,24,20,35,7,0,0,104,UTA,17,25,24,31,19,0,0,116,20010115
2001,MIL,26,25,27,23,0,0,0,101,WAS,23,20,20,32,0,0,0,95,20010115
2001,TOR,21,22,25,31,0,0,0,99,HOU,30,24,32,28,0,0,0,114,20010116
2001,DET,20,21,26,18,0,0,0,85,MIA,28,23,19,23,0,0,0,93,20010116
2001,LAC,22,18,30,21,0,0,0,91,MIL,27,27,42,16,0,0,0,112,20010116
2001,CLE,20,28,19,16,0,0,0,83,POR,27,27,24,25,0,0,0,103,20010116
2001,DAL,21,17,27,26,0,0,0,91,CHH,29,19,28,14,0,0,0,90,20010117
2001,VAN,14,30,27,26,0,0,0,97,DEN,35,30,24,32,0,0,0,121,20010117
2001,WAS,25,23,29,12,0,0,0,89,NJN,28,35,23,22,0,0,0,108,20010117
2001,CHI,27,24,23,14,0,0,0,88,PHI,26,29,22,22,0,0,0,99,20010117
2001,BOS,27,26,32,21,0,0,0,106,SAC,31,27,25,28,0,0,0,111,20010117
2001,TOR,31,24,19,24,0,0,0,98,SAS,19,31,24,17,0,0,0,91,20010117
2001,PHO,24,20,22,23,0,0,0,89,SEA,19,29,14,18,0,0,0,80,20010117
2001,MIN,20,22,23,24,0,0,0,89,UTA,19,23,18,21,0,0,0,81,20010117
2001,DET,33,30,29,24,0,0,0,116,CHI,27,33,28,22,0,0,0,110,20010118
2001,ORL,37,17,18,27,7,0,0,106,DAL,15,29,23,32,16,0,0,115,20010118
2001,HOU,27,28,30,27,0,0,0,112,GSW,25,29,19,31,0,0,0,104,20010118
2001,ATL,17,19,21,19,0,0,0,76,IND,17,16,23,28,0,0,0,84,20010118
2001,BOS,24,18,16,24,0,0,0,82,LAC,16,14,26,23,0,0,0,79,20010118
2001,MIA,10,21,21,22,0,0,0,74,POR,27,14,28,16,0,0,0,85,20010118
2001,MIL,28,31,18,28,0,0,0,105,CHH,24,23,28,23,0,0,0,98,20010119
2001,CLE,17,25,21,25,0,0,0,88,DEN,20,27,19,25,0,0,0,91,20010119
2001,NYK,28,28,21,20,0,0,0,97,DET,26,21,23,21,0,0,0,91,20010119
2001,HOU,30,23,23,25,0,0,0,101,LAL,26,33,32,23,0,0,0,114,20010119
2001,NJN,12,25,33,16,0,0,0,86,PHI,30,24,22,21,0,0,0,97,20010119
2001,GSW,22,30,20,31,0,0,0,103,PHO,25,22,23,25,0,0,0,95,20010119
2001,MIN,21,24,34,19,0,0,0,98,SEA,28,24,19,22,0,0,0,93,20010119
2001,WAS,18,19,20,22,0,0,0,79,TOR,27,26,21,27,0,0,0,101,20010119
2001,MIA,22,28,20,27,0,0,0,97,VAN,12,22,27,25,0,0,0,86,20010119
2001,DEN,20,23,16,20,0,0,0,79,DAL,22,31,21,23,0,0,0,97,20010120
2001,CHI,24,33,20,26,0,0,0,103,NJN,37,30,24,32,0,0,0,123,20010120
2001,SAC,33,28,25,25,0,0,0,111,POR,34,23,25,19,0,0,0,101,20010120
2001,ORL,34,26,16,20,16,0,0,112,SAS,22,25,24,25,13,0,0,109,20010120
2001,MIL,26,23,27,26,0,0,0,102,DET,33,17,24,24,0,0,0,98,20010121
2001,BOS,27,21,24,19,0,0,0,91,GSW,24,26,22,22,0,0,0,94,20010121
2001,MIA,30,24,22,27,0,0,0,103,LAL,24,27,20,21,0,0,0,92,20010121
2001,IND,23,23,15,26,0,0,0,87,NYK,12,21,21,20,0,0,0,74,20010121
2001,TOR,22,22,34,18,14,0,0,110,PHI,38,22,19,17,10,0,0,106,20010121
2001,SAC,24,33,24,26,0,0,0,107,SEA,28,27,29,25,0,0,0,109,20010121
2001,PHO,24,27,21,26,0,0,0,98,UTA,30,23,24,32,0,0,0,109,20010121
2001,MIN,22,25,18,31,0,0,0,96,VAN,26,23,18,27,0,0,0,94,20010121
2001,ATL,22,25,17,26,0,0,0,90,WAS,19,23,22,30,0,0,0,94,20010121
2001,POR,15,9,21,13,0,0,0,58,CLE,17,22,20,25,0,0,0,84,20010122
2001,ATL,20,23,18,21,0,0,0,82,BOS,21,30,14,18,0,0,0,83,20010123
2001,POR,27,30,24,23,0,0,0,104,CHI,23,21,25,31,0,0,0,100,20010123
2001,PHI,32,19,30,33,0,0,0,114,DAL,20,28,23,27,0,0,0,98,20010123
2001,HOU,25,23,30,22,0,0,0,100,DEN,34,22,23,26,0,0,0,105,20010123
2001,NYK,23,26,21,21,0,0,0,91,MIL,31,27,24,23,0,0,0,105,20010123
2001,PHO,21,14,17,21,0,0,0,73,MIN,13,26,18,25,0,0,0,82,20010123
2001,TOR,19,24,27,27,5,9,0,111,ORL,28,19,22,28,5,14,0,116,20010123
2001,NJN,30,24,27,23,0,0,0,104,SAC,39,30,32,29,0,0,0,130,20010123
2001,VAN,22,16,17,22,0,0,0,77,SAS,28,32,22,28,0,0,0,110,20010123
2001,LAL,23,18,16,23,0,0,0,80,SEA,25,23,16,27,0,0,0,91,20010123
2001,GSW,14,17,24,23,0,0,0,78,UTA,27,25,27,21,0,0,0,100,20010123
2001,CHH,22,31,19,23,0,0,0,95,WAS,23,26,28,20,0,0,0,97,20010123
2001,NYK,22,14,16,15,0,0,0,67,CHH,21,17,26,17,0,0,0,81,20010124
2001,CHI,18,21,21,26,0,0,0,86,CLE,21,29,18,26,0,0,0,94,20010124
2001,PHO,24,23,30,29,0,0,0,106,DET,15,21,18,19,0,0,0,73,20010124
2001,NJN,24,27,18,18,0,0,0,87,GSW,25,30,32,22,0,0,0,109,20010124
2001,PHI,20,12,19,19,15,0,0,85,HOU,16,16,27,11,14,0,0,84,20010124
2001,SEA,22,31,23,24,14,0,0,114,LAC,26,28,22,24,10,0,0,110,20010124
2001,TOR,17,27,23,16,0,0,0,83,MIA,22,27,22,32,0,0,0,103,20010124
2001,VAN,23,20,21,19,0,0,0,83,DAL,32,39,28,21,0,0,0,120,20010125
2001,POR,27,20,12,33,0,0,0,92,IND,19,14,23,26,0,0,0,82,20010125
2001,ORL,30,21,25,24,0,0,0,100,MIN,32,25,21,31,0,0,0,109,20010125
2001,SAS,27,22,27,21,0,0,0,97,SAC,25,24,24,18,0,0,0,91,20010125
2001,DEN,21,27,27,21,0,0,0,96,UTA,27,23,20,28,0,0,0,98,20010125
2001,WAS,21,28,23,34,0,0,0,106,ATL,30,25,26,18,0,0,0,99,20010126
2001,PHO,22,22,12,27,0,0,0,83,BOS,22,23,27,27,0,0,0,99,20010126
2001,SEA,38,22,28,19,0,0,0,107,GSW,29,24,27,25,0,0,0,105,20010126
2001,VAN,27,22,19,21,0,0,0,89,HOU,27,32,32,15,0,0,0,106,20010126
2001,NJN,23,31,27,20,0,0,0,101,LAL,26,29,34,24,0,0,0,113,20010126
2001,DET,21,20,26,22,0,0,0,89,PHI,25,33,15,32,0,0,0,105,20010126
2001,HOU,24,32,32,22,0,0,0,110,CHH,31,11,27,28,0,0,0,97,20010127
2001,TOR,22,26,21,21,0,0,0,90,CHI,19,26,18,17,0,0,0,80,20010127
2001,ATL,29,25,28,19,0,0,0,101,CLE,22,21,26,21,0,0,0,90,20010127
2001,DAL,22,36,16,26,0,0,0,100,DEN,32,21,28,21,0,0,0,102,20010127
2001,SAC,29,28,26,18,0,0,0,101,LAC,24,23,17,25,0,0,0,89,20010127
2001,DET,27,28,23,30,0,0,0,108,MIL,22,29,22,30,0,0,0,103,20010127
2001,POR,20,19,28,13,0,0,0,80,MIN,23,24,26,20,0,0,0,93,20010127
2001,MIA,16,19,17,29,0,0,0,81,ORL,18,20,12,9,0,0,0,59,20010127
2001,NJN,25,32,19,21,0,0,0,97,SEA,24,25,33,24,0,0,0,106,20010127
2001,SAS,29,25,21,24,0,0,0,99,UTA,16,26,20,24,0,0,0,86,20010127
2001,PHO,20,25,13,24,0,0,0,82,WAS,26,15,19,29,0,0,0,89,20010127
2001,PHI,19,18,18,31,0,0,0,86,IND,18,16,23,24,0,0,0,81,20010128
2001,LAL,19,14,21,27,0,0,0,81,NYK,33,14,20,24,0,0,0,91,20010128
2001,PHO,24,28,16,27,0,0,0,95,ATL,18,25,24,15,0,0,0,82,20010129
2001,DET,29,21,22,15,0,0,0,87,BOS,19,18,29,33,0,0,0,99,20010129
2001,UTA,26,21,24,26,0,0,0,97,DEN,13,23,22,33,0,0,0,91,20010129
2001,CHH,29,29,22,13,0,0,0,93,GSW,25,21,26,13,0,0,0,85,20010129
2001,SAS,28,21,25,22,0,0,0,96,LAC,13,15,18,21,0,0,0,67,20010129
2001,MIL,22,24,25,25,0,0,0,96,MIN,27,16,25,31,0,0,0,99,20010129
2001,NJN,35,24,13,14,0,0,0,86,VAN,14,26,25,32,0,0,0,97,20010129
2001,CLE,20,18,22,29,0,0,0,89,WAS,28,29,21,17,0,0,0,95,20010129
2001,LAL,35,18,29,20,0,0,0,102,CLE,26,15,22,33,0,0,0,96,20010130
2001,MIA,31,27,18,27,0,0,0,103,HOU,23,17,19,26,0,0,0,85,20010130
2001,IND,24,12,30,20,0,0,0,86,ORL,25,19,20,29,0,0,0,93,20010130
2001,CHI,26,13,18,24,0,0,0,81,POR,27,17,15,33,0,0,0,92,20010130
2001,GSW,29,10,22,18,0,0,0,79,SAC,35,22,24,24,0,0,0,105,20010130
2001,UTA,24,24,28,26,0,0,0,102,SEA,29,21,17,21,0,0,0,88,20010130
2001,PHI,33,22,13,21,0,0,0,89,TOR,28,26,19,23,0,0,0,96,20010130
2001,TOR,28,18,25,26,0,0,0,97,ATL,30,28,20,24,0,0,0,102,20010131
2001,BOS,16,28,23,20,15,0,0,102,IND,25,20,20,22,9,0,0,96,20010131
2001,DEN,22,24,29,36,0,0,0,111,MIL,29,29,21,37,0,0,0,116,20010131
2001,LAL,19,23,19,22,0,0,0,83,MIN,31,23,15,27,0,0,0,96,20010131
2001,DET,20,36,19,37,0,0,0,112,NJN,30,19,28,26,0,0,0,103,20010131
2001,VAN,23,24,29,16,0,0,0,92,PHO,30,29,20,22,0,0,0,101,20010131
2001,LAC,16,18,16,20,0,0,0,70,SAS,23,14,31,24,0,0,0,92,20010131
2001,ORL,33,18,15,34,0,0,0,100,WAS,28,19,27,22,0,0,0,96,20010131
2001,MIN,23,21,20,26,0,0,0,90,CLE,21,18,20,22,0,0,0,81,20010201
2001,MIA,24,22,19,22,4,0,0,91,DAL,24,24,24,15,8,0,0,95,20010201
2001,LAC,22,28,29,22,0,0,0,101,HOU,14,22,21,27,0,0,0,84,20010201
2001,PHI,22,24,23,18,0,0,0,87,NYK,18,19,24,19,0,0,0,80,20010201
2001,PHO,23,22,19,28,0,0,0,92,POR,22,19,32,27,0,0,0,100,20010201
2001,CHI,15,24,30,22,0,0,0,91,SEA,22,30,22,23,0,0,0,97,20010201
2001,CHH,22,16,27,11,0,0,0,76,UTA,15,29,29,14,0,0,0,87,20010201
2001,MIA,19,22,27,23,0,0,0,91,ATL,17,22,25,16,0,0,0,80,20010202
2001,BOS,29,35,18,20,0,0,0,102,DET,29,23,20,23,0,0,0,95,20010202
2001,DEN,21,31,16,26,0,0,0,94,IND,22,29,19,33,0,0,0,103,20010202
2001,CHH,28,25,19,15,0,0,0,87,LAL,29,28,16,20,0,0,0,93,20010202
2001,NYK,26,23,25,21,0,0,0,95,NJN,19,23,19,10,0,0,0,71,20010202
2001,ORL,23,22,40,17,6,15,0,123,PHI,27,25,22,28,6,9,0,117,20010202
2001,VAN,15,21,28,31,0,0,0,95,SAC,31,32,23,19,0,0,0,105,20010202
2001,DET,28,20,12,19,9,0,0,88,CLE,17,22,21,19,2,0,0,81,20010203
2001,GSW,25,27,16,27,0,0,0,95,DAL,28,22,24,27,0,0,0,101,20010203
2001,POR,28,22,24,15,0,0,0,89,LAC,27,17,29,17,0,0,0,90,20010203
2001,IND,18,21,16,30,0,0,0,85,MIL,30,25,30,19,0,0,0,104,20010203
2001,ATL,25,26,17,16,0,0,0,84,ORL,21,22,27,26,0,0,0,96,20010203
2001,HOU,21,21,19,27,0,0,0,88,SAS,22,18,21,29,0,0,0,90,20010203
2001,MIN,22,31,28,27,0,0,0,108,TOR,22,24,27,32,0,0,0,105,20010203
2001,SEA,20,27,27,17,0,0,0,91,UTA,27,23,33,28,0,0,0,111,20010203
2001,CHI,16,21,25,22,0,0,0,84,VAN,23,18,26,24,0,0,0,91,20010203
2001,DEN,29,25,24,27,0,0,0,105,WAS,30,24,32,14,0,0,0,100,20010203
2001,CLE,19,23,21,19,0,0,0,82,BOS,32,27,26,18,0,0,0,103,20010204
2001,SAC,21,30,20,23,0,0,0,94,LAL,33,21,26,20,0,0,0,100,20010204
2001,NYK,27,23,26,15,12,0,0,103,MIA,30,22,21,18,9,0,0,100,20010204
2001,PHI,20,28,24,17,0,0,0,89,NJN,22,21,19,34,0,0,0,96,20010204
2001,CHH,23,21,22,16,0,0,0,82,PHO,22,21,20,22,0,0,0,85,20010204
2001,DAL,23,13,32,23,0,0,0,91,ATL,24,26,16,15,0,0,0,81,20010205
2001,NYK,37,21,12,16,0,0,0,86,HOU,27,19,34,20,0,0,0,100,20010205
2001,CHI,24,21,18,19,0,0,0,82,LAC,22,25,25,30,0,0,0,102,20010205
2001,DEN,17,28,18,17,0,0,0,80,PHI,31,28,16,24,0,0,0,99,20010205
2001,GSW,23,18,10,34,0,0,0,85,SAS,22,31,28,28,0,0,0,109,20010205
2001,VAN,25,25,15,17,0,0,0,82,SEA,26,25,16,28,0,0,0,95,20010205
2001,BOS,27,20,23,28,0,0,0,98,TOR,30,26,28,26,0,0,0,110,20010205
2001,ORL,23,21,34,31,0,0,0,109,CHH,21,22,21,19,0,0,0,83,20010206
2001,DEN,25,14,21,23,0,0,0,83,DET,29,28,17,20,0,0,0,94,20010206
2001,IND,26,22,22,19,0,0,0,89,MIA,28,24,32,18,0,0,0,102,20010206
2001,SAC,24,27,26,32,0,0,0,109,MIL,27,32,32,21,0,0,0,112,20010206
2001,ATL,21,18,18,27,0,0,0,84,NJN,26,24,21,19,0,0,0,90,20010206
2001,CHI,25,20,14,21,0,0,0,80,PHO,20,28,30,19,0,0,0,97,20010206
2001,MIL,17,26,26,22,0,0,0,91,BOS,23,21,20,30,0,0,0,94,20010207
2001,SAS,29,20,24,34,0,0,0,107,CLE,18,22,25,24,0,0,0,89,20010207
2001,LAC,21,23,22,22,0,0,0,88,GSW,20,22,22,25,0,0,0,89,20010207
2001,PHO,14,26,19,24,0,0,0,83,LAL,21,22,27,15,0,0,0,85,20010207
2001,SAC,10,21,35,22,0,0,0,88,MIN,41,21,33,22,0,0,0,117,20010207
2001,DAL,20,20,24,16,7,6,0,93,NYK,19,21,21,19,7,9,0,96,20010207
2001,WAS,27,28,23,20,0,0,0,98,ORL,22,29,28,28,0,0,0,107,20010207
2001,HOU,26,26,29,31,0,0,0,112,PHI,21,21,27,18,0,0,0,87,20010207
2001,SEA,20,19,19,22,0,0,0,80,POR,18,25,22,32,0,0,0,97,20010207
2001,UTA,27,17,22,26,0,0,0,92,VAN,21,21,20,20,0,0,0,82,20010207
2001,ATL,18,23,22,21,0,0,0,84,CHH,25,31,20,25,0,0,0,101,20010208
2001,HOU,34,23,22,24,0,0,0,103,DET,18,29,21,22,0,0,0,90,20010208
2001,SAS,23,21,23,30,0,0,0,97,NJN,28,27,19,25,0,0,0,99,20010208
2001,DEN,30,28,17,17,0,0,0,92,TOR,21,26,25,27,0,0,0,99,20010208
2001,ATL,12,30,33,17,0,0,0,92,CHI,26,30,20,20,0,0,0,96,20010213
2001,TOR,28,28,33,31,0,0,0,120,CLE,25,21,21,38,0,0,0,105,20010213
2001,NYK,27,17,18,15,0,0,0,77,DEN,32,22,20,22,0,0,0,96,20010213
2001,PHO,21,27,17,28,0,0,0,93,GSW,14,20,17,32,0,0,0,83,20010213
2001,WAS,27,20,18,24,0,0,0,89,HOU,25,29,24,21,0,0,0,99,20010213
2001,CHH,17,25,20,15,0,0,0,77,IND,18,20,14,14,0,0,0,66,20010213
2001,LAC,24,27,21,18,9,0,0,99,MIA,19,18,23,30,11,0,0,101,20010213
2001,PHI,27,32,22,26,0,0,0,107,MIL,25,26,36,17,0,0,0,104,20010213
2001,LAL,29,15,30,30,9,0,0,113,NJN,23,14,34,33,6,0,0,110,20010213
2001,MIN,16,23,19,30,0,0,0,88,POR,28,26,27,28,0,0,0,109,20010213
2001,DAL,22,19,20,31,0,0,0,92,SAS,22,29,20,33,0,0,0,104,20010213
2001,SAC,28,27,18,16,8,0,0,97,UTA,19,33,21,16,5,0,0,94,20010213
2001,BOS,23,30,22,23,0,0,0,98,VAN,24,21,24,30,0,0,0,99,20010213
2001,MIL,25,25,23,29,0,0,0,102,ATL,27,28,25,18,0,0,0,98,20010214
2001,NJN,16,23,25,22,0,0,0,86,DET,27,30,27,21,0,0,0,105,20010214
2001,LAC,23,22,30,26,0,0,0,101,ORL,29,32,29,24,0,0,0,114,20010214
2001,LAL,25,23,22,27,0,0,0,97,PHI,29,26,27,30,0,0,0,112,20010214
2001,MIN,23,27,17,29,0,0,0,96,PHO,24,21,26,33,0,0,0,104,20010214
2001,NYK,26,24,25,15,0,0,0,90,UTA,23,33,25,25,0,0,0,106,20010214
2001,CLE,21,25,15,20,0,0,0,81,DAL,31,21,23,27,0,0,0,102,20010215
2001,DET,20,18,14,21,0,0,0,73,IND,26,20,16,20,0,0,0,82,20010215
2001,SAC,17,23,20,21,0,0,0,81,POR,32,28,27,18,0,0,0,105,20010215
2001,WAS,14,23,23,18,0,0,0,78,SAS,25,27,31,19,0,0,0,102,20010215
2001,BOS,33,34,23,18,0,0,0,108,SEA,18,27,22,21,0,0,0,88,20010215
2001,MIA,28,23,14,21,12,0,0,98,TOR,21,22,22,21,5,0,0,91,20010215
2001,GSW,22,23,20,24,0,0,0,89,VAN,22,33,18,26,0,0,0,99,20010215
2001,LAL,20,29,22,28,0,0,0,99,CHH,24,23,20,27,0,0,0,94,20010216
2001,VAN,27,23,25,17,0,0,0,92,GSW,26,20,20,13,0,0,0,79,20010216
2001,SAS,18,31,24,18,0,0,0,91,MIN,18,27,19,21,0,0,0,85,20010216
2001,NJN,18,32,25,29,0,0,0,104,NYK,27,31,27,29,0,0,0,114,20010216
2001,HOU,22,21,23,27,0,0,0,93,ORL,26,26,31,25,0,0,0,108,20010216
2001,LAC,18,27,23,25,0,0,0,93,PHI,36,19,24,29,0,0,0,108,20010216
2001,DEN,31,7,22,24,0,0,0,84,SAC,35,24,28,30,0,0,0,117,20010216
2001,MIA,17,14,30,21,0,0,0,82,CHI,23,32,9,25,0,0,0,89,20010217
2001,WAS,25,30,24,26,0,0,0,105,DAL,26,33,27,26,0,0,0,112,20010217
2001,CLE,26,18,15,21,0,0,0,80,HOU,34,14,17,27,0,0,0,92,20010217
2001,CHH,23,26,27,27,0,0,0,103,MIL,20,30,17,26,0,0,0,93,20010217
2001,BOS,26,19,16,24,0,0,0,85,POR,22,18,18,23,0,0,0,81,20010217
2001,ATL,25,16,29,31,0,0,0,101,SEA,23,19,25,27,0,0,0,94,20010217
2001,WAS,32,21,26,22,0,0,0,101,DEN,33,15,27,23,0,0,0,98,20010218
2001,ATL,34,16,21,27,0,0,0,98,GSW,27,22,27,15,0,0,0,91,20010218
2001,LAL,31,29,23,26,0,0,0,109,IND,25,21,28,36,0,0,0,110,20010218
2001,VAN,21,29,28,32,0,0,0,110,MIN,26,26,22,28,0,0,0,102,20010218
2001,LAC,25,24,20,23,4,0,0,96,NJN,12,25,36,19,10,0,0,102,20010218
2001,NYK,19,20,28,21,0,0,0,88,ORL,22,20,28,26,0,0,0,96,20010218
2001,PHO,32,15,24,27,0,0,0,98,PHI,26,28,26,24,0,0,0,104,20010218
2001,UTA,20,19,25,30,0,0,0,94,SAC,24,20,27,19,0,0,0,90,20010218
2001,SAS,33,18,19,22,0,0,0,92,TOR,17,12,19,26,0,0,0,74,20010218
2001,CHI,25,21,25,13,0,0,0,84,CLE,21,23,18,23,0,0,0,85,20010219
2001,LAC,30,30,16,20,15,0,0,111,DET,21,25,20,30,10,0,0,106,20010219
2001,SAS,32,18,29,19,0,0,0,98,MIL,26,28,22,26,0,0,0,102,20010219
2001,BOS,17,27,26,29,0,0,0,99,UTA,27,31,31,25,0,0,0,114,20010219
2001,MIL,23,19,24,35,0,0,0,101,CHI,24,29,21,18,0,0,0,92,20010220
2001,LAL,25,34,30,30,0,0,0,119,DAL,26,29,23,31,0,0,0,109,20010220
2001,BOS,19,22,22,21,0,0,0,84,HOU,29,24,29,19,0,0,0,101,20010220
2001,MIA,18,23,21,12,0,0,0,74,NYK,22,18,20,16,0,0,0,76,20010220
2001,PHO,24,23,30,33,0,0,0,110,ORL,22,23,32,27,0,0,0,104,20010220
2001,DEN,27,14,22,31,0,0,0,94,POR,26,28,20,30,0,0,0,104,20010220
2001,ATL,12,18,25,25,0,0,0,80,SAC,28,19,25,22,0,0,0,94,20010220
2001,GSW,24,31,26,21,0,0,0,102,TOR,29,27,26,31,0,0,0,113,20010220
2001,VAN,26,33,24,33,0,0,0,116,WAS,24,26,20,34,0,0,0,104,20010220
2001,LAC,23,24,26,27,0,0,0,100,CLE,29,22,21,22,0,0,0,94,20010221
2001,NYK,15,22,21,27,0,0,0,85,DET,20,25,32,13,0,0,0,90,20010221
2001,PHO,28,26,26,20,0,0,0,100,MIA,20,20,15,30,0,0,0,85,20010221
2001,HOU,21,28,22,18,0,0,0,89,MIN,26,12,27,18,0,0,0,83,20010221
2001,TOR,26,31,23,31,0,0,0,111,NJN,26,32,29,26,0,0,0,113,20010221
2001,VAN,29,21,24,17,0,0,0,91,PHI,22,29,29,27,0,0,0,107,20010221
2001,LAL,29,18,28,26,0,0,0,101,SAS,25,23,25,26,0,0,0,99,20010221
2001,DEN,27,21,23,27,0,0,0,98,SEA,35,36,27,29,0,0,0,127,20010221
2001,GSW,33,24,21,13,0,0,0,91,CHH,24,25,23,21,0,0,0,93,20010222
2001,LAC,18,23,23,29,0,0,0,93,CHI,19,23,14,24,0,0,0,80,20010222
2001,BOS,28,18,23,22,0,0,0,91,DAL,24,32,25,17,0,0,0,98,20010222
2001,UTA,22,24,21,23,0,0,0,90,POR,21,19,18,26,0,0,0,84,20010222
2001,SAC,23,28,28,36,0,0,0,115,WAS,20,24,28,38,0,0,0,110,20010222
2001,IND,19,21,22,30,0,0,0,92,CLE,18,23,23,26,0,0,0,90,20010223
2001,PHI,36,25,15,23,0,0,0,99,DET,27,12,20,19,0,0,0,78,20010223
2001,ORL,28,26,26,15,0,0,0,95,HOU,26,31,27,21,0,0,0,105,20010223
2001,ATL,27,23,24,32,0,0,0,106,LAL,34,33,17,29,0,0,0,113,20010223
2001,VAN,25,22,22,12,0,0,0,81,MIL,27,27,19,20,0,0,0,93,20010223
2001,GSW,22,22,13,26,0,0,0,83,MIN,30,34,35,23,0,0,0,122,20010223
2001,PHO,24,18,21,17,8,0,0,88,NYK,19,19,26,16,4,0,0,84,20010223
2001,BOS,19,21,22,20,0,0,0,82,SAS,30,27,28,15,0,0,0,100,20010223
2001,UTA,22,22,23,29,0,0,0,96,SEA,16,32,19,17,0,0,0,84,20010223
2001,SAC,31,19,25,22,8,7,7,119,TOR,29,17,33,18,8,7,6,118,20010223
2001,PHI,21,21,16,27,0,0,0,85,CHH,19,22,23,22,0,0,0,86,20010224
2001,VAN,22,16,25,12,0,0,0,75,CHI,29,24,20,17,0,0,0,90,20010224
2001,SAS,21,31,21,34,0,0,0,107,DAL,28,17,26,33,0,0,0,104,20010224
2001,ATL,17,26,23,16,0,0,0,82,DEN,27,26,15,17,0,0,0,85,20010224
2001,POR,25,25,8,43,13,6,0,120,LAC,24,27,23,27,13,9,0,123,20010224
2001,NJN,22,13,9,26,0,0,0,70,MIA,25,19,18,13,0,0,0,75,20010224
2001,TOR,30,30,36,10,0,0,0,106,WAS,23,22,33,21,0,0,0,99,20010224
2001,CLE,22,30,24,25,0,0,0,101,DET,24,25,27,18,0,0,0,94,20010225
2001,MIN,18,25,27,30,0,0,0,100,IND,30,27,20,33,0,0,0,110,20010225
2001,ORL,28,26,22,24,0,0,0,100,LAL,25,20,26,35,0,0,0,106,20010225
2001,GSW,24,34,23,14,0,0,0,95,MIL,36,27,35,24,0,0,0,122,20010225
2001,WAS,28,13,21,29,0,0,0,91,NJN,25,27,26,23,0,0,0,101,20010225
2001,SAC,21,30,26,9,0,0,0,86,NYK,16,31,23,18,0,0,0,88,20010225
2001,UTA,20,17,28,15,0,0,0,80,PHO,24,25,23,18,0,0,0,90,20010225
2001,SEA,24,12,24,22,0,0,0,82,BOS,19,25,18,23,0,0,0,85,20010226
2001,IND,11,21,19,21,0,0,0,72,CHH,15,26,16,25,0,0,0,82,20010226
2001,GSW,23,22,24,15,0,0,0,84,CHI,27,23,11,17,0,0,0,78,20010226
2001,ORL,18,28,26,21,0,0,0,93,DEN,30,19,18,19,0,0,0,86,20010226
2001,POR,22,26,21,26,0,0,0,95,HOU,28,27,20,14,0,0,0,89,20010226
2001,DAL,32,22,22,27,0,0,0,103,LAC,27,23,20,22,0,0,0,92,20010226
2001,MIL,24,22,21,31,0,0,0,98,PHI,14,25,21,31,0,0,0,91,20010226
2001,ATL,25,19,20,18,0,0,0,82,UTA,25,27,25,22,0,0,0,99,20010226
2001,WAS,26,21,25,23,0,0,0,95,MIA,27,22,25,29,0,0,0,103,20010227
2001,SEA,27,25,13,27,0,0,0,92,NYK,31,28,21,21,0,0,0,101,20010227
2001,LAC,25,23,17,24,4,0,0,93,SAC,24,23,20,22,17,0,0,106,20010227
2001,POR,17,21,33,24,0,0,0,95,SAS,28,21,16,22,0,0,0,87,20010227
2001,CLE,26,19,22,22,0,0,0,89,TOR,28,23,31,19,0,0,0,101,20010227
2001,DAL,41,24,22,29,0,0,0,116,VAN,24,33,26,29,0,0,0,112,20010227
2001,TOR,30,23,22,20,0,0,0,95,ATL,26,22,24,16,0,0,0,88,20010228
2001,NJN,14,36,20,18,0,0,0,88,CHH,17,25,27,22,0,0,0,91,20010228
2001,HOU,19,28,26,22,0,0,0,95,CHI,29,14,19,16,0,0,0,78,20010228
2001,LAL,27,30,22,22,0,0,0,101,DEN,25,26,24,32,0,0,0,107,20010228
2001,SAC,32,32,29,29,0,0,0,122,GSW,34,21,25,21,0,0,0,101,20010228
2001,MIL,25,19,20,22,0,0,0,86,IND,28,31,28,12,0,0,0,99,20010228
2001,DET,22,33,14,31,0,0,0,100,MIN,36,17,27,31,0,0,0,111,20010228
2001,MIA,17,15,21,16,0,0,0,69,PHI,18,22,20,19,0,0,0,79,20010228
2001,ORL,29,24,21,23,0,0,0,97,PHO,22,23,23,23,0,0,0,91,20010228
2001,VAN,25,24,17,17,0,0,0,83,UTA,31,20,27,23,0,0,0,101,20010228
2001,SEA,18,30,19,26,8,0,0,101,CLE,26,25,21,21,6,0,0,99,20010301
2001,HOU,30,27,36,15,0,0,0,108,MIL,23,22,30,16,0,0,0,91,20010301
2001,BOS,16,22,32,18,0,0,0,88,NYK,22,29,26,18,0,0,0,95,20010301
2001,LAC,26,20,16,19,0,0,0,81,POR,25,20,24,25,0,0,0,94,20010301
2001,PHO,14,24,19,14,0,0,0,71,SAS,22,23,22,24,0,0,0,91,20010301
2001,CHH,28,28,17,32,0,0,0,105,ATL,34,20,27,18,0,0,0,99,20010302
2001,UTA,20,30,27,22,0,0,0,99,BOS,21,33,26,23,0,0,0,103,20010302
2001,NYK,21,24,16,11,0,0,0,72,CHI,27,20,18,16,0,0,0,81,20010302
2001,MIN,16,29,26,18,0,0,0,89,DEN,21,14,17,19,0,0,0,71,20010302
2001,MIA,20,17,17,31,12,0,0,97,DET,23,20,25,17,8,0,0,93,20010302
2001,SEA,26,24,23,13,0,0,0,86,IND,17,23,12,31,0,0,0,83,20010302
2001,SAC,22,17,21,21,0,0,0,81,LAC,21,25,18,24,0,0,0,88,20010302
2001,CLE,20,21,19,34,0,0,0,94,ORL,30,28,30,32,0,0,0,120,20010302
2001,WAS,28,18,28,28,0,0,0,102,PHI,32,27,25,23,0,0,0,107,20010302
2001,NJN,28,16,27,19,0,0,0,90,TOR,22,24,25,36,0,0,0,107,20010302
2001,HOU,27,20,30,18,0,0,0,95,DAL,20,28,23,29,0,0,0,100,20010303
2001,CHI,29,22,26,18,15,12,0,122,MIL,28,23,30,14,15,16,0,126,20010303
2001,DEN,21,24,16,21,0,0,0,82,PHO,22,18,30,27,0,0,0,97,20010303
2001,GSW,20,27,20,24,0,0,0,91,POR,37,27,33,25,0,0,0,122,20010303
2001,ATL,24,28,21,22,0,0,0,95,SAS,33,25,38,28,0,0,0,124,20010303
2001,LAL,21,30,22,25,0,0,0,98,VAN,21,20,23,24,0,0,0,88,20010303
2001,CHH,39,25,26,26,0,0,0,116,BOS,32,16,20,29,0,0,0,97,20010304
2001,MIA,20,27,23,21,0,0,0,91,CLE,17,25,14,23,0,0,0,79,20010304
2001,ORL,26,14,24,20,0,0,0,84,DET,36,21,18,18,0,0,0,93,20010304
2001,NJN,29,32,31,28,0,0,0,120,IND,16,30,29,21,0,0,0,96,20010304
2001,GSW,16,30,23,26,0,0,0,95,LAL,43,18,32,17,0,0,0,110,20010304
2001,SEA,26,29,24,24,8,0,0,111,MIN,25,29,22,27,16,0,0,119,20010304
2001,NYK,20,27,12,29,0,0,0,88,TOR,25,22,21,30,0,0,0,98,20010304
2001,UTA,26,32,32,28,0,0,0,118,WAS,17,18,32,31,0,0,0,98,20010304
2001,UTA,24,34,26,25,0,0,0,109,ATL,24,27,32,19,0,0,0,102,20010305
2001,DEN,21,36,17,12,0,0,0,86,LAC,26,25,16,32,0,0,0,99,20010305
2001,DET,25,21,18,20,0,0,0,84,MIA,25,24,23,15,0,0,0,87,20010305
2001,MIL,25,33,19,30,0,0,0,107,NJN,20,21,33,26,0,0,0,100,20010305
2001,DAL,19,28,22,12,0,0,0,81,ORL,24,20,27,24,0,0,0,95,20010305
2001,SAS,23,24,20,24,0,0,0,91,VAN,26,23,18,10,0,0,0,77,20010305
2001,MIN,31,19,20,25,0,0,0,95,CHH,19,17,28,25,0,0,0,89,20010306
2001,CLE,18,23,14,19,0,0,0,74,CHI,29,27,18,13,0,0,0,87,20010306
2001,PHO,27,26,19,21,0,0,0,93,DEN,17,18,17,30,0,0,0,82,20010306
2001,LAL,18,25,28,26,0,0,0,97,GSW,22,16,26,21,0,0,0,85,20010306
2001,IND,30,19,20,14,0,0,0,83,NYK,13,35,27,22,0,0,0,97,20010306
2001,VAN,26,20,26,33,0,0,0,105,POR,29,21,26,21,0,0,0,97,20010306
2001,TOR,27,17,24,23,0,0,0,91,SAC,17,21,35,25,0,0,0,98,20010306
2001,SAS,24,34,17,26,0,0,0,101,SEA,17,17,25,14,0,0,0,73,20010306
2001,HOU,19,20,32,33,0,0,0,104,ATL,29,30,18,21,0,0,0,98,20010307
2001,MIL,19,26,28,28,0,0,0,101,BOS,21,23,26,24,0,0,0,94,20010307
2001,WAS,24,25,18,21,0,0,0,88,CLE,18,32,16,17,0,0,0,83,20010307
2001,NYK,23,18,16,22,0,0,0,79,IND,22,23,19,11,0,0,0,75,20010307
2001,TOR,24,19,24,18,0,0,0,85,LAL,16,29,31,21,0,0,0,97,20010307
2001,DAL,28,18,21,26,0,0,0,93,MIA,18,22,26,20,0,0,0,86,20010307
2001,DET,23,26,30,23,0,0,0,102,ORL,33,31,26,22,0,0,0,112,20010307
2001,NJN,29,27,23,15,0,0,0,94,PHI,26,26,23,27,0,0,0,102,20010307
2001,SAC,17,23,30,30,0,0,0,100,PHO,31,33,9,16,0,0,0,89,20010307
2001,SEA,25,11,21,25,0,0,0,82,UTA,17,22,26,21,0,0,0,86,20010307
2001,ORL,20,25,17,22,0,0,0,84,CHH,29,27,19,22,0,0,0,97,20010308
2001,LAC,21,24,31,11,0,0,0,87,HOU,28,16,23,32,0,0,0,99,20010308
2001,SAS,27,24,27,15,0,0,0,93,POR,19,23,14,23,0,0,0,79,20010308
2001,WAS,18,20,19,15,0,0,0,72,BOS,26,32,22,24,0,0,0,104,20010309
2001,GSW,23,20,15,15,0,0,0,73,DAL,34,18,21,29,0,0,0,102,20010309
2001,CHI,27,17,16,15,0,0,0,75,DET,28,27,30,23,0,0,0,108,20010309
2001,CLE,27,15,21,21,0,0,0,84,IND,25,23,29,22,0,0,0,99,20010309
2001,SAS,29,15,22,17,10,0,0,93,LAL,20,21,25,17,6,0,0,89,20010309
2001,MIN,27,22,12,18,0,0,0,79,MIA,22,23,18,23,0,0,0,86,20010309
2001,NYK,22,15,22,24,0,0,0,83,NJN,23,31,25,17,0,0,0,96,20010309
2001,ATL,28,24,18,33,0,0,0,103,PHI,33,22,30,23,0,0,0,108,20010309
2001,DEN,28,23,22,31,0,0,0,104,SAC,28,27,30,25,0,0,0,110,20010309
2001,TOR,28,23,23,36,0,0,0,110,SEA,16,36,22,25,0,0,0,99,20010309
2001,PHO,19,21,17,38,0,0,0,95,UTA,22,27,30,28,0,0,0,107,20010309
2001,POR,28,15,27,15,0,0,0,85,VAN,22,23,27,23,0,0,0,95,20010309
2001,CHI,21,27,14,28,0,0,0,90,ATL,24,24,20,25,0,0,0,93,20010310
2001,MIL,23,24,21,22,0,0,0,90,CHH,21,25,28,26,0,0,0,100,20010310
2001,GSW,30,16,15,20,0,0,0,81,HOU,25,19,22,20,0,0,0,86,20010310
2001,MIN,25,22,25,21,0,0,0,93,ORL,23,28,34,20,0,0,0,105,20010310
2001,NJN,33,26,21,21,0,0,0,101,WAS,22,35,25,25,0,0,0,107,20010310
2001,PHI,29,21,23,24,0,0,0,97,BOS,23,28,15,25,0,0,0,91,20010311
2001,MIL,26,25,36,23,0,0,0,110,CLE,35,27,32,30,0,0,0,124,20010311
2001,LAC,23,27,18,25,0,0,0,93,DAL,32,31,29,19,0,0,0,111,20010311
2001,IND,23,21,18,16,0,0,0,78,DET,26,23,18,28,0,0,0,95,20010311
2001,SEA,25,30,21,17,16,0,0,109,LAL,34,18,20,21,4,0,0,97,20010311
2001,MIA,35,11,12,25,0,0,0,83,NYK,16,24,24,22,0,0,0,86,20010311
2001,HOU,23,30,21,18,0,0,0,92,PHO,20,25,21,28,0,0,0,94,20010311
2001,UTA,31,15,18,26,0,0,0,90,SAC,28,21,27,29,0,0,0,105,20010311
2001,TOR,28,23,30,20,0,0,0,101,VAN,28,17,18,21,0,0,0,84,20010311
2001,CHI,20,32,18,24,0,0,0,94,CHH,35,22,24,21,0,0,0,102,20010312
2001,DEN,26,15,20,23,0,0,0,84,GSW,20,17,29,13,0,0,0,79,20010312
2001,MIA,20,27,12,18,0,0,0,77,MIN,31,26,19,18,0,0,0,94,20010312
2001,LAC,18,20,21,22,0,0,0,81,SAS,28,27,24,20,0,0,0,99,20010312
2001,VAN,14,23,30,32,0,0,0,99,ATL,23,31,24,31,0,0,0,109,20010313
2001,NJN,25,27,22,24,0,0,0,98,DAL,28,28,34,32,0,0,0,122,20010313
2001,IND,25,23,28,16,10,10,6,118,HOU,25,30,19,18,10,10,15,127,20010313
2001,BOS,22,32,24,29,0,0,0,107,LAL,23,26,31,32,0,0,0,112,20010313
2001,CLE,21,18,22,18,0,0,0,79,NYK,26,31,26,15,0,0,0,98,20010313
2001,SAC,34,23,25,20,12,0,0,114,ORL,28,24,35,15,6,0,0,108,20010313
2001,POR,22,26,16,26,0,0,0,90,SEA,24,29,22,24,0,0,0,99,20010313
2001,MIL,33,33,24,11,0,0,0,101,TOR,32,24,15,26,0,0,0,97,20010313
2001,VAN,28,24,16,27,0,0,0,95,CHH,25,33,16,26,0,0,0,100,20010314
2001,PHI,25,27,14,19,0,0,0,85,CHI,13,15,15,24,0,0,0,67,20010314
2001,ORL,29,21,22,25,0,0,0,97,CLE,24,22,21,20,0,0,0,87,20010314
2001,IND,16,23,23,21,0,0,0,83,DEN,19,21,28,27,0,0,0,95,20010314
2001,UTA,27,22,19,34,0,0,0,102,GSW,12,23,25,23,0,0,0,83,20010314
2001,SAC,35,14,29,26,0,0,0,104,MIA,23,34,30,27,0,0,0,114,20010314
2001,PHO,23,15,24,22,0,0,0,84,POR,13,14,28,24,0,0,0,79,20010314
2001,MIN,21,26,20,25,8,0,0,100,SAS,22,25,21,24,14,0,0,106,20010314
2001,DET,25,14,28,29,0,0,0,96,WAS,23,27,30,23,0,0,0,103,20010314
2001,MIN,16,19,19,29,0,0,0,83,DAL,33,17,25,28,0,0,0,103,20010315
2001,LAL,28,29,22,32,14,0,0,125,DET,27,35,28,21,8,0,0,119,20010315
2001,NJN,19,26,33,28,0,0,0,106,HOU,22,34,29,23,0,0,0,108,20010315
2001,SEA,30,29,27,22,0,0,0,108,MIL,30,30,23,19,0,0,0,102,20010315
2001,TOR,22,22,12,16,0,0,0,72,NYK,21,24,24,19,0,0,0,88,20010315
2001,BOS,26,27,25,27,0,0,0,105,PHO,32,18,18,33,0,0,0,101,20010315
2001,SEA,25,23,20,22,0,0,0,90,CHI,21,18,17,24,0,0,0,80,20010316
2001,CHH,21,35,28,25,0,0,0,109,CLE,23,26,35,30,0,0,0,114,20010316
2001,BOS,24,19,24,20,0,0,0,87,DEN,26,17,18,22,0,0,0,83,20010316
2001,ATL,19,21,24,33,0,0,0,97,IND,21,26,27,29,0,0,0,103,20010316
2001,GSW,18,20,21,17,0,0,0,76,LAC,29,29,19,17,0,0,0,94,20010316
2001,VAN,25,32,21,21,0,0,0,99,ORL,23,28,23,29,0,0,0,103,20010316
2001,SAC,30,23,25,22,0,0,0,100,PHI,14,28,20,17,0,0,0,79,20010316
2001,UTA,21,21,22,23,0,0,0,87,POR,22,25,25,18,0,0,0,90,20010316
2001,NJN,13,26,17,30,0,0,0,86,SAS,22,23,32,18,0,0,0,95,20010316
2001,LAL,28,23,26,24,0,0,0,101,WAS,25,18,19,27,0,0,0,89,20010316
2001,DET,29,33,25,19,0,0,0,106,ATL,25,23,17,25,0,0,0,90,20010317
2001,WAS,24,29,23,17,0,0,0,93,CHH,35,22,20,18,0,0,0,95,20010317
2001,PHO,14,27,25,33,0,0,0,99,DAL,29,25,30,25,0,0,0,109,20010317
2001,SAS,24,24,23,28,0,0,0,99,HOU,19,16,35,33,0,0,0,103,20010317
2001,VAN,16,28,18,19,0,0,0,81,MIA,29,18,28,20,0,0,0,95,20010317
2001,PHI,22,21,19,16,0,0,0,78,MIL,17,24,24,22,0,0,0,87,20010317
2001,CHI,22,21,20,17,0,0,0,80,NYK,33,28,17,23,0,0,0,101,20010317
2001,NJN,31,10,21,22,0,0,0,84,DEN,22,31,23,22,0,0,0,98,20010318
2001,MIL,26,29,22,23,0,0,0,100,DET,28,35,16,17,0,0,0,96,20010318
2001,SEA,29,34,20,21,0,0,0,104,GSW,30,28,23,18,0,0,0,99,20010318
2001,SAC,23,18,29,25,0,0,0,95,IND,30,16,26,29,0,0,0,101,20010318
2001,UTA,28,31,27,25,0,0,0,111,LAC,24,21,24,27,0,0,0,96,20010318
2001,CLE,29,18,14,15,0,0,0,76,MIN,25,22,30,14,0,0,0,91,20010318
2001,LAL,21,27,25,22,0,0,0,95,ORL,19,23,26,22,0,0,0,90,20010318
2001,LAL,32,20,30,24,0,0,0,106,ATL,33,22,29,24,0,0,0,108,20010319
2001,POR,18,24,23,20,0,0,0,85,SAS,29,25,24,20,0,0,0,98,20010319
2001,PHI,22,26,18,23,0,0,0,89,SEA,19,26,24,24,0,0,0,93,20010319
2001,ORL,26,27,25,25,0,0,0,103,CHI,28,16,28,23,0,0,0,95,20010320
2001,NYK,18,25,36,31,0,0,0,110,CLE,9,22,16,28,0,0,0,75,20010320
2001,POR,14,24,25,33,0,0,0,96,DAL,24,19,23,22,0,0,0,88,20010320
2001,PHI,25,21,16,15,0,0,0,77,LAC,26,18,29,15,0,0,0,88,20010320
2001,VAN,16,23,21,30,0,0,0,90,NJN,21,32,24,27,0,0,0,104,20010320
2001,WAS,24,24,24,19,0,0,0,91,PHO,34,25,24,22,0,0,0,105,20010320
2001,HOU,29,25,19,36,0,0,0,109,SAC,46,20,30,29,0,0,0,125,20010320
2001,IND,27,18,23,13,0,0,0,81,TOR,24,31,26,21,0,0,0,102,20010320
2001,DET,27,22,19,11,0,0,0,79,UTA,25,25,11,23,0,0,0,84,20010320
2001,SAS,14,26,28,29,0,0,0,97,BOS,23,18,20,16,0,0,0,77,20010321
2001,TOR,30,21,20,24,0,0,0,95,CHH,23,34,35,19,0,0,0,111,20010321
2001,WAS,22,24,28,25,0,0,0,99,GSW,22,26,30,16,0,0,0,94,20010321
2001,ORL,23,19,26,27,0,0,0,95,IND,27,30,17,22,0,0,0,96,20010321
2001,CHI,24,18,16,23,0,0,0,81,MIA,28,31,26,24,0,0,0,109,20010321
2001,LAL,25,19,24,32,0,0,0,100,MIL,15,25,32,35,0,0,0,107,20010321
2001,DAL,22,22,24,29,0,0,0,97,MIN,29,24,25,31,0,0,0,109,20010321
2001,SAS,34,26,33,22,0,0,0,115,ATL,25,23,30,23,0,0,0,101,20010322
2001,VAN,19,29,24,23,0,0,0,95,CLE,31,31,23,24,0,0,0,109,20010322
2001,HOU,22,18,21,31,0,0,0,92,LAC,28,18,24,27,0,0,0,97,20010322
2001,BOS,26,34,35,18,0,0,0,113,NJN,28,25,16,29,0,0,0,98,20010322
2001,DET,21,35,25,17,0,0,0,98,SAC,30,31,24,18,0,0,0,103,20010322
2001,PHO,21,17,26,27,0,0,0,91,SEA,25,25,21,17,0,0,0,88,20010322
2001,POR,26,22,22,31,0,0,0,101,UTA,28,29,20,22,0,0,0,99,20010322
2001,CHH,28,17,18,21,6,0,0,90,CHI,22,22,21,19,9,0,0,93,20010323
2001,VAN,21,20,11,23,0,0,0,75,IND,27,29,27,12,0,0,0,95,20010323
2001,WAS,25,30,18,18,0,0,0,91,LAL,25,35,28,16,0,0,0,104,20010323
2001,ORL,21,26,28,28,0,0,0,103,MIL,28,33,23,31,0,0,0,115,20010323
2001,DEN,13,27,25,25,0,0,0,90,MIN,21,22,25,33,0,0,0,101,20010323
2001,NJN,17,36,23,19,0,0,0,95,NYK,22,21,19,24,0,0,0,86,20010323
2001,PHI,20,23,17,11,0,0,0,71,PHO,22,23,21,18,0,0,0,84,20010323
2001,ATL,22,22,16,26,0,0,0,86,TOR,35,29,31,17,0,0,0,112,20010323
2001,DEN,25,21,31,28,0,0,0,105,CLE,36,29,27,25,0,0,0,117,20010324
2001,CHH,22,23,24,31,0,0,0,100,DAL,34,23,16,30,0,0,0,103,20010324
2001,DET,31,23,25,16,0,0,0,95,GSW,26,38,28,11,0,0,0,103,20010324
2001,HOU,21,29,19,21,0,0,0,90,SEA,27,26,20,20,0,0,0,93,20010324
2001,WAS,13,27,24,29,0,0,0,93,UTA,41,29,24,25,0,0,0,119,20010324
2001,CHI,23,27,21,27,0,0,0,98,BOS,23,30,20,29,0,0,0,102,20010325
2001,SAS,19,18,28,18,0,0,0,83,MIA,25,21,24,18,0,0,0,88,20010325
2001,ATL,31,30,27,10,0,0,0,98,MIL,29,30,21,25,0,0,0,105,20010325
2001,NJN,24,18,33,16,0,0,0,91,MIN,38,25,24,18,0,0,0,105,20010325
2001,IND,26,19,13,24,0,0,0,82,ORL,19,21,28,16,0,0,0,84,20010325
2001,LAL,18,21,14,31,0,0,0,84,SAC,18,22,20,12,0,0,0,72,20010325
2001,VAN,26,26,23,17,0,0,0,92,TOR,29,21,26,26,0,0,0,102,20010325
2001,DEN,26,19,30,20,14,0,0,109,CHI,22,23,25,25,9,0,0,104,20010326
2001,NYK,24,23,17,21,4,0,0,89,GSW,19,19,23,24,2,0,0,87,20010326
2001,MIL,25,17,17,19,0,0,0,78,PHI,19,26,30,15,0,0,0,90,20010326
2001,LAL,22,18,27,16,0,0,0,83,PHO,27,33,20,24,0,0,0,104,20010326
2001,LAC,15,32,19,30,0,0,0,96,POR,21,34,25,24,0,0,0,104,20010326
2001,CLE,27,21,19,19,0,0,0,86,SEA,20,36,23,25,0,0,0,104,20010326
2001,DAL,18,17,29,34,0,0,0,98,UTA,18,28,20,24,0,0,0,90,20010326
2001,BOS,29,18,32,26,10,0,0,115,ATL,28,26,31,20,7,0,0,112,20010327
2001,UTA,23,16,26,21,0,0,0,86,HOU,27,39,26,17,0,0,0,109,20010327
2001,DET,25,25,23,21,0,0,0,94,LAC,31,28,15,27,0,0,0,101,20010327
2001,TOR,25,27,26,23,0,0,0,101,MIA,17,30,24,21,0,0,0,92,20010327
2001,NYK,30,34,19,27,7,0,0,117,SAC,25,22,31,32,14,0,0,124,20010327
2001,CHH,21,16,16,26,0,0,0,79,SAS,30,18,20,25,0,0,0,93,20010327
2001,IND,35,23,25,27,0,0,0,110,WAS,21,26,24,31,0,0,0,102,20010327
2001,SAC,27,30,28,23,0,0,0,108,LAL,30,23,17,14,0,0,0,84,20010328
2001,DEN,33,16,22,25,0,0,0,96,NJN,24,33,26,16,0,0,0,99,20010328
2001,ORL,18,26,30,22,0,0,0,96,PHI,24,27,12,32,0,0,0,95,20010328
2001,CLE,20,20,28,26,0,0,0,94,PHO,33,18,26,26,0,0,0,103,20010328
2001,DAL,23,18,26,27,0,0,0,94,POR,28,15,20,21,0,0,0,84,20010328
2001,MIN,26,23,27,17,0,0,0,93,SEA,23,27,24,20,0,0,0,94,20010328
2001,IND,27,27,20,19,0,0,0,93,ATL,20,29,25,30,0,0,0,104,20010329
2001,BOS,27,30,30,19,0,0,0,106,CHI,21,35,22,26,0,0,0,104,20010329
2001,PHO,21,19,27,23,0,0,0,90,HOU,26,24,18,17,0,0,0,85,20010329
2001,MIA,26,22,24,24,0,0,0,96,MIL,21,28,24,31,0,0,0,104,20010329
2001,UTA,18,25,27,18,0,0,0,88,SAS,36,31,20,19,0,0,0,106,20010329
2001,NYK,13,24,13,18,0,0,0,68,VAN,24,28,26,11,0,0,0,89,20010329
2001,GSW,34,19,28,19,0,0,0,100,WAS,24,39,27,26,0,0,0,116,20010329
2001,IND,18,27,25,22,0,0,0,92,BOS,30,20,20,17,0,0,0,87,20010330
2001,DEN,22,26,23,32,0,0,0,103,CHH,27,38,15,16,0,0,0,96,20010330
2001,ORL,29,27,30,11,0,0,0,97,DET,30,24,24,22,0,0,0,100,20010330
2001,DAL,26,26,16,21,0,0,0,89,LAL,31,28,17,22,0,0,0,98,20010330
2001,GSW,19,23,19,28,0,0,0,89,PHI,23,24,30,25,0,0,0,102,20010330
2001,NYK,25,21,21,12,0,0,0,79,POR,24,25,28,19,0,0,0,96,20010330
2001,MIN,21,17,25,35,0,0,0,98,SAC,24,25,33,28,0,0,0,110,20010330
2001,LAC,25,21,21,17,0,0,0,84,SEA,31,16,21,26,0,0,0,94,20010330
2001,NJN,30,25,27,17,0,0,0,99,TOR,27,29,26,28,0,0,0,110,20010330
2001,CLE,20,21,26,21,0,0,0,88,UTA,21,26,25,23,0,0,0,95,20010330
2001,DEN,25,23,19,21,0,0,0,88,ATL,26,27,18,28,0,0,0,99,20010331
2001,MIA,23,25,28,21,0,0,0,97,CHI,26,21,12,31,0,0,0,90,20010331
2001,CLE,23,19,26,29,0,0,0,97,LAC,23,27,26,28,0,0,0,104,20010331
2001,MIL,21,29,20,16,0,0,0,86,SAS,20,30,12,15,0,0,0,77,20010331
2001,HOU,16,19,28,33,0,0,0,96,WAS,25,18,22,21,0,0,0,86,20010331
2001,BOS,13,28,17,21,0,0,0,79,CHH,20,15,20,25,0,0,0,80,20010401
2001,GSW,24,22,23,18,0,0,0,87,DET,35,28,28,13,0,0,0,104,20010401
2001,NYK,14,35,13,17,0,0,0,79,LAL,23,25,17,13,0,0,0,78,20010401
2001,HOU,21,20,35,22,0,0,0,98,NJN,20,26,32,23,0,0,0,101,20010401
2001,IND,18,24,21,30,0,0,0,93,PHI,25,29,23,27,0,0,0,104,20010401
2001,MIL,24,23,27,25,0,0,0,99,PHO,19,32,22,33,0,0,0,106,20010401
2001,MIN,33,26,22,18,0,0,0,99,POR,28,34,23,10,0,0,0,95,20010401
2001,DAL,28,36,34,21,0,0,0,119,SAC,33,25,25,24,0,0,0,107,20010401
2001,ORL,30,30,20,24,0,0,0,104,TOR,31,15,27,28,0,0,0,101,20010401
2001,UTA,25,20,28,19,0,0,0,92,VAN,22,23,16,12,0,0,0,73,20010401
2001,DET,33,23,33,21,0,0,0,110,CHI,20,27,24,12,0,0,0,83,20010403
2001,POR,23,26,17,26,0,0,0,92,DEN,22,26,26,20,0,0,0,94,20010403
2001,DAL,29,38,23,19,0,0,0,109,HOU,32,26,14,25,0,0,0,97,20010403
2001,PHO,15,26,26,14,0,0,0,81,IND,21,29,16,19,0,0,0,85,20010403
2001,BOS,20,25,17,20,0,0,0,82,MIA,15,23,24,15,0,0,0,77,20010403
2001,CHH,29,17,32,25,0,0,0,103,NJN,21,24,27,16,0,0,0,88,20010403
2001,ORL,22,27,19,14,0,0,0,82,NYK,21,28,17,28,0,0,0,94,20010403
2001,MIL,32,34,21,20,0,0,0,107,SAC,22,24,34,21,0,0,0,101,20010403
2001,SEA,17,16,30,26,0,0,0,89,SAS,20,31,24,32,0,0,0,107,20010403
2001,PHI,21,18,17,29,0,0,0,85,TOR,28,35,19,18,0,0,0,100,20010403
2001,LAL,22,30,17,27,0,0,0,96,UTA,19,25,19,25,0,0,0,88,20010403
2001,PHO,19,20,36,28,0,0,0,103,CHH,29,27,17,21,0,0,0,94,20010404
2001,TOR,27,24,24,22,0,0,0,97,CLE,26,24,20,24,0,0,0,94,20010404
2001,PHI,21,22,28,19,0,0,0,90,DET,17,24,16,27,0,0,0,84,20010404
2001,MIL,33,25,26,24,0,0,0,108,GSW,23,16,18,21,0,0,0,78,20010404
2001,POR,23,23,21,12,0,0,0,79,MIN,16,25,24,18,0,0,0,83,20010404
2001,BOS,28,23,30,20,0,0,0,101,ORL,29,20,28,31,0,0,0,108,20010404
2001,LAC,20,19,12,27,0,0,0,78,VAN,19,17,27,23,0,0,0,86,20010404
2001,MIA,16,29,26,15,0,0,0,86,WAS,19,24,19,22,0,0,0,84,20010404
2001,LAL,26,31,25,18,0,0,0,100,CHI,25,27,23,13,0,0,0,88,20010405
2001,ATL,16,22,27,29,0,0,0,94,DAL,23,35,24,26,0,0,0,108,20010405
2001,SAS,27,23,27,24,0,0,0,101,DEN,25,13,24,18,0,0,0,80,20010405
2001,SEA,22,19,17,30,0,0,0,88,HOU,22,25,23,21,0,0,0,91,20010405
2001,WAS,22,18,30,10,0,0,0,80,NYK,22,28,17,26,0,0,0,93,20010405
2001,SAC,18,24,29,21,0,0,0,92,UTA,35,12,19,20,0,0,0,86,20010405
2001,LAL,22,34,23,21,0,0,0,100,BOS,14,21,23,38,0,0,0,96,20010406
2001,POR,38,29,35,20,0,0,0,122,GSW,17,19,22,33,0,0,0,91,20010406
2001,CHI,27,20,33,13,0,0,0,93,IND,26,24,27,23,0,0,0,100,20010406
2001,MIL,23,25,24,28,10,0,0,110,LAC,29,28,17,26,13,0,0,113,20010406
2001,CHH,24,24,16,12,0,0,0,76,MIA,23,17,20,21,0,0,0,81,20010406
2001,PHO,16,23,25,24,0,0,0,88,MIN,15,32,23,31,0,0,0,101,20010406
2001,TOR,28,20,23,37,0,0,0,108,ORL,23,26,31,20,0,0,0,100,20010406
2001,CLE,21,27,19,21,0,0,0,88,PHI,25,27,23,21,0,0,0,96,20010406
2001,SAC,27,34,31,26,0,0,0,118,VAN,28,21,15,26,0,0,0,90,20010406
2001,DET,20,26,25,26,0,0,0,97,CHH,18,19,26,29,0,0,0,92,20010407
2001,PHO,19,27,33,23,0,0,0,102,CLE,28,26,18,26,0,0,0,98,20010407
2001,UTA,17,31,36,32,0,0,0,116,DAL,21,21,30,31,0,0,0,103,20010407
2001,VAN,26,19,23,29,0,0,0,97,DEN,29,22,21,26,0,0,0,98,20010407
2001,ATL,23,29,24,21,0,0,0,97,HOU,33,21,26,30,0,0,0,110,20010407
2001,SAS,28,22,20,23,0,0,0,93,LAC,11,26,24,22,0,0,0,83,20010407
2001,BOS,27,29,23,23,0,0,0,102,WAS,31,25,26,18,0,0,0,100,20010407
2001,SAS,21,24,17,22,0,0,0,84,GSW,17,22,19,18,0,0,0,76,20010408
2001,NYK,15,19,20,22,0,0,0,76,MIA,28,16,20,17,0,0,0,81,20010408
2001,LAL,18,26,30,30,0,0,0,104,MIN,17,33,25,24,0,0,0,99,20010408
2001,IND,25,26,41,16,0,0,0,108,NJN,33,18,12,20,0,0,0,83,20010408
2001,POR,29,13,32,15,0,0,0,89,SAC,17,26,29,26,0,0,0,98,20010408
2001,MIL,24,16,22,26,0,0,0,88,SEA,28,31,20,22,0,0,0,101,20010408
2001,CHI,26,17,28,17,0,0,0,88,TOR,26,17,41,16,0,0,0,100,20010408
2001,ATL,26,12,15,16,0,0,0,69,DET,24,18,22,17,0,0,0,81,20010409
2001,WAS,23,21,17,17,0,0,0,78,IND,23,30,20,27,0,0,0,100,20010409
2001,CHH,27,21,27,23,0,0,0,98,NYK,25,29,29,30,0,0,0,113,20010409
2001,BOS,24,20,23,28,0,0,0,95,PHI,28,30,28,22,0,0,0,108,20010409
2001,HOU,18,23,16,24,0,0,0,81,UTA,12,26,36,22,0,0,0,96,20010409
2001,ORL,19,18,22,19,0,0,0,78,CLE,37,32,12,20,0,0,0,101,20010410
2001,DEN,30,22,28,20,0,0,0,100,HOU,24,25,28,22,0,0,0,99,20010410
2001,PHO,22,16,14,28,0,0,0,80,LAL,26,26,23,31,0,0,0,106,20010410
2001,PHI,19,13,22,27,0,0,0,81,MIA,19,23,13,28,0,0,0,83,20010410
2001,CHI,19,26,19,20,0,0,0,84,MIL,34,30,22,19,0,0,0,105,20010410
2001,GSW,19,20,27,22,0,0,0,88,POR,28,27,35,26,0,0,0,116,20010410
2001,LAC,26,22,36,22,3,0,0,109,SAC,27,23,33,23,10,0,0,116,20010410
2001,DAL,20,22,15,22,0,0,0,79,SAS,21,26,23,21,0,0,0,91,20010410
2001,MIN,32,30,26,16,0,0,0,104,VAN,20,23,16,32,0,0,0,91,20010410
2001,CLE,25,32,25,20,0,0,0,102,ATL,25,30,25,27,0,0,0,107,20010411
2001,MIA,28,22,22,30,0,0,0,102,BOS,13,26,27,31,0,0,0,97,20010411
2001,TOR,31,27,11,18,0,0,0,87,DET,29,12,26,32,0,0,0,99,20010411
2001,NYK,24,18,20,31,0,0,0,93,IND,28,22,21,29,0,0,0,100,20010411
2001,DAL,25,23,25,33,0,0,0,106,PHO,23,35,18,35,0,0,0,111,20010411
2001,GSW,28,26,22,25,0,0,0,101,SEA,26,27,27,27,0,0,0,107,20010411
2001,CHI,31,30,27,25,0,0,0,113,WAS,28,29,21,31,0,0,0,109,20010411
2001,NJN,14,18,26,20,0,0,0,78,CHH,20,25,24,19,0,0,0,88,20010412
2001,MIN,19,25,27,31,0,0,0,102,LAL,34,17,33,35,0,0,0,119,20010412
2001,UTA,16,18,33,26,0,0,0,93,MIL,34,26,27,28,0,0,0,115,20010412
2001,PHI,19,17,22,19,0,0,0,77,ORL,29,32,25,15,0,0,0,101,20010412
2001,SAC,23,21,22,30,11,0,0,107,SAS,31,22,21,22,9,0,0,105,20010412
2001,POR,19,24,31,26,0,0,0,100,VAN,21,18,17,31,0,0,0,87,20010412
2001,UTA,17,24,28,25,0,0,0,94,CHI,22,20,23,18,0,0,0,83,20010413
2001,SAC,29,22,27,19,0,0,0,97,DAL,32,24,28,17,0,0,0,101,20010413
2001,GSW,22,20,22,28,0,0,0,92,DEN,26,42,21,19,0,0,0,108,20010413
2001,BOS,26,27,26,25,4,0,0,108,IND,31,33,15,25,9,0,0,113,20010413
2001,MIN,26,31,18,30,0,0,0,105,LAC,27,28,29,27,0,0,0,111,20010413
2001,CLE,24,32,12,29,0,0,0,97,NJN,30,16,21,24,0,0,0,91,20010413
2001,ATL,17,15,17,16,0,0,0,65,NYK,33,26,23,19,0,0,0,101,20010413
2001,SEA,25,27,23,25,0,0,0,100,PHO,30,25,27,27,0,0,0,109,20010413
2001,HOU,26,32,23,28,0,0,0,109,POR,22,26,27,28,0,0,0,103,20010413
2001,MIA,18,22,19,23,0,0,0,82,TOR,22,24,25,23,0,0,0,94,20010413
2001,ORL,26,27,29,28,0,0,0,110,WAS,33,24,22,34,0,0,0,113,20010413
2001,DET,29,30,32,24,14,0,0,129,ATL,22,31,32,30,9,0,0,124,20010414
2001,LAC,27,23,29,27,0,0,0,106,GSW,29,23,15,27,0,0,0,94,20010414
2001,TOR,20,24,20,22,0,0,0,86,MIL,37,30,20,25,0,0,0,112,20010414
2001,DEN,20,24,20,31,0,0,0,95,SAS,27,28,30,26,0,0,0,111,20010414
2001,HOU,27,10,32,31,0,0,0,100,VAN,21,30,18,26,0,0,0,95,20010414
2001,NJN,26,24,18,20,0,0,0,88,BOS,33,23,16,23,0,0,0,95,20010415
2001,IND,22,24,27,20,0,0,0,93,CHI,21,26,13,26,0,0,0,86,20010415
2001,CHH,30,26,23,20,0,0,0,99,DET,22,21,27,20,0,0,0,90,20010415
2001,POR,23,31,23,23,0,0,0,100,LAL,29,24,31,21,0,0,0,105,20010415
2001,ORL,26,27,23,14,0,0,0,90,MIA,21,13,18,21,0,0,0,73,20010415
2001,UTA,29,19,26,26,0,0,0,100,MIN,23,24,29,31,0,0,0,107,20010415
2001,NYK,22,19,19,22,0,0,0,82,PHI,19,25,26,19,0,0,0,89,20010415
2001,SAC,26,19,22,19,0,0,0,86,PHO,27,26,18,17,0,0,0,88,20010415
2001,DAL,27,22,21,24,13,0,0,107,SEA,28,17,16,33,5,0,0,99,20010415
2001,CLE,24,28,29,25,0,0,0,106,WAS,26,26,18,28,0,0,0,98,20010415
2001,ATL,25,18,16,24,0,0,0,83,CHH,32,28,23,23,0,0,0,106,20010416
2001,NYK,22,17,20,19,0,0,0,78,CLE,30,17,19,14,0,0,0,80,20010416
2001,DAL,28,29,26,27,0,0,0,110,GSW,25,28,23,25,0,0,0,101,20010416
2001,PHO,15,19,20,26,0,0,0,80,LAC,22,31,28,19,0,0,0,100,20010416
2001,MIL,24,29,22,26,0,0,0,101,ORL,22,17,30,20,0,0,0,89,20010416
2001,VAN,25,29,25,21,0,0,0,100,SAC,34,21,31,24,0,0,0,110,20010416
2001,WAS,31,31,31,26,0,0,0,119,ATL,29,25,26,42,0,0,0,122,20010417
2001,MIN,26,26,16,19,0,0,0,87,HOU,35,30,30,19,0,0,0,114,20010417
2001,PHI,23,20,29,27,12,0,0,111,IND,27,27,21,24,6,0,0,105,20010417
2001,DEN,31,20,18,22,0,0,0,91,LAL,28,29,23,28,0,0,0,108,20010417
2001,MIL,20,27,18,24,0,0,0,89,MIA,22,28,17,24,0,0,0,91,20010417
2001,CHI,30,25,28,17,0,0,0,100,NJN,24,20,30,20,0,0,0,94,20010417
2001,SAS,22,21,26,30,0,0,0,99,POR,20,25,25,23,0,0,0,93,20010417
2001,DET,24,24,16,20,8,0,0,92,TOR,23,21,24,16,10,0,0,94,20010417
2001,LAC,18,26,24,24,0,0,0,92,UTA,27,20,17,33,0,0,0,97,20010417
2001,CHH,33,19,23,22,0,0,0,97,BOS,26,23,25,18,0,0,0,92,20010418
2001,IND,28,20,30,17,10,0,0,105,CLE,24,29,20,22,6,0,0,101,20010418
2001,MIN,22,28,17,33,0,0,0,100,DAL,39,24,33,24,0,0,0,120,20010418
2001,SAC,28,20,29,23,0,0,0,100,DEN,17,38,32,23,0,0,0,110,20010418
2001,VAN,16,29,29,21,0,0,0,95,GSW,27,20,18,16,0,0,0,81,20010418
2001,DET,24,25,20,19,0,0,0,88,NYK,33,27,18,16,0,0,0,94,20010418
2001,MIA,25,24,21,33,0,0,0,103,ORL,25,24,24,18,0,0,0,91,20010418
2001,CHI,22,28,19,23,0,0,0,92,PHI,20,23,22,21,0,0,0,86,20010418
2001,UTA,26,15,24,28,0,0,0,93,PHO,22,22,25,29,0,0,0,98,20010418
2001,SAS,18,18,17,14,0,0,0,67,SEA,25,29,22,29,0,0,0,105,20010418
2001,TOR,28,25,26,19,0,0,0,98,WAS,24,22,24,22,0,0,0,92,20010418
2001,CHH,23,27,31,25,0,0,0,106,MIA,21,19,18,22,0,0,0,80,20010421
2001,IND,17,19,22,21,0,0,0,79,PHI,29,23,13,13,0,0,0,78,20010421
2001,MIN,24,13,28,17,0,0,0,82,SAS,25,26,12,24,0,0,0,87,20010421
2001,DAL,17,22,23,24,0,0,0,86,UTA,22,18,21,27,0,0,0,88,20010421
2001,POR,19,29,24,21,0,0,0,93,LAL,30,21,23,32,0,0,0,106,20010422
2001,ORL,22,24,28,16,0,0,0,90,MIL,21,28,30,24,0,0,0,103,20010422
2001,TOR,18,26,21,20,0,0,0,85,NYK,22,19,25,26,0,0,0,92,20010422
2001,PHO,28,10,28,20,0,0,0,86,SAC,25,19,22,17,0,0,0,83,20010422
2001,CHH,26,28,24,24,0,0,0,102,MIA,26,26,7,17,0,0,0,76,20010423
2001,MIN,16,20,15,18,0,0,0,69,SAS,20,30,24,12,0,0,0,86,20010423
2001,IND,27,32,19,20,0,0,0,98,PHI,28,33,30,25,0,0,0,116,20010424
2001,DAL,19,22,27,30,0,0,0,98,UTA,28,25,31,25,0,0,0,109,20010424
2001,ORL,26,25,26,19,0,0,0,96,MIL,33,20,29,21,0,0,0,103,20010425
2001,PHO,22,21,20,27,0,0,0,90,SAC,31,32,32,21,0,0,0,116,20010425
2001,POR,29,17,19,23,0,0,0,88,LAL,25,30,25,26,0,0,0,106,20010426
2001,TOR,20,19,27,28,0,0,0,94,NYK,16,19,17,22,0,0,0,74,20010426
2001,MIA,17,14,24,24,0,0,0,79,CHH,27,31,15,21,0,0,0,94,20010427
2001,UTA,22,21,22,26,0,0,0,91,DAL,31,20,21,22,0,0,0,94,20010428
2001,PHI,21,24,29,18,0,0,0,92,IND,24,17,19,27,0,0,0,87,20010428
2001,SAS,19,23,24,18,0,0,0,84,MIN,24,23,21,25,0,0,0,93,20010428
2001,MIL,23,27,24,36,6,0,0,116,ORL,24,20,36,30,11,0,0,121,20010428
2001,SAC,19,34,22,29,0,0,0,104,PHO,36,19,18,23,0,0,0,96,20010429
2001,LAL,23,31,25,20,0,0,0,99,POR,26,21,25,14,0,0,0,86,20010429
2001,NYK,20,25,23,29,0,0,0,97,TOR,16,25,26,22,0,0,0,89,20010429
2001,SAS,19,25,27,26,0,0,0,97,MIN,19,24,20,21,0,0,0,84,20010430
2001,UTA,24,18,21,14,0,0,0,77,DAL,17,28,36,26,0,0,0,107,20010501
2001,MIL,22,35,40,15,0,0,0,112,ORL,36,25,26,17,0,0,0,104,20010501
2001,PHI,25,17,22,24,0,0,0,88,IND,27,21,21,16,0,0,0,85,20010502
2001,SAC,14,22,23,30,0,0,0,89,PHO,29,18,16,19,0,0,0,82,20010502
2001,NYK,22,19,23,29,0,0,0,93,TOR,26,18,26,30,0,0,0,100,20010502
2001,DAL,16,17,24,27,0,0,0,84,UTA,20,28,23,12,0,0,0,83,20010503
2001,TOR,25,24,21,23,0,0,0,93,NYK,24,19,16,30,0,0,0,89,20010504
2001,DAL,11,23,19,25,0,0,0,78,SAS,16,31,29,18,0,0,0,94,20010505
2001,SAC,30,24,24,27,0,0,0,105,LAL,28,25,31,24,0,0,0,108,20010506
2001,CHH,24,16,33,19,0,0,0,92,MIL,27,28,23,26,0,0,0,104,20010506
2001,TOR,21,26,26,23,0,0,0,96,PHI,17,20,24,32,0,0,0,93,20010506
2001,DAL,18,24,20,24,0,0,0,86,SAS,23,23,29,25,0,0,0,100,20010507
2001,SAC,15,28,13,34,0,0,0,90,LAL,25,18,31,22,0,0,0,96,20010508
2001,CHH,19,17,26,28,0,0,0,90,MIL,27,20,21,23,0,0,0,91,20010508
2001,SAS,26,22,30,26,0,0,0,104,DAL,22,21,11,36,0,0,0,90,20010509
2001,TOR,31,16,24,21,0,0,0,92,PHI,21,28,24,24,0,0,0,97,20010509
2001,MIL,26,25,18,23,0,0,0,92,CHH,25,26,25,26,0,0,0,102,20010510
2001,LAL,29,17,19,38,0,0,0,103,SAC,19,18,17,27,0,0,0,81,20010511
2001,PHI,23,18,20,17,0,0,0,78,TOR,23,35,17,27,0,0,0,102,20010511
2001,SAS,24,33,30,21,0,0,0,108,DAL,32,27,27,26,0,0,0,112,20010512
2001,MIL,18,27,21,12,0,0,0,78,CHH,28,22,20,15,0,0,0,85,20010513
2001,LAL,27,26,27,39,0,0,0,119,SAC,22,37,25,29,0,0,0,113,20010513
2001,PHI,26,23,21,14,0,0,0,84,TOR,18,18,25,18,0,0,0,79,20010513
2001,DAL,21,20,23,23,0,0,0,87,SAS,32,25,22,26,0,0,0,105,20010514
2001,CHH,26,26,28,14,0,0,0,94,MIL,26,23,20,17,0,0,0,86,20010515
2001,TOR,12,28,27,21,0,0,0,88,PHI,33,29,31,28,0,0,0,121,20010516
2001,MIL,21,22,28,33,0,0,0,104,CHH,28,25,18,26,0,0,0,97,20010517
2001,PHI,17,22,29,21,0,0,0,89,TOR,27,27,16,31,0,0,0,101,20010518
2001,LAL,24,27,29,24,0,0,0,104,SAS,17,25,24,24,0,0,0,90,20010519
2001,CHH,26,21,17,31,0,0,0,95,MIL,23,21,29,31,0,0,0,104,20010520
2001,TOR,21,21,24,21,0,0,0,87,PHI,31,19,19,19,0,0,0,88,20010520
2001,LAL,21,17,28,22,0,0,0,88,SAS,22,24,21,14,0,0,0,81,20010521
2001,MIL,19,16,28,22,0,0,0,85,PHI,19,32,19,23,0,0,0,93,20010522
2001,MIL,32,17,20,23,0,0,0,92,PHI,16,21,20,21,0,0,0,78,20010524
2001,SAS,21,23,20,8,0,0,0,72,LAL,34,20,32,25,0,0,0,111,20010525
2001,PHI,17,22,21,14,0,0,0,74,MIL,24,19,26,11,0,0,0,80,20010526
2001,SAS,23,18,25,16,0,0,0,82,LAL,33,31,22,25,0,0,0,111,20010527
2001,PHI,24,16,29,20,0,0,0,89,MIL,22,20,20,21,0,0,0,83,20010528
2001,MIL,29,22,19,18,0,0,0,88,PHI,21,21,28,19,0,0,0,89,20010530
2001,PHI,15,16,23,46,0,0,0,100,MIL,25,35,20,30,0,0,0,110,20010601
2001,MIL,26,24,21,20,0,0,0,91,PHI,25,31,26,26,0,0,0,108,20010603
2001,PHI,22,34,23,15,13,0,0,107,LAL,23,27,27,17,7,0,0,101,20010606
2001,PHI,24,23,20,22,0,0,0,89,LAL,25,24,28,21,0,0,0,98,20010608
2001,LAL,25,30,18,23,0,0,0,96,PHI,25,20,21,25,0,0,0,91,20010610
2001,LAL,22,29,26,23,0,0,0,100,PHI,14,23,22,27,0,0,0,86,20010613
2001,LAL,24,28,31,25,0,0,0,108,PHI,27,21,20,28,0,0,0,96,20010615
2002,BOS,33,32,27,16,0,0,0,108,CLE,19,26,14,30,0,0,0,89,20011030
2002,DET,25,19,20,23,0,0,0,87,DAL,17,23,29,25,0,0,0,94,20011030
2002,ATL,22,19,17,18,8,0,0,84,HOU,19,26,18,13,13,0,0,89,20011030
2002,POR,20,26,22,19,0,0,0,87,LAL,29,26,24,19,0,0,0,98,20011030
2002,PHI,23,10,23,18,0,0,0,74,MIN,17,29,18,19,0,0,0,83,20011030
2002,IND,31,22,26,18,0,0,0,97,NJN,17,28,23,35,0,0,0,103,20011030
2002,WAS,21,22,18,30,0,0,0,91,NYK,19,22,26,26,0,0,0,93,20011030
2002,TOR,22,25,15,23,0,0,0,85,ORL,31,24,31,28,0,0,0,114,20011030
2002,DEN,25,32,20,22,0,0,0,99,PHO,16,20,27,33,0,0,0,96,20011030
2002,SEA,21,27,24,23,0,0,0,95,SAC,27,25,29,20,0,0,0,101,20011030
2002,LAC,25,19,26,28,0,0,0,98,SAS,28,20,32,29,0,0,0,109,20011030
2002,MIL,27,24,24,27,17,0,0,119,UTA,28,26,30,18,10,0,0,112,20011030
2002,NJN,31,24,20,20,0,0,0,95,BOS,17,22,26,27,0,0,0,92,20011031
2002,CLE,22,21,28,23,0,0,0,94,CHH,16,24,28,32,0,0,0,100,20011031
2002,IND,28,19,23,28,0,0,0,98,CHI,29,15,20,9,0,0,0,73,20011031
2002,TOR,24,23,19,26,0,0,0,92,MIA,22,28,21,26,0,0,0,97,20011031
2002,GSW,22,24,24,17,0,0,0,87,POR,19,29,27,17,0,0,0,92,20011031
2002,WAS,28,21,25,24,0,0,0,98,ATL,23,30,19,16,0,0,0,88,20011101
2002,MIL,27,22,28,25,0,0,0,102,DEN,33,30,22,16,0,0,0,101,20011101
2002,PHO,32,23,26,26,0,0,0,107,GSW,20,22,25,34,0,0,0,101,20011101
2002,LAC,25,19,20,22,6,0,0,92,HOU,23,21,26,16,12,0,0,98,20011101
2002,DET,18,18,25,29,0,0,0,90,MEM,21,22,17,20,0,0,0,80,20011101
2002,DAL,28,31,19,21,0,0,0,99,PHI,27,19,20,26,0,0,0,92,20011101
2002,SAS,28,24,22,34,0,0,0,108,SEA,24,31,26,33,0,0,0,114,20011101
2002,LAL,28,16,33,28,0,0,0,105,UTA,22,25,24,30,0,0,0,101,20011101
2002,CHI,21,20,15,26,0,0,0,82,BOS,23,25,19,29,0,0,0,96,20011102
2002,NYK,26,25,17,25,0,0,0,93,CHH,29,25,20,23,0,0,0,97,20011102
2002,NJN,18,22,24,24,0,0,0,88,DET,31,25,24,22,0,0,0,102,20011102
2002,ORL,32,23,22,30,0,0,0,107,IND,39,24,23,31,0,0,0,117,20011102
2002,PHO,25,21,19,29,0,0,0,94,LAL,28,26,25,38,0,0,0,117,20011102
2002,CLE,26,25,24,15,0,0,0,90,MIA,20,24,19,20,0,0,0,83,20011102
2002,MEM,33,23,16,30,0,0,0,102,MIN,25,32,28,26,0,0,0,111,20011102
2002,DAL,18,29,26,19,0,0,0,92,TOR,33,34,22,20,0,0,0,109,20011102
2002,MIA,17,27,12,27,0,0,0,83,ATL,20,31,14,25,0,0,0,90,20011103
2002,NYK,25,20,18,16,0,0,0,79,CHI,21,22,16,25,0,0,0,84,20011103
2002,ORL,24,31,19,25,0,0,0,99,CLE,15,18,18,18,0,0,0,69,20011103
2002,SAC,26,32,29,19,0,0,0,106,DEN,28,17,25,24,0,0,0,94,20011103
2002,MIN,29,19,26,16,0,0,0,90,HOU,17,23,29,19,0,0,0,88,20011103
2002,GSW,29,20,27,22,12,0,0,110,LAC,28,31,22,17,10,0,0,108,20011103
2002,BOS,21,23,32,23,0,0,0,99,MIL,23,32,25,25,0,0,0,105,20011103
2002,CHH,23,25,16,21,0,0,0,85,NJN,27,25,25,18,0,0,0,95,20011103
2002,SAS,29,27,25,25,0,0,0,106,POR,13,25,37,15,0,0,0,90,20011103
2002,UTA,23,26,22,20,0,0,0,91,SEA,18,14,27,15,0,0,0,74,20011103
2002,PHI,27,16,13,20,0,0,0,76,WAS,18,17,29,26,0,0,0,90,20011103
2002,WAS,18,19,17,24,0,0,0,78,DET,26,35,27,12,0,0,0,100,20011104
2002,POR,27,17,18,24,0,0,0,86,GSW,30,24,25,17,0,0,0,96,20011104
2002,UTA,33,24,21,18,0,0,0,96,LAL,22,25,23,30,0,0,0,100,20011104
2002,DAL,25,25,22,22,0,0,0,94,MEM,28,15,23,19,0,0,0,85,20011104
2002,HOU,23,22,26,32,0,0,0,103,PHO,23,33,23,21,0,0,0,100,20011104
2002,SAS,19,23,18,23,0,0,0,83,SAC,25,30,23,25,0,0,0,103,20011104
2002,IND,26,27,26,21,0,0,0,100,TOR,32,35,18,28,0,0,0,113,20011104
2002,ATL,22,23,15,26,0,0,0,86,LAC,28,27,23,31,0,0,0,109,20011105
2002,SEA,33,33,13,21,11,12,0,123,ORL,29,25,17,29,11,8,0,119,20011105
2002,SAC,27,37,22,29,0,0,0,115,CLE,22,24,31,22,0,0,0,99,20011106
2002,CHH,21,16,32,23,0,0,0,92,DAL,31,23,26,30,0,0,0,110,20011106
2002,DEN,24,24,22,23,0,0,0,93,HOU,28,30,19,22,0,0,0,99,20011106
2002,SEA,19,18,24,19,5,0,0,85,MIA,25,19,23,13,7,0,0,87,20011106
2002,NYK,23,30,17,24,0,0,0,94,MIN,33,25,28,18,0,0,0,104,20011106
2002,IND,23,25,21,18,0,0,0,87,PHI,25,14,25,13,0,0,0,77,20011106
2002,MEM,33,24,28,16,0,0,0,101,PHO,28,24,29,32,0,0,0,113,20011106
2002,UTA,17,24,16,26,0,0,0,83,POR,29,20,20,32,0,0,0,101,20011106
2002,ORL,17,31,20,21,0,0,0,89,SAS,21,33,25,25,0,0,0,104,20011106
2002,WAS,19,23,26,27,0,0,0,95,BOS,22,26,27,29,0,0,0,104,20011107
2002,DET,23,25,22,27,0,0,0,97,CHI,22,21,16,14,0,0,0,73,20011107
2002,SAC,28,30,29,17,0,0,0,104,IND,25,30,31,30,0,0,0,116,20011107
2002,MEM,15,26,27,24,0,0,0,92,LAC,33,19,22,34,0,0,0,108,20011107
2002,CLE,14,20,13,17,0,0,0,64,NYK,19,20,22,21,0,0,0,82,20011107
2002,GSW,25,26,20,21,0,0,0,92,TOR,23,29,35,22,0,0,0,109,20011107
2002,ATL,24,20,25,20,0,0,0,89,UTA,26,24,20,26,0,0,0,96,20011107
2002,SAS,31,23,24,27,0,0,0,105,CHH,20,29,31,15,0,0,0,95,20011108
2002,DEN,17,29,28,17,0,0,0,91,DAL,27,26,28,24,0,0,0,105,20011108
2002,PHI,15,20,20,17,0,0,0,72,HOU,19,16,29,13,0,0,0,77,20011108
2002,MIA,19,23,24,16,0,0,0,82,MIL,21,21,25,19,0,0,0,86,20011108
2002,CHI,14,22,10,28,0,0,0,74,MIN,34,34,33,26,0,0,0,127,20011108
2002,SEA,26,22,27,19,0,0,0,94,NJN,25,27,23,31,0,0,0,106,20011108
2002,ATL,19,26,15,20,0,0,0,80,PHO,30,22,27,29,0,0,0,108,20011108
2002,LAC,25,29,30,17,0,0,0,101,POR,21,31,30,37,0,0,0,119,20011108
2002,SEA,15,29,29,21,0,0,0,94,BOS,26,24,22,32,0,0,0,104,20011109
2002,HOU,22,24,16,19,0,0,0,81,DEN,25,25,37,21,0,0,0,108,20011109
2002,NYK,30,30,16,19,0,0,0,95,IND,20,25,26,32,0,0,0,103,20011109
2002,MEM,10,33,17,26,0,0,0,86,LAL,19,36,32,23,0,0,0,110,20011109
2002,SAC,35,18,28,24,0,0,0,105,ORL,28,33,27,27,0,0,0,115,20011109
2002,GSW,25,32,30,22,0,0,0,109,WAS,26,24,22,28,0,0,0,100,20011109
2002,CHH,28,19,16,26,0,0,0,89,CHI,21,27,17,20,0,0,0,85,20011110
2002,PHI,29,23,19,27,0,0,0,98,DAL,17,26,25,23,0,0,0,91,20011110
2002,POR,31,22,23,20,0,0,0,96,IND,22,27,27,29,0,0,0,105,20011110
2002,PHO,29,22,25,26,0,0,0,102,LAC,33,29,27,22,0,0,0,111,20011110
2002,SAC,27,22,14,27,0,0,0,90,MIA,15,16,23,21,0,0,0,75,20011110
2002,MIN,28,22,24,24,0,0,0,98,MIL,9,23,26,24,0,0,0,82,20011110
2002,CLE,21,20,23,20,0,0,0,84,NJN,25,26,20,16,0,0,0,87,20011110
2002,GSW,30,18,20,22,0,0,0,90,NYK,25,13,19,14,0,0,0,71,20011110
2002,ATL,24,18,24,22,0,0,0,88,SAS,27,31,20,32,0,0,0,110,20011110
2002,TOR,31,23,34,29,0,0,0,117,UTA,22,31,18,25,0,0,0,96,20011110
2002,TOR,26,20,19,20,0,0,0,85,DEN,26,21,21,28,0,0,0,96,20011111
2002,POR,25,23,24,28,0,0,0,100,DET,16,34,23,25,0,0,0,98,20011111
2002,ORL,31,22,24,18,0,0,0,95,LAL,27,32,22,27,0,0,0,108,20011111
2002,SEA,19,29,28,23,0,0,0,99,WAS,20,21,14,29,0,0,0,84,20011111
2002,GSW,20,27,16,23,0,0,0,86,MEM,17,21,22,19,0,0,0,79,20011112
2002,ORL,18,26,23,31,0,0,0,98,UTA,24,21,26,34,0,0,0,105,20011112
2002,CHI,27,28,23,15,0,0,0,93,DEN,29,30,19,23,0,0,0,101,20011113
2002,NJN,32,13,23,23,0,0,0,91,IND,16,19,27,20,0,0,0,82,20011113
2002,PHI,23,26,17,16,0,0,0,82,MIA,15,23,20,18,0,0,0,76,20011113
2002,CLE,22,24,27,34,0,0,0,107,MIN,27,15,31,30,0,0,0,103,20011113
2002,POR,19,24,23,16,0,0,0,82,NYK,30,21,11,27,0,0,0,89,20011113
2002,TOR,22,22,22,20,0,0,0,86,SAC,31,28,15,21,0,0,0,95,20011113
2002,HOU,15,9,27,35,0,0,0,86,SAS,21,24,25,20,0,0,0,90,20011113
2002,PHO,20,24,26,22,0,0,0,92,SEA,20,23,31,17,0,0,0,91,20011113
2002,UTA,21,14,19,25,0,0,0,79,ATL,24,27,31,29,0,0,0,111,20011114
2002,IND,25,20,31,17,0,0,0,93,BOS,30,22,26,23,0,0,0,101,20011114
2002,DAL,30,26,28,23,0,0,0,107,CLE,22,29,19,24,0,0,0,94,20011114
2002,TOR,16,26,23,24,0,0,0,89,GSW,24,19,23,16,0,0,0,82,20011114
2002,CHI,26,18,29,29,0,0,0,102,LAC,26,27,31,22,0,0,0,106,20011114
2002,CHH,22,26,18,20,0,0,0,86,PHI,22,25,28,25,0,0,0,100,20011114
2002,ORL,28,23,24,18,0,0,0,93,PHO,22,26,28,16,0,0,0,92,20011114
2002,MIL,29,29,26,23,0,0,0,107,WAS,29,12,37,20,0,0,0,98,20011114
2002,ORL,26,26,24,25,0,0,0,101,DEN,21,25,18,18,0,0,0,82,20011115
2002,DAL,25,12,30,22,0,0,0,89,DET,30,32,19,34,0,0,0,115,20011115
2002,LAL,25,22,22,18,11,0,0,98,HOU,22,17,27,21,10,0,0,97,20011115
2002,POR,26,18,23,34,0,0,0,101,MEM,19,25,23,18,0,0,0,85,20011115
2002,MIA,17,28,21,8,0,0,0,74,NYK,29,18,16,20,0,0,0,83,20011115
2002,MIN,25,25,22,26,11,11,0,120,IND,32,26,18,22,11,4,0,113,20011116
2002,TOR,23,22,24,25,0,0,0,94,LAC,20,17,32,16,0,0,0,85,20011116
2002,CHH,24,18,31,23,0,0,0,96,MIA,19,25,29,14,0,0,0,87,20011116
2002,NYK,21,15,35,12,0,0,0,83,NJN,30,29,21,29,0,0,0,109,20011116
2002,ATL,20,19,22,17,0,0,0,78,PHI,21,28,22,27,0,0,0,98,20011116
2002,LAL,25,19,21,18,0,0,0,83,PHO,19,23,32,21,0,0,0,95,20011116
2002,CHI,26,15,11,19,0,0,0,71,SAC,25,31,24,25,0,0,0,105,20011116
2002,CLE,24,20,25,22,0,0,0,91,SAS,34,19,21,31,0,0,0,105,20011116
2002,GSW,21,29,24,17,0,0,0,91,SEA,34,23,23,20,0,0,0,100,20011116
2002,UTA,27,21,29,24,0,0,0,101,WAS,23,26,18,25,0,0,0,92,20011116
2002,BOS,25,23,34,21,0,0,0,103,ATL,36,29,21,26,0,0,0,112,20011117
2002,POR,19,21,30,27,0,0,0,97,CHH,22,18,17,30,0,0,0,87,20011117
2002,IND,30,18,19,31,0,0,0,98,DET,24,27,21,32,0,0,0,104,20011117
2002,CHI,23,21,27,17,0,0,0,88,GSW,28,18,29,18,0,0,0,93,20011117
2002,DAL,26,26,18,17,0,0,0,87,HOU,36,20,41,27,0,0,0,124,20011117
2002,CLE,25,29,20,19,0,0,0,93,MEM,24,19,29,26,0,0,0,98,20011117
2002,UTA,27,25,20,21,0,0,0,93,MIL,14,25,36,29,0,0,0,104,20011117
2002,ORL,22,27,12,34,0,0,0,95,MIN,24,20,31,28,0,0,0,103,20011117
2002,PHI,29,21,23,21,0,0,0,94,NJN,20,24,16,22,0,0,0,82,20011117
2002,DEN,22,26,33,22,0,0,0,103,SEA,26,28,16,23,0,0,0,93,20011117
2002,NYK,20,16,29,21,0,0,0,86,LAC,21,25,23,30,0,0,0,99,20011118
2002,SAC,19,25,24,17,0,0,0,85,LAL,15,20,29,29,0,0,0,93,20011118
2002,TOR,28,16,27,16,0,0,0,87,PHO,18,21,21,21,0,0,0,81,20011118
2002,NJN,22,16,23,29,6,0,0,96,DEN,24,25,21,20,9,0,0,99,20011119
2002,HOU,19,20,25,13,0,0,0,77,SAC,25,29,28,31,0,0,0,113,20011119
2002,SEA,30,24,34,17,0,0,0,105,DAL,20,24,27,26,0,0,0,97,20011120
2002,NYK,30,25,29,10,0,0,0,94,GSW,18,7,21,24,0,0,0,70,20011120
2002,ATL,31,30,27,14,0,0,0,102,IND,23,19,34,30,0,0,0,106,20011120
2002,LAL,25,27,25,21,0,0,0,98,LAC,21,25,18,29,0,0,0,93,20011120
2002,MIN,23,19,18,20,0,0,0,80,MIA,15,17,16,25,0,0,0,73,20011120
2002,HOU,15,31,28,20,0,0,0,94,POR,15,24,26,22,0,0,0,87,20011120
2002,DET,24,24,13,27,0,0,0,88,TOR,24,19,22,19,0,0,0,84,20011120
2002,CHH,18,20,28,29,0,0,0,95,WAS,18,22,19,29,0,0,0,88,20011120
2002,ATL,17,26,29,20,0,0,0,92,BOS,18,19,25,23,0,0,0,85,20011121
2002,DAL,23,25,25,16,0,0,0,89,CHH,21,21,18,18,0,0,0,78,20011121
2002,MEM,27,17,23,27,0,0,0,94,CLE,30,20,32,19,0,0,0,101,20011121
2002,LAL,27,22,17,23,0,0,0,89,DEN,13,22,20,13,0,0,0,68,20011121
2002,CHI,26,23,16,27,0,0,0,92,MIL,22,21,30,23,0,0,0,96,20011121
2002,MIN,31,25,28,22,0,0,0,106,ORL,36,31,26,24,0,0,0,117,20011121
2002,DET,13,31,24,21,0,0,0,89,PHI,26,14,25,29,0,0,0,94,20011121
2002,NYK,17,16,28,11,0,0,0,72,PHO,30,18,29,19,0,0,0,96,20011121
2002,POR,23,20,20,20,0,0,0,83,SAC,23,24,18,30,0,0,0,95,20011121
2002,SEA,20,24,21,28,0,0,0,93,SAS,40,28,19,23,0,0,0,110,20011121
2002,NJN,26,23,17,16,8,0,0,90,UTA,20,21,24,17,7,0,0,89,20011121
2002,WAS,23,27,25,28,0,0,0,103,IND,26,20,35,29,0,0,0,110,20011122
2002,NJN,27,22,22,24,0,0,0,95,LAC,21,23,22,24,0,0,0,90,20011122
2002,MIL,20,28,16,14,0,0,0,78,TOR,22,17,18,18,0,0,0,75,20011122
2002,DET,31,26,25,17,0,0,0,99,ATL,25,16,31,34,0,0,0,106,20011123
2002,TOR,18,21,29,23,0,0,0,91,BOS,23,25,25,16,0,0,0,89,20011123
2002,ORL,34,31,26,18,0,0,0,109,CHH,21,25,28,25,0,0,0,99,20011123
2002,SAS,24,22,27,24,0,0,0,97,IND,29,13,21,16,0,0,0,79,20011123
2002,GSW,16,24,22,28,0,0,0,90,LAL,37,25,23,21,0,0,0,106,20011123
2002,PHO,27,30,28,18,0,0,0,103,MEM,25,21,22,21,0,0,0,89,20011123
2002,DAL,23,31,24,26,0,0,0,104,MIA,29,21,17,27,0,0,0,94,20011123
2002,CLE,17,12,17,22,0,0,0,68,PHI,19,23,18,19,0,0,0,79,20011123
2002,DEN,23,26,19,22,0,0,0,90,POR,26,19,25,27,0,0,0,97,20011123
2002,HOU,23,22,20,16,0,0,0,81,SEA,26,21,30,22,0,0,0,99,20011123
2002,LAC,31,23,32,15,0,0,0,101,UTA,23,29,26,28,0,0,0,106,20011123
2002,MIA,25,20,19,25,7,0,0,96,CLE,26,18,26,19,11,0,0,100,20011124
2002,PHO,22,22,29,31,0,0,0,104,DAL,31,25,25,38,0,0,0,119,20011124
2002,MEM,22,22,27,13,0,0,0,84,DET,25,24,17,25,0,0,0,91,20011124
2002,ATL,23,23,18,24,0,0,0,88,MIL,15,27,27,26,0,0,0,95,20011124
2002,SAS,25,22,19,28,0,0,0,94,MIN,24,24,26,25,0,0,0,99,20011124
2002,CHI,16,21,14,20,0,0,0,71,NYK,25,16,16,21,0,0,0,78,20011124
2002,CHH,34,27,15,27,0,0,0,103,ORL,39,20,19,23,0,0,0,101,20011124
2002,NJN,22,26,24,25,0,0,0,97,SAC,31,24,20,23,0,0,0,98,20011124
2002,BOS,18,21,13,26,6,0,0,84,WAS,20,24,21,13,10,0,0,88,20011124
2002,NJN,25,25,13,22,0,0,0,85,GSW,25,20,30,26,0,0,0,101,20011125
2002,HOU,16,21,26,20,0,0,0,83,LAC,31,19,22,18,0,0,0,90,20011125
2002,DEN,23,28,29,18,0,0,0,98,LAL,29,33,16,27,0,0,0,105,20011125
2002,IND,26,24,20,18,0,0,0,88,SEA,21,26,28,24,0,0,0,99,20011125
2002,PHI,21,24,19,24,0,0,0,88,TOR,25,29,24,29,0,0,0,107,20011125
2002,SAC,34,22,21,17,0,0,0,94,MEM,22,29,23,24,0,0,0,98,20011126
2002,ATL,29,26,14,14,0,0,0,83,NYK,24,21,19,24,0,0,0,88,20011126
2002,DET,25,20,21,39,0,0,0,105,ORL,22,27,20,31,0,0,0,100,20011126
2002,PHO,29,33,19,17,13,0,0,111,UTA,20,30,28,20,6,0,0,104,20011126
2002,WAS,20,20,18,17,0,0,0,75,CLE,32,16,18,28,0,0,0,94,20011127
2002,GSW,39,23,17,27,0,0,0,106,DAL,23,26,33,34,0,0,0,116,20011127
2002,SAC,29,23,16,21,0,0,0,89,HOU,27,14,26,17,0,0,0,84,20011127
2002,MIL,28,21,22,14,0,0,0,85,LAL,21,26,27,30,0,0,0,104,20011127
2002,BOS,24,26,21,13,0,0,0,84,MIA,16,29,22,16,0,0,0,83,20011127
2002,CHI,21,21,6,20,0,0,0,68,NJN,28,24,24,24,0,0,0,100,20011127
2002,IND,28,25,20,17,0,0,0,90,POR,15,24,27,30,0,0,0,96,20011127
2002,MIN,22,28,23,29,0,0,0,102,SEA,33,20,29,30,0,0,0,112,20011127
2002,NYK,28,29,23,25,0,0,0,105,ATL,19,30,17,34,0,0,0,100,20011128
2002,IND,23,26,22,28,0,0,0,99,DEN,21,23,22,19,0,0,0,85,20011128
2002,CHH,26,27,20,31,0,0,0,104,DET,16,16,29,35,0,0,0,96,20011128
2002,MIN,16,21,17,21,0,0,0,75,LAC,20,19,28,27,0,0,0,94,20011128
2002,WAS,25,22,25,22,0,0,0,94,PHI,27,23,16,21,0,0,0,87,20011128
2002,MIL,20,21,18,25,0,0,0,84,PHO,22,36,28,18,0,0,0,104,20011128
2002,GSW,20,17,24,22,0,0,0,83,SAS,26,27,19,22,0,0,0,94,20011128
2002,SEA,27,19,20,22,0,0,0,88,UTA,29,34,22,27,0,0,0,112,20011128
2002,MIA,21,19,15,17,0,0,0,72,CHI,20,27,10,21,0,0,0,78,20011129
2002,ATL,26,32,20,27,0,0,0,105,CLE,37,23,16,20,0,0,0,96,20011129
2002,SAC,30,29,21,30,0,0,0,110,DAL,23,19,29,27,0,0,0,98,20011129
2002,BOS,24,31,24,20,0,0,0,99,ORL,23,24,24,18,0,0,0,89,20011129
2002,MEM,18,19,28,23,0,0,0,88,TOR,25,15,38,13,0,0,0,91,20011129
2002,DET,27,29,25,29,0,0,0,110,CHH,27,21,26,31,0,0,0,105,20011130
2002,LAC,14,31,21,27,0,0,0,93,DEN,24,20,22,30,0,0,0,96,20011130
2002,HOU,22,19,17,27,0,0,0,85,MEM,21,20,34,27,0,0,0,102,20011130
2002,WAS,24,19,23,18,0,0,0,84,MIA,21,28,17,9,0,0,0,75,20011130
2002,UTA,22,25,14,15,0,0,0,76,PHO,24,24,31,19,0,0,0,98,20011130
2002,MIL,33,14,26,22,0,0,0,95,POR,30,32,21,18,0,0,0,101,20011130
2002,SAC,23,31,21,22,12,0,0,109,SAS,23,26,32,16,9,0,0,106,20011130
2002,LAL,20,30,31,26,0,0,0,107,SEA,24,19,23,26,0,0,0,92,20011130
2002,TOR,25,25,30,24,0,0,0,104,ATL,19,23,30,31,0,0,0,103,20011201
2002,PHI,31,25,16,21,0,0,0,93,CHI,11,29,8,28,0,0,0,76,20011201
2002,CHH,19,26,17,19,0,0,0,81,CLE,16,30,27,20,0,0,0,93,20011201
2002,DAL,20,28,39,24,0,0,0,111,GSW,18,22,18,24,0,0,0,82,20011201
2002,SAS,32,8,17,28,0,0,0,85,HOU,18,17,18,22,0,0,0,75,20011201
2002,MIN,21,25,16,14,0,0,0,76,LAL,24,22,31,25,0,0,0,102,20011201
2002,BOS,15,18,30,27,15,0,0,105,NJN,27,20,17,26,8,0,0,98,20011201
2002,DET,20,17,29,34,0,0,0,100,NYK,29,24,22,22,0,0,0,97,20011201
2002,PHO,17,25,28,27,0,0,0,97,POR,31,22,15,15,0,0,0,83,20011201
2002,IND,16,32,25,27,0,0,0,100,UTA,19,27,28,23,0,0,0,97,20011201
2002,ORL,21,29,22,24,0,0,0,96,WAS,18,21,22,26,0,0,0,87,20011201
2002,IND,19,23,12,18,0,0,0,72,LAC,23,30,31,19,0,0,0,103,20011202
2002,MEM,23,20,24,26,0,0,0,93,PHI,18,22,27,20,0,0,0,87,20011202
2002,DAL,32,30,21,22,15,0,0,120,SAC,29,15,36,25,9,0,0,114,20011202
2002,MIL,19,21,20,23,0,0,0,83,SEA,25,32,22,18,0,0,0,97,20011202
2002,BOS,31,15,27,12,0,0,0,85,TOR,23,21,16,9,0,0,0,69,20011202
2002,HOU,24,18,28,16,0,0,0,86,NYK,30,8,22,29,0,0,0,89,20011203
2002,MEM,19,26,15,11,0,0,0,71,ORL,25,37,29,22,0,0,0,113,20011203
2002,GSW,17,24,24,28,0,0,0,93,PHO,24,32,31,23,0,0,0,110,20011203
2002,HOU,19,15,22,19,0,0,0,75,CHI,28,27,19,29,0,0,0,103,20011204
2002,DET,28,25,17,18,0,0,0,88,CLE,32,20,25,23,0,0,0,100,20011204
2002,DEN,23,28,19,26,0,0,0,96,IND,26,37,22,19,0,0,0,104,20011204
2002,MIA,23,23,24,13,0,0,0,83,LAC,25,21,21,20,0,0,0,87,20011204
2002,NYK,24,18,24,19,0,0,0,85,MIL,19,14,29,9,0,0,0,71,20011204
2002,SEA,20,27,21,15,0,0,0,83,MIN,28,30,24,26,0,0,0,108,20011204
2002,PHI,19,27,20,18,0,0,0,84,SAC,22,26,26,20,0,0,0,94,20011204
2002,WAS,26,22,14,26,0,0,0,88,SAS,29,28,28,18,0,0,0,103,20011204
2002,CHH,29,32,25,14,0,0,0,100,UTA,27,31,18,28,0,0,0,104,20011204
2002,SAS,32,35,30,23,0,0,0,120,ATL,20,26,38,28,0,0,0,112,20011205
2002,DEN,24,20,16,20,0,0,0,80,BOS,28,23,31,13,0,0,0,95,20011205
2002,SEA,27,22,24,18,0,0,0,91,DET,17,30,28,20,0,0,0,95,20011205
2002,PHI,23,16,29,19,0,0,0,87,GSW,21,20,25,27,0,0,0,93,20011205
2002,DAL,26,29,24,15,0,0,0,94,LAL,25,23,27,23,0,0,0,98,20011205
2002,PHO,28,18,15,26,0,0,0,87,NJN,25,30,27,24,0,0,0,106,20011205
2002,CHI,17,23,18,16,0,0,0,74,ORL,33,24,29,16,0,0,0,102,20011205
2002,WAS,22,16,22,25,0,0,0,85,HOU,24,16,18,24,0,0,0,82,20011206
2002,MIN,29,29,29,18,0,0,0,105,MEM,22,15,28,15,0,0,0,80,20011206
2002,TOR,23,16,21,29,0,0,0,89,MIL,22,24,28,21,0,0,0,95,20011206
2002,CHH,26,19,28,22,0,0,0,95,POR,25,13,18,33,0,0,0,89,20011206
2002,PHO,25,22,22,23,10,0,0,102,BOS,21,28,23,20,17,0,0,109,20011207
2002,CHH,30,22,21,33,0,0,0,106,GSW,19,22,25,23,0,0,0,89,20011207
2002,CHI,20,18,22,23,0,0,0,83,IND,30,20,22,26,0,0,0,98,20011207
2002,UTA,20,22,27,33,0,0,0,102,LAC,23,19,25,19,0,0,0,86,20011207
2002,CLE,20,22,21,21,0,0,0,84,NJN,26,18,27,25,0,0,0,96,20011207
2002,ATL,29,15,28,22,0,0,0,94,ORL,36,34,28,31,0,0,0,129,20011207
2002,LAL,19,24,13,35,0,0,0,91,SAC,28,20,18,31,0,0,0,97,20011207
2002,PHI,20,20,16,20,0,0,0,76,SAS,24,19,16,27,0,0,0,86,20011207
2002,MIA,24,25,19,20,10,0,0,98,SEA,16,26,27,19,6,0,0,94,20011207
2002,DEN,19,17,25,26,9,0,0,96,TOR,23,25,17,22,11,0,0,98,20011207
2002,ORL,34,25,22,23,0,0,0,104,ATL,22,28,29,28,0,0,0,107,20011208
2002,BOS,27,25,18,14,0,0,0,84,CHI,18,21,31,17,0,0,0,87,20011208
2002,DEN,27,15,29,28,0,0,0,99,CLE,23,35,32,19,0,0,0,109,20011208
2002,WAS,27,28,13,34,0,0,0,102,DAL,22,16,26,31,0,0,0,95,20011208
2002,PHI,24,16,21,22,0,0,0,83,MEM,35,18,19,20,0,0,0,92,20011208
2002,NJN,17,20,24,18,0,0,0,79,MIL,30,24,26,15,0,0,0,95,20011208
2002,HOU,16,26,33,22,0,0,0,97,MIN,28,28,29,22,0,0,0,107,20011208
2002,IND,25,12,29,33,0,0,0,99,NYK,20,25,28,28,0,0,0,101,20011208
2002,SEA,18,29,23,22,0,0,0,92,POR,31,26,27,29,0,0,0,113,20011208
2002,GSW,28,23,27,23,0,0,0,101,UTA,35,27,22,27,0,0,0,111,20011208
2002,HOU,23,13,14,27,0,0,0,77,DET,28,27,21,29,0,0,0,105,20011209
2002,CHH,21,20,17,20,0,0,0,78,LAC,29,22,14,24,0,0,0,89,20011209
2002,MIA,24,23,23,18,0,0,0,88,SAC,26,28,22,19,0,0,0,95,20011209
2002,PHO,25,18,25,23,0,0,0,91,TOR,18,30,14,28,0,0,0,90,20011209
2002,ORL,27,24,25,16,0,0,0,92,LAC,18,33,24,25,0,0,0,100,20011210
2002,DAL,25,30,23,20,0,0,0,98,UTA,25,36,20,26,0,0,0,107,20011210
2002,PHI,28,21,21,17,0,0,0,87,ATL,20,25,20,24,0,0,0,89,20011211
2002,NJN,27,32,26,22,0,0,0,107,CHI,27,20,27,19,0,0,0,93,20011211
2002,POR,30,18,18,37,0,0,0,103,DAL,22,24,23,36,0,0,0,105,20011211
2002,CHH,29,24,25,21,0,0,0,99,DEN,28,17,23,28,0,0,0,96,20011211
2002,CLE,32,29,20,26,0,0,0,107,HOU,18,32,24,28,0,0,0,102,20011211
2002,SEA,35,26,24,19,0,0,0,104,LAL,30,24,23,16,0,0,0,93,20011211
2002,WAS,28,30,18,15,0,0,0,91,MEM,27,14,16,24,0,0,0,81,20011211
2002,MIL,25,24,25,23,0,0,0,97,MIA,27,25,27,20,0,0,0,99,20011211
2002,GSW,28,22,16,20,0,0,0,86,MIN,30,30,19,28,0,0,0,107,20011211
2002,BOS,21,27,22,19,13,0,0,102,NYK,21,26,26,16,4,0,0,93,20011211
2002,ORL,26,20,28,26,0,0,0,100,SAC,25,30,30,27,0,0,0,112,20011211
2002,SEA,21,24,22,27,0,0,0,94,LAC,33,37,22,22,0,0,0,114,20011212
2002,SAC,14,25,26,23,0,0,0,88,PHO,27,34,24,29,0,0,0,114,20011212
2002,TOR,23,24,21,27,0,0,0,95,SAS,20,34,32,22,0,0,0,108,20011212
2002,MIN,24,27,31,16,0,0,0,98,UTA,21,31,13,22,0,0,0,87,20011212
2002,MIA,20,20,23,17,0,0,0,80,WAS,25,24,22,11,0,0,0,82,20011212
2002,TOR,24,18,25,23,0,0,0,90,CHH,40,22,23,19,0,0,0,104,20011213
2002,CLE,22,18,24,18,0,0,0,82,DAL,22,30,25,25,0,0,0,102,20011213
2002,MEM,21,26,20,19,0,0,0,86,DEN,20,17,29,23,0,0,0,89,20011213
2002,NYK,20,24,29,24,0,0,0,97,DET,25,22,28,24,0,0,0,99,20011213
2002,ORL,25,35,20,25,0,0,0,105,GSW,27,22,23,28,0,0,0,100,20011213
2002,HOU,26,22,30,18,10,0,0,106,IND,28,18,24,26,12,0,0,108,20011213
2002,CHI,27,23,31,20,0,0,0,101,BOS,30,23,23,31,0,0,0,107,20011214
2002,LAC,26,22,17,15,0,0,0,80,LAL,23,21,28,38,0,0,0,110,20011214
2002,NJN,26,22,31,16,0,0,0,95,MIA,20,32,18,16,0,0,0,86,20011214
2002,SAC,35,23,14,22,0,0,0,94,MIN,23,29,34,28,0,0,0,114,20011214
2002,MIL,21,23,24,28,0,0,0,96,PHI,21,22,19,18,0,0,0,80,20011214
2002,SAS,20,33,24,28,0,0,0,105,PHO,20,25,27,21,0,0,0,93,20011214
2002,POR,13,27,15,30,0,0,0,85,UTA,26,24,18,25,0,0,0,93,20011214
2002,NYK,21,19,24,16,0,0,0,80,WAS,27,26,26,17,0,0,0,96,20011214
2002,BOS,33,16,35,22,0,0,0,106,CHH,26,25,23,23,0,0,0,97,20011215
2002,ATL,19,21,23,17,0,0,0,80,CHI,19,22,18,20,0,0,0,79,20011215
2002,PHI,21,29,20,24,0,0,0,94,CLE,27,16,22,26,0,0,0,91,20011215
2002,MIN,27,33,22,35,0,0,0,117,DAL,25,32,33,35,0,0,0,125,20011215
2002,PHO,29,25,29,15,0,0,0,98,DEN,24,26,26,30,0,0,0,106,20011215
2002,MEM,26,16,19,23,0,0,0,84,GSW,31,24,23,15,0,0,0,93,20011215
2002,MIA,22,15,18,21,0,0,0,76,HOU,23,12,18,20,0,0,0,73,20011215
2002,IND,34,21,20,20,0,0,0,95,MIL,30,25,32,28,0,0,0,115,20011215
2002,ORL,16,28,32,30,0,0,0,106,POR,30,22,30,35,0,0,0,117,20011215
2002,UTA,20,25,15,20,0,0,0,80,SAS,33,25,22,20,0,0,0,100,20011215
2002,DET,21,22,23,11,0,0,0,77,LAC,16,26,14,26,0,0,0,82,20011216
2002,GSW,28,14,23,20,0,0,0,85,LAL,26,20,32,23,0,0,0,101,20011216
2002,NJN,27,21,34,32,0,0,0,114,NYK,27,23,28,18,0,0,0,96,20011216
2002,MEM,20,18,21,28,0,0,0,87,SAC,35,19,23,27,0,0,0,104,20011216
2002,ORL,18,30,24,19,0,0,0,91,SEA,34,21,28,31,0,0,0,114,20011216
2002,WAS,23,23,27,20,0,0,0,93,TOR,34,18,16,20,0,0,0,88,20011216
2002,BOS,21,14,22,26,0,0,0,83,PHI,30,21,27,21,0,0,0,99,20011217
2002,IND,28,22,25,28,0,0,0,103,ATL,27,28,26,19,0,0,0,100,20011218
2002,NYK,29,18,27,26,0,0,0,100,CHH,27,21,16,31,0,0,0,95,20011218
2002,CHI,21,25,23,15,0,0,0,84,CLE,37,18,22,25,0,0,0,102,20011218
2002,SAS,26,23,22,31,0,0,0,102,DEN,27,18,27,21,0,0,0,93,20011218
2002,POR,21,24,35,21,0,0,0,101,HOU,27,21,25,19,0,0,0,92,20011218
2002,MIL,36,31,16,31,0,0,0,114,MEM,32,26,27,20,0,0,0,105,20011218
2002,UTA,20,27,23,25,0,0,0,95,MIA,12,11,18,15,0,0,0,56,20011218
2002,DAL,19,26,28,34,0,0,0,107,MIN,30,31,25,17,0,0,0,103,20011218
2002,LAC,24,25,26,21,0,0,0,96,PHO,26,30,27,9,0,0,0,92,20011218
2002,DET,21,26,26,25,0,0,0,98,SAC,25,26,26,25,0,0,0,102,20011218
2002,CLE,13,22,29,34,0,0,0,98,BOS,21,33,27,23,0,0,0,104,20011219
2002,DET,27,18,18,25,0,0,0,88,GSW,23,28,17,33,0,0,0,101,20011219
2002,TOR,27,23,24,28,0,0,0,102,IND,26,21,29,14,0,0,0,90,20011219
2002,MIN,26,22,23,32,9,0,0,112,NJN,21,34,29,19,14,0,0,117,20011219
2002,UTA,19,13,29,29,0,0,0,90,ORL,22,15,22,39,0,0,0,98,20011219
2002,CHH,38,17,22,17,0,0,0,94,PHI,21,32,15,17,0,0,0,85,20011219
2002,POR,15,20,24,20,0,0,0,79,SAS,24,26,22,25,0,0,0,97,20011219
2002,SAC,22,24,22,24,0,0,0,92,SEA,26,26,30,22,0,0,0,104,20011219
2002,ATL,14,19,22,21,0,0,0,76,WAS,20,29,27,27,0,0,0,103,20011219
2002,MIL,20,33,22,26,0,0,0,101,DAL,31,28,28,26,0,0,0,113,20011220
2002,LAL,27,26,29,25,0,0,0,107,HOU,21,30,17,33,0,0,0,101,20011220
2002,MEM,18,22,34,16,0,0,0,90,NYK,14,23,28,23,0,0,0,88,20011220
2002,CHI,25,22,24,20,0,0,0,91,TOR,17,22,26,31,0,0,0,96,20011220
2002,UTA,19,26,23,24,0,0,0,92,BOS,22,25,23,28,0,0,0,98,20011221
2002,SEA,27,44,16,9,15,0,0,111,GSW,24,25,21,26,12,0,0,108,20011221
2002,NJN,24,18,20,32,0,0,0,94,IND,20,31,26,23,0,0,0,100,20011221
2002,LAL,31,27,24,26,0,0,0,108,MEM,26,30,24,34,0,0,0,114,20011221
2002,CLE,21,24,14,19,8,0,0,86,MIA,20,16,23,19,3,0,0,81,20011221
2002,CHH,22,21,19,27,0,0,0,89,MIN,33,18,25,18,0,0,0,94,20011221
2002,WAS,25,18,21,29,0,0,0,93,ORL,18,25,17,15,0,0,0,75,20011221
2002,ATL,17,26,17,23,0,0,0,83,PHI,35,15,28,16,0,0,0,94,20011221
2002,DET,19,20,18,24,0,0,0,81,POR,16,18,30,19,0,0,0,83,20011221
2002,DEN,19,24,12,19,0,0,0,74,SAS,34,27,24,24,0,0,0,109,20011221
2002,CHH,30,16,25,17,0,0,0,88,ATL,19,25,31,26,0,0,0,101,20011222
2002,MIN,22,22,21,30,0,0,0,95,CHI,12,23,17,22,0,0,0,74,20011222
2002,IND,32,24,28,25,0,0,0,109,CLE,26,26,26,25,0,0,0,103,20011222
2002,ORL,21,20,17,22,0,0,0,80,DAL,24,34,20,24,0,0,0,102,20011222
2002,GSW,22,27,27,29,0,0,0,105,DEN,25,15,31,30,0,0,0,101,20011222
2002,MIL,20,25,30,35,0,0,0,110,HOU,28,15,36,36,0,0,0,115,20011222
2002,SAC,25,23,17,20,0,0,0,85,LAC,21,28,22,30,0,0,0,101,20011222
2002,UTA,21,31,25,27,0,0,0,104,NJN,24,18,28,20,0,0,0,90,20011222
2002,WAS,20,17,26,24,0,0,0,87,NYK,32,8,22,24,0,0,0,86,20011222
2002,POR,23,15,28,24,0,0,0,90,PHO,19,23,18,42,0,0,0,102,20011222
2002,DET,25,15,21,28,0,0,0,89,SEA,31,31,24,31,0,0,0,117,20011222
2002,MEM,16,18,25,21,0,0,0,80,BOS,30,16,20,19,0,0,0,85,20011223
2002,PHO,24,12,25,40,0,0,0,101,SAC,29,26,33,45,0,0,0,133,20011223
2002,MIL,23,24,23,31,0,0,0,101,SAS,25,25,23,18,0,0,0,91,20011223
2002,MIA,20,14,17,25,0,0,0,76,TOR,21,22,22,18,0,0,0,83,20011223
2002,PHI,21,28,17,16,0,0,0,82,LAL,18,21,21,28,0,0,0,88,20011225
2002,TOR,15,27,22,30,0,0,0,94,NYK,30,24,18,30,0,0,0,102,20011225
2002,WAS,30,27,15,21,0,0,0,93,CHH,29,23,21,26,0,0,0,99,20011226
2002,NJN,31,24,17,19,0,0,0,91,CLE,19,16,26,28,0,0,0,89,20011226
2002,MIN,27,20,26,21,0,0,0,94,DEN,21,25,18,27,0,0,0,91,20011226
2002,LAL,20,23,23,24,0,0,0,90,GSW,27,20,29,25,0,0,0,101,20011226
2002,PHO,15,32,24,26,0,0,0,97,HOU,20,24,23,24,0,0,0,91,20011226
2002,PHI,23,26,25,26,0,0,0,100,LAC,21,26,19,20,0,0,0,86,20011226
2002,CHI,19,25,24,17,0,0,0,85,MEM,30,24,29,24,0,0,0,107,20011226
2002,ATL,26,28,21,22,0,0,0,97,MIL,19,30,33,25,0,0,0,107,20011226
2002,IND,25,17,22,25,0,0,0,89,ORL,20,24,18,20,0,0,0,82,20011226
2002,POR,12,14,21,27,0,0,0,74,SAC,26,18,20,25,0,0,0,89,20011226
2002,DAL,27,32,27,30,10,0,0,126,SAS,23,35,24,34,7,0,0,123,20011226
2002,BOS,18,22,23,23,0,0,0,86,UTA,17,26,29,27,0,0,0,99,20011226
2002,MIA,35,23,22,16,0,0,0,96,ATL,18,30,21,31,0,0,0,100,20011227
2002,CHI,20,14,22,18,0,0,0,74,DAL,32,11,20,26,0,0,0,89,20011227
2002,NJN,24,20,30,14,0,0,0,88,DET,20,19,18,18,0,0,0,75,20011227
2002,WAS,21,22,12,26,0,0,0,81,IND,30,25,27,26,0,0,0,108,20011227
2002,BOS,22,26,15,19,0,0,0,82,PHO,24,17,20,23,0,0,0,84,20011227
2002,UTA,11,27,33,28,0,0,0,99,POR,27,8,28,24,0,0,0,87,20011227
2002,LAC,24,25,16,25,0,0,0,90,SEA,23,24,20,34,0,0,0,101,20011227
2002,MIL,33,27,25,20,0,0,0,105,CHH,26,16,27,20,0,0,0,89,20011228
2002,NYK,24,23,17,24,0,0,0,88,CLE,16,26,25,31,0,0,0,98,20011228
2002,PHI,26,20,21,23,0,0,0,90,DEN,23,27,27,16,0,0,0,93,20011228
2002,HOU,22,24,28,26,0,0,0,100,GSW,19,27,23,24,0,0,0,93,20011228
2002,TOR,22,22,23,22,0,0,0,89,LAL,19,18,25,24,0,0,0,86,20011228
2002,MEM,23,24,25,19,0,0,0,91,MIA,18,24,21,23,0,0,0,86,20011228
2002,DET,13,17,27,21,0,0,0,78,ORL,20,22,20,25,0,0,0,87,20011228
2002,MIN,24,26,35,26,0,0,0,111,SAC,33,32,29,31,0,0,0,125,20011228
2002,CLE,19,21,17,23,0,0,0,80,CHI,21,32,27,23,0,0,0,103,20011229
2002,ATL,27,20,33,17,0,0,0,97,DAL,32,34,22,25,0,0,0,113,20011229
2002,BOS,9,32,25,27,12,0,0,105,LAC,24,20,33,16,10,0,0,103,20011229
2002,SAS,32,15,19,27,6,0,0,99,MIL,23,34,22,14,9,0,0,102,20011229
2002,IND,23,22,24,19,5,0,0,93,NJN,30,21,22,15,10,0,0,98,20011229
2002,DEN,27,24,20,21,0,0,0,92,PHO,25,33,24,27,0,0,0,109,20011229
2002,TOR,22,14,20,19,0,0,0,75,SEA,26,31,22,22,0,0,0,101,20011229
2002,PHI,24,10,25,22,0,0,0,81,UTA,21,23,23,22,0,0,0,89,20011229
2002,CHH,28,23,16,23,0,0,0,90,WAS,29,27,28,23,0,0,0,107,20011229
2002,MIA,22,20,13,25,0,0,0,80,DET,27,19,18,22,0,0,0,86,20011230
2002,HOU,16,26,28,20,0,0,0,90,LAL,23,32,29,30,0,0,0,114,20011230
2002,SAS,15,29,16,23,0,0,0,83,MEM,18,23,14,24,0,0,0,79,20011230
2002,ORL,27,16,20,31,0,0,0,94,NYK,26,23,26,15,0,0,0,90,20011230
2002,MIN,28,17,27,23,0,0,0,95,POR,26,24,21,22,0,0,0,93,20011230
2002,BOS,22,23,20,29,0,0,0,94,SAC,34,25,29,21,0,0,0,109,20011230
2002,MIL,19,24,23,17,0,0,0,83,CHI,16,21,31,22,0,0,0,90,20011231
2002,MIA,25,11,26,27,0,0,0,89,IND,20,26,18,23,0,0,0,87,20011231
2002,NJN,25,16,21,14,0,0,0,76,WAS,19,25,30,24,0,0,0,98,20011231
2002,POR,26,24,29,18,0,0,0,97,LAC,32,32,24,24,0,0,0,112,20020101
2002,ORL,27,23,12,32,0,0,0,94,BOS,26,40,17,27,0,0,0,110,20020102
2002,DAL,17,26,28,36,0,0,0,107,CHI,15,27,26,29,0,0,0,97,20020102
2002,GSW,16,36,26,20,0,0,0,98,CLE,31,23,34,25,0,0,0,113,20020102
2002,LAL,24,19,30,14,0,0,0,87,DEN,22,24,25,15,0,0,0,86,20020102
2002,MIL,23,23,17,14,0,0,0,77,MIN,19,28,31,17,0,0,0,95,20020102
2002,MEM,28,7,21,18,0,0,0,74,NJN,29,22,26,15,0,0,0,92,20020102
2002,PHI,26,26,36,14,0,0,0,102,PHO,18,28,14,21,0,0,0,81,20020102
2002,TOR,25,23,25,22,0,0,0,95,POR,16,20,22,26,0,0,0,84,20020102
2002,LAC,24,23,20,24,0,0,0,91,SAC,30,26,22,27,0,0,0,105,20020102
2002,DET,28,18,20,19,0,0,0,85,SAS,29,24,19,25,0,0,0,97,20020102
2002,GSW,26,22,29,25,0,0,0,102,CHH,31,33,26,24,0,0,0,114,20020103
2002,DET,26,21,31,19,0,0,0,97,HOU,27,29,18,25,0,0,0,99,20020103
2002,DAL,31,33,13,17,7,0,0,101,NYK,37,26,18,13,14,0,0,108,20020103
2002,MIA,23,21,18,27,0,0,0,89,BOS,13,14,23,16,0,0,0,66,20020104
2002,LAC,22,23,22,15,0,0,0,82,DEN,20,22,21,17,0,0,0,80,20020104
2002,PHO,27,18,23,18,0,0,0,86,LAL,33,27,25,33,0,0,0,118,20020104
2002,ATL,33,24,28,28,0,0,0,113,MEM,32,29,23,25,0,0,0,109,20020104
2002,UTA,21,34,12,19,0,0,0,86,MIN,25,19,18,31,0,0,0,93,20020104
2002,ORL,35,18,29,27,0,0,0,109,NJN,30,28,14,24,0,0,0,96,20020104
2002,IND,28,21,15,28,0,0,0,92,SAS,19,26,18,19,0,0,0,82,20020104
2002,PHI,25,24,21,17,0,0,0,87,SEA,20,20,14,23,0,0,0,77,20020104
2002,CLE,22,21,20,28,0,0,0,91,TOR,29,19,30,23,0,0,0,101,20020104
2002,CHI,18,19,22,24,0,0,0,83,WAS,32,25,20,12,0,0,0,89,20020104
2002,MIN,25,29,33,25,0,0,0,112,ATL,28,22,27,19,0,0,0,96,20020105
2002,NJN,18,15,34,22,0,0,0,89,CHH,19,21,16,24,0,0,0,80,20020105
2002,UTA,32,27,26,15,13,0,0,113,CHI,26,22,31,21,11,0,0,111,20020105
2002,SAS,25,32,27,21,0,0,0,105,DAL,17,27,28,31,0,0,0,103,20020105
2002,CLE,23,19,23,26,0,0,0,91,DET,19,25,31,26,0,0,0,101,20020105
2002,IND,26,15,20,20,0,0,0,81,HOU,21,29,15,14,0,0,0,79,20020105
2002,MIL,12,22,23,26,0,0,0,83,LAC,28,14,22,22,0,0,0,86,20020105
2002,BOS,23,20,18,29,0,0,0,90,NYK,19,25,25,12,0,0,0,81,20020105
2002,GSW,23,34,27,25,0,0,0,109,ORL,39,29,20,30,0,0,0,118,20020105
2002,SAC,29,23,33,33,0,0,0,118,PHO,23,24,31,34,0,0,0,112,20020105
2002,PHI,24,19,22,23,0,0,0,88,POR,27,23,19,27,0,0,0,96,20020105
2002,SEA,19,29,19,22,0,0,0,89,MEM,23,17,18,19,0,0,0,77,20020106
2002,GSW,23,20,24,17,0,0,0,84,MIA,26,31,17,18,0,0,0,92,20020106
2002,MIL,33,17,19,32,0,0,0,101,SAC,25,26,33,31,0,0,0,115,20020106
2002,LAL,19,35,30,25,0,0,0,109,TOR,28,20,24,17,0,0,0,89,20020106
2002,DEN,24,15,21,20,0,0,0,80,CHH,27,27,18,22,0,0,0,94,20020107
2002,SEA,20,27,25,28,0,0,0,100,CHI,25,21,17,25,0,0,0,88,20020107
2002,POR,27,24,25,22,0,0,0,98,CLE,13,21,16,22,0,0,0,72,20020107
2002,DET,29,19,25,20,0,0,0,93,MIN,24,38,25,22,0,0,0,109,20020107
2002,BOS,22,29,16,20,0,0,0,87,ORL,22,26,26,24,0,0,0,98,20020107
2002,LAC,16,22,26,28,0,0,0,92,PHI,26,27,30,33,0,0,0,116,20020107
2002,NYK,17,20,20,22,0,0,0,79,SAS,21,23,22,24,0,0,0,90,20020107
2002,POR,24,27,21,20,0,0,0,92,ATL,28,21,31,21,0,0,0,101,20020108
2002,DEN,24,16,24,30,0,0,0,94,DAL,22,30,20,23,0,0,0,95,20020108
2002,LAL,26,34,39,22,0,0,0,121,DET,23,19,27,23,0,0,0,92,20020108
2002,MIL,30,35,22,26,0,0,0,113,GSW,20,26,26,25,0,0,0,97,20020108
2002,NYK,21,15,28,22,0,0,0,86,HOU,26,16,26,20,0,0,0,88,20020108
2002,TOR,18,26,20,17,0,0,0,81,MEM,20,23,25,16,0,0,0,84,20020108
2002,MIA,23,27,24,21,0,0,0,95,NJN,25,37,18,24,0,0,0,104,20020108
2002,PHO,30,9,24,21,0,0,0,84,UTA,18,33,24,23,0,0,0,98,20020108
2002,LAC,25,18,15,30,0,0,0,88,WAS,17,24,29,26,0,0,0,96,20020108
2002,SAS,23,23,24,23,0,0,0,93,BOS,21,23,23,23,0,0,0,90,20020109
2002,ATL,20,20,27,20,0,0,0,87,CHH,25,39,22,25,0,0,0,111,20020109
2002,TOR,15,27,16,27,0,0,0,85,CHI,14,18,19,22,0,0,0,73,20020109
2002,LAL,26,23,32,28,0,0,0,109,IND,27,16,21,26,0,0,0,90,20020109
2002,SEA,28,20,21,37,0,0,0,106,MIN,29,25,23,34,0,0,0,111,20020109
2002,ORL,27,22,24,29,0,0,0,102,PHI,24,19,24,24,0,0,0,91,20020109
2002,NYK,22,22,23,22,0,0,0,89,DAL,29,30,28,24,0,0,0,111,20020110
2002,CLE,28,20,25,18,0,0,0,91,DEN,26,26,20,24,0,0,0,96,20020110
2002,POR,21,23,21,27,0,0,0,92,MIA,34,21,16,14,0,0,0,85,20020110
2002,LAC,23,29,20,17,0,0,0,89,NJN,28,30,27,23,0,0,0,108,20020110
2002,MEM,29,26,23,24,0,0,0,102,PHO,22,26,28,20,0,0,0,96,20020110
2002,HOU,27,22,9,21,0,0,0,79,UTA,28,17,21,17,0,0,0,83,20020110
2002,DET,19,19,19,33,0,0,0,90,BOS,24,28,32,20,0,0,0,104,20020111
2002,LAC,23,21,18,20,9,0,0,91,CHH,15,19,17,31,10,0,0,92,20020111
2002,CHI,23,17,25,25,0,0,0,90,IND,23,27,24,23,0,0,0,97,20020111
2002,WAS,19,23,15,29,0,0,0,86,MIL,28,32,20,25,0,0,0,105,20020111
2002,LAL,25,30,25,22,0,0,0,102,MIN,31,32,25,32,0,0,0,120,20020111
2002,POR,27,27,17,21,0,0,0,92,ORL,24,25,15,20,0,0,0,84,20020111
2002,SAS,16,23,24,21,0,0,0,84,PHI,21,28,23,29,0,0,0,101,20020111
2002,CLE,21,28,27,24,0,0,0,100,SEA,34,23,25,20,0,0,0,102,20020111
2002,ATL,22,24,15,22,8,0,0,91,TOR,23,19,28,13,11,0,0,94,20020111
2002,BOS,33,22,26,34,0,0,0,115,ATL,27,16,23,25,0,0,0,91,20020112
2002,LAL,32,19,17,26,10,0,0,104,CHI,21,31,18,24,12,0,0,106,20020112
2002,IND,27,25,27,23,0,0,0,102,DAL,30,17,25,39,0,0,0,111,20020112
2002,CHH,20,21,19,16,0,0,0,76,DET,25,27,21,31,0,0,0,104,20020112
2002,DEN,18,18,27,23,0,0,0,86,HOU,19,28,28,23,0,0,0,98,20020112
2002,MIL,26,23,25,28,0,0,0,102,NYK,12,22,30,33,0,0,0,97,20020112
2002,NJN,22,25,22,22,0,0,0,91,ORL,17,25,22,21,0,0,0,85,20020112
2002,MIA,18,10,23,23,0,0,0,74,PHO,29,18,32,29,0,0,0,108,20020112
2002,MEM,23,24,16,20,8,6,0,97,UTA,18,21,23,21,8,4,0,95,20020112
2002,MIN,33,28,18,29,0,0,0,108,WAS,26,26,22,26,0,0,0,100,20020112
2002,CLE,16,20,11,17,0,0,0,64,POR,23,19,31,23,0,0,0,96,20020113
2002,PHO,23,21,24,32,0,0,0,100,SAC,23,25,30,25,0,0,0,103,20020113
2002,LAC,19,24,24,12,0,0,0,79,TOR,29,15,17,11,0,0,0,72,20020113
2002,MIA,17,18,19,31,0,0,0,85,GSW,18,19,19,23,0,0,0,79,20020114
2002,MEM,27,18,14,22,0,0,0,81,LAL,32,31,35,22,0,0,0,120,20020114
2002,SAS,24,22,24,27,0,0,0,97,NJN,23,32,21,23,0,0,0,99,20020114
2002,DAL,23,31,9,24,0,0,0,87,ORL,25,36,33,19,0,0,0,113,20020114
2002,DEN,22,22,26,27,0,0,0,97,UTA,26,30,22,28,0,0,0,106,20020114
2002,DAL,32,23,39,22,0,0,0,116,ATL,23,34,26,24,0,0,0,107,20020115
2002,CHH,27,22,24,21,0,0,0,94,CHI,22,24,23,17,0,0,0,86,20020115
2002,TOR,25,29,21,17,0,0,0,92,DET,25,19,33,13,0,0,0,90,20020115
2002,MIL,27,32,26,21,0,0,0,106,IND,34,10,31,27,0,0,0,102,20020115
2002,LAC,26,14,22,21,0,0,0,83,MIN,25,35,18,19,0,0,0,97,20020115
2002,HOU,19,32,32,16,7,0,0,106,PHI,24,22,29,24,13,0,0,112,20020115
2002,CLE,23,29,23,27,0,0,0,102,SAC,30,17,27,35,0,0,0,109,20020115
2002,SAS,28,20,24,24,0,0,0,96,WAS,13,22,26,30,0,0,0,91,20020115
2002,NYK,25,22,24,29,0,0,0,100,BOS,27,17,27,30,0,0,0,101,20020116
2002,SAC,25,30,28,29,0,0,0,112,DEN,30,24,32,21,0,0,0,107,20020116
2002,CLE,19,20,27,22,0,0,0,88,GSW,29,25,32,31,0,0,0,117,20020116
2002,MIA,39,21,20,22,0,0,0,102,LAL,22,26,30,18,0,0,0,96,20020116
2002,IND,25,22,28,25,0,0,0,100,MIL,24,29,26,26,0,0,0,105,20020116
2002,WAS,18,15,16,18,0,0,0,67,NJN,43,29,16,23,0,0,0,111,20020116
2002,POR,24,23,28,33,0,0,0,108,PHO,23,19,26,31,0,0,0,99,20020116
2002,HOU,28,16,24,35,0,0,0,103,TOR,28,27,25,29,0,0,0,109,20020116
2002,SEA,20,19,21,20,0,0,0,80,UTA,24,15,31,25,0,0,0,95,20020116
2002,CHI,21,23,24,26,0,0,0,94,ATL,25,22,18,26,0,0,0,91,20020117
2002,PHI,24,30,20,19,0,0,0,93,CHH,31,21,19,17,0,0,0,88,20020117
2002,DAL,29,26,27,26,0,0,0,108,MEM,27,22,19,29,0,0,0,97,20020117
2002,MIA,13,24,21,28,6,0,0,92,POR,20,27,18,21,4,0,0,90,20020117
2002,UTA,31,21,21,25,0,0,0,98,SAS,27,21,25,29,0,0,0,102,20020117
2002,HOU,25,25,29,25,0,0,0,104,BOS,22,22,26,31,0,0,0,101,20020118
2002,SEA,25,21,15,29,0,0,0,90,DEN,19,14,36,27,0,0,0,96,20020118
2002,DET,21,32,18,25,0,0,0,96,IND,18,17,31,27,0,0,0,93,20020118
2002,CLE,26,20,23,34,0,0,0,103,LAC,27,20,26,36,0,0,0,109,20020118
2002,ORL,27,28,28,27,0,0,0,110,MIL,27,23,23,42,0,0,0,115,20020118
2002,MIN,27,21,20,25,7,0,0,100,PHO,25,32,18,18,10,0,0,103,20020118
2002,GSW,26,27,29,15,0,0,0,97,SAC,32,35,26,28,0,0,0,121,20020118
2002,NJN,24,12,25,16,0,0,0,77,TOR,20,23,23,23,0,0,0,89,20020118
2002,MIL,25,32,25,34,0,0,0,116,ATL,40,20,21,26,0,0,0,107,20020119
2002,TOR,23,28,25,15,0,0,0,91,CHH,20,20,32,17,0,0,0,89,20020119
2002,WAS,16,19,20,22,0,0,0,77,CHI,12,15,11,31,0,0,0,69,20020119
2002,UTA,16,28,23,36,0,0,0,103,DAL,32,26,23,25,0,0,0,106,20020119
2002,BOS,33,24,25,9,0,0,0,91,DET,22,28,17,27,0,0,0,94,20020119
2002,MIN,25,26,26,28,0,0,0,105,GSW,27,24,24,27,0,0,0,102,20020119
2002,ORL,41,28,27,23,0,0,0,119,MEM,17,27,35,24,0,0,0,103,20020119
2002,IND,28,20,21,19,0,0,0,88,MIA,34,25,23,18,0,0,0,100,20020119
2002,HOU,24,28,20,18,0,0,0,90,NJN,27,20,30,22,0,0,0,99,20020119
2002,NYK,27,19,14,29,0,0,0,89,PHI,20,25,27,25,0,0,0,97,20020119
2002,LAC,20,22,25,26,0,0,0,93,POR,29,29,34,21,0,0,0,113,20020119
2002,LAL,22,27,20,29,0,0,0,98,SAS,24,21,18,18,0,0,0,81,20020119
2002,DEN,22,23,12,20,0,0,0,77,SEA,27,25,32,20,0,0,0,104,20020119
2002,HOU,22,23,20,26,0,0,0,91,ATL,18,21,28,28,0,0,0,95,20020121
2002,TOR,26,18,27,26,0,0,0,97,BOS,28,24,23,31,0,0,0,106,20020121
2002,IND,23,27,19,24,0,0,0,93,CHI,21,23,17,20,0,0,0,81,20020121
2002,MIA,30,22,16,19,8,0,0,95,CLE,21,20,23,23,6,0,0,93,20020121
2002,NJN,17,32,32,24,0,0,0,105,DAL,30,26,24,33,0,0,0,113,20020121
2002,MIL,34,21,14,28,0,0,0,97,DET,15,22,23,19,0,0,0,79,20020121
2002,UTA,21,29,21,30,0,0,0,101,GSW,23,31,14,31,0,0,0,99,20020121
2002,DEN,21,31,19,18,0,0,0,89,LAC,37,22,16,27,0,0,0,102,20020121
2002,WAS,26,27,26,22,0,0,0,101,MIN,28,28,27,22,0,0,0,105,20020121
2002,CHH,39,21,32,19,0,0,0,111,NYK,19,14,18,17,0,0,0,68,20020121
2002,SEA,26,23,36,24,0,0,0,109,PHI,20,25,20,33,0,0,0,98,20020121
2002,MEM,30,25,19,24,0,0,0,98,SAC,31,28,32,21,0,0,0,112,20020121
2002,DAL,34,32,18,29,0,0,0,113,HOU,34,20,23,30,0,0,0,107,20020122
2002,DEN,25,26,26,30,0,0,0,107,LAL,25,25,23,18,0,0,0,91,20020122
2002,CHI,24,17,21,17,0,0,0,79,MIA,20,22,21,29,0,0,0,92,20020122
2002,PHO,26,29,14,23,0,0,0,92,MIL,20,16,20,25,0,0,0,81,20020122
2002,ATL,24,17,20,25,0,0,0,86,ORL,19,28,28,25,0,0,0,100,20020122
2002,SAC,27,26,25,22,10,0,0,110,POR,28,26,26,20,16,0,0,116,20020122
2002,NJN,20,19,32,21,0,0,0,92,SAS,22,21,21,22,0,0,0,86,20020122
2002,PHI,19,26,26,20,0,0,0,91,WAS,23,23,16,22,0,0,0,84,20020122
2002,IND,19,25,30,20,0,0,0,94,BOS,24,21,33,20,0,0,0,98,20020123
2002,SEA,28,18,25,30,0,0,0,101,CHH,30,41,14,26,0,0,0,111,20020123
2002,MIN,22,17,18,26,0,0,0,83,DET,24,30,27,23,0,0,0,104,20020123
2002,MEM,29,27,19,20,0,0,0,95,GSW,32,26,19,30,0,0,0,107,20020123
2002,LAL,25,24,21,20,0,0,0,90,LAC,19,16,35,25,0,0,0,95,20020123
2002,NYK,26,25,24,21,0,0,0,96,TOR,21,25,24,22,0,0,0,92,20020123
2002,SAS,21,30,29,18,0,0,0,98,UTA,28,17,21,26,0,0,0,92,20020123
2002,DAL,24,26,25,29,0,0,0,104,DEN,32,18,18,29,0,0,0,97,20020124
2002,NJN,33,22,28,20,0,0,0,103,HOU,27,19,26,26,0,0,0,98,20020124
2002,SEA,22,30,25,22,0,0,0,99,MIL,30,24,20,14,0,0,0,88,20020124
2002,PHO,31,27,20,13,0,0,0,91,NYK,22,18,32,24,0,0,0,96,20020124
2002,MIA,29,22,17,19,0,0,0,87,ORL,25,19,24,24,0,0,0,92,20020124
2002,MEM,16,11,23,32,0,0,0,82,POR,27,31,37,25,0,0,0,120,20020124
2002,UTA,21,14,24,21,0,0,0,80,SAC,26,28,32,27,0,0,0,113,20020124
2002,CLE,28,22,17,18,0,0,0,85,WAS,23,25,29,17,0,0,0,94,20020124
2002,DET,23,32,26,26,0,0,0,107,ATL,15,23,22,30,0,0,0,90,20020125
2002,PHI,33,30,20,23,0,0,0,106,BOS,24,24,25,17,0,0,0,90,20020125
2002,CHH,18,24,17,22,0,0,0,81,IND,29,24,15,22,0,0,0,90,20020125
2002,SAS,19,22,24,26,0,0,0,91,LAL,28,25,20,21,0,0,0,94,20020125
2002,MIN,21,22,24,33,0,0,0,100,TOR,30,31,26,20,0,0,0,107,20020125
2002,HOU,23,27,27,19,15,0,0,111,CHH,26,21,30,19,8,0,0,104,20020126
2002,MEM,28,30,21,13,0,0,0,92,CHI,25,27,17,26,0,0,0,95,20020126
2002,BOS,25,27,26,30,0,0,0,108,CLE,24,22,33,22,0,0,0,101,20020126
2002,SAS,22,22,24,22,0,0,0,90,GSW,12,25,18,27,0,0,0,82,20020126
2002,SEA,29,18,21,27,0,0,0,95,IND,25,26,20,15,0,0,0,86,20020126
2002,DAL,34,36,27,36,0,0,0,133,LAC,31,27,37,17,0,0,0,112,20020126
2002,NJN,16,18,23,20,0,0,0,77,MIA,29,15,26,20,0,0,0,90,20020126
2002,NYK,30,27,21,29,10,12,0,129,MIL,28,23,24,32,10,10,0,127,20020126
2002,ATL,25,16,17,22,0,0,0,80,MIN,25,23,33,22,0,0,0,103,20020126
2002,SAC,23,34,31,26,0,0,0,114,UTA,28,19,21,22,0,0,0,90,20020126
2002,PHO,16,21,22,43,0,0,0,102,WAS,22,27,26,37,0,0,0,112,20020126
2002,LAL,22,23,22,20,0,0,0,87,PHI,24,18,21,30,0,0,0,93,20020127
2002,ORL,16,30,21,30,0,0,0,97,TOR,34,27,20,25,0,0,0,106,20020127
2002,LAC,25,27,23,25,15,0,0,115,MEM,20,20,36,24,19,0,0,119,20020128
2002,MIA,23,23,23,20,0,0,0,89,UTA,31,27,20,23,0,0,0,101,20020128
2002,LAL,32,36,34,25,0,0,0,127,ATL,20,21,28,24,0,0,0,93,20020129
2002,MIN,21,19,18,23,0,0,0,81,CLE,21,27,37,29,0,0,0,114,20020129
2002,LAC,22,27,33,35,0,0,0,117,DAL,22,30,29,19,0,0,0,100,20020129
2002,MIA,25,25,15,24,11,0,0,100,DEN,23,16,29,21,5,0,0,94,20020129
2002,GSW,23,24,20,19,10,0,0,96,HOU,27,19,14,26,14,0,0,100,20020129
2002,BOS,25,24,17,24,0,0,0,90,MIL,30,21,35,23,0,0,0,109,20020129
2002,PHI,22,16,19,14,0,0,0,71,NYK,21,19,19,19,0,0,0,78,20020129
2002,CHI,23,32,13,22,0,0,0,90,PHO,27,26,23,15,0,0,0,91,20020129
2002,CHH,23,21,21,13,0,0,0,78,SAS,28,15,20,10,0,0,0,73,20020129
2002,POR,24,20,24,24,0,0,0,92,SEA,27,27,15,17,0,0,0,86,20020129
2002,DET,22,27,27,13,0,0,0,89,WAS,26,23,19,18,0,0,0,86,20020129
2002,ATL,19,22,11,19,0,0,0,71,DET,28,19,13,28,0,0,0,88,20020130
2002,MEM,17,22,27,16,0,0,0,82,IND,25,16,13,29,0,0,0,83,20020130
2002,LAL,21,26,28,36,0,0,0,111,ORL,25,26,26,16,0,0,0,93,20020130
2002,MIN,25,18,27,21,0,0,0,91,PHI,18,34,17,27,0,0,0,96,20020130
2002,CHI,18,24,15,21,0,0,0,78,UTA,24,24,21,21,0,0,0,90,20020130
2002,WAS,29,25,17,22,0,0,0,93,CLE,23,19,32,18,0,0,0,92,20020131
2002,HOU,17,16,30,28,0,0,0,91,DAL,25,21,17,32,0,0,0,95,20020131
2002,MIL,26,28,32,14,0,0,0,100,NJN,43,14,36,32,0,0,0,125,20020131
2002,PHO,24,21,22,30,0,0,0,97,POR,39,23,19,24,0,0,0,105,20020131
2002,LAC,23,24,22,22,0,0,0,91,SAS,22,27,16,22,0,0,0,87,20020131
2002,SAC,29,27,20,23,0,0,0,99,SEA,32,27,17,19,0,0,0,95,20020131
2002,BOS,27,23,25,17,0,0,0,92,TOR,18,27,18,34,0,0,0,97,20020131
2002,MIN,24,14,23,24,13,0,0,98,BOS,21,22,23,19,10,0,0,95,20020201
2002,ORL,22,17,26,20,0,0,0,85,DET,24,23,16,20,0,0,0,83,20020201
2002,CHH,22,18,18,15,0,0,0,73,HOU,15,20,15,22,0,0,0,72,20020201
2002,NYK,20,20,30,17,0,0,0,87,IND,22,31,19,20,0,0,0,92,20020201
2002,LAL,19,24,25,32,0,0,0,100,MEM,21,23,25,16,0,0,0,85,20020201
2002,SAS,14,28,27,14,0,0,0,83,MIA,29,22,14,23,0,0,0,88,20020201
2002,GSW,20,24,21,33,0,0,0,98,PHO,30,26,21,27,0,0,0,104,20020201
2002,DEN,31,20,22,23,0,0,0,96,SAC,42,29,32,29,0,0,0,132,20020201
2002,ATL,20,24,21,25,0,0,0,90,WAS,29,25,22,21,0,0,0,97,20020201
2002,LAC,27,24,18,25,0,0,0,94,ATL,27,15,31,28,0,0,0,101,20020202
2002,DET,23,34,26,32,0,0,0,115,CLE,17,23,37,30,0,0,0,107,20020202
2002,PHI,22,21,14,29,0,0,0,86,MIL,25,19,21,16,0,0,0,81,20020202
2002,TOR,20,24,24,23,0,0,0,91,NJN,28,24,24,22,0,0,0,98,20020202
2002,CHI,18,26,12,41,0,0,0,97,SEA,22,20,27,22,0,0,0,91,20020202
2002,POR,26,29,13,28,0,0,0,96,UTA,22,27,24,24,0,0,0,97,20020202
2002,LAC,27,23,28,13,0,0,0,91,BOS,25,29,27,23,0,0,0,104,20020203
2002,LAL,30,27,19,25,0,0,0,101,DAL,30,22,20,22,0,0,0,94,20020203
2002,PHO,20,25,32,21,0,0,0,98,GSW,37,24,18,18,0,0,0,97,20020203
2002,CHH,25,22,28,22,0,0,0,97,MEM,18,25,22,14,0,0,0,79,20020203
2002,SAC,23,27,35,27,0,0,0,112,MIN,32,16,27,32,0,0,0,107,20020203
2002,MIA,23,17,29,25,0,0,0,94,NYK,24,20,19,20,0,0,0,83,20020203
2002,SAS,21,23,22,24,15,0,0,105,ORL,22,18,27,23,8,0,0,98,20020203
2002,CHI,28,15,28,25,0,0,0,96,POR,25,29,28,19,0,0,0,101,20020203
2002,IND,25,18,24,22,0,0,0,89,WAS,31,18,32,28,0,0,0,109,20020203
2002,UTA,21,24,28,24,0,0,0,97,HOU,32,23,22,27,0,0,0,104,20020204
2002,SAC,26,28,16,13,0,0,0,83,NJN,26,31,30,30,0,0,0,117,20020204
2002,TOR,33,19,32,16,0,0,0,100,PHI,33,15,23,22,0,0,0,93,20020204
2002,MIN,18,11,29,25,0,0,0,83,SAS,27,29,21,36,0,0,0,113,20020204
2002,BOS,26,19,17,20,0,0,0,82,CHH,18,20,24,17,0,0,0,79,20020205
2002,POR,20,28,31,17,0,0,0,96,DEN,26,24,28,19,0,0,0,97,20020205
2002,PHI,23,22,17,20,0,0,0,82,DET,20,19,25,22,0,0,0,86,20020205
2002,SEA,29,30,32,22,0,0,0,113,GSW,13,24,28,22,0,0,0,87,20020205
2002,DAL,36,31,18,35,11,10,0,141,IND,35,23,31,31,11,9,0,140,20020205
2002,UTA,21,11,18,29,0,0,0,79,MEM,32,19,21,14,0,0,0,86,20020205
2002,ATL,18,21,14,23,0,0,0,76,MIA,18,19,15,21,0,0,0,73,20020205
2002,LAC,25,24,27,36,0,0,0,112,NYK,35,25,22,28,0,0,0,110,20020205
2002,CLE,26,18,26,28,0,0,0,98,ORL,33,21,24,28,0,0,0,106,20020205
2002,TOR,21,30,24,19,0,0,0,94,WAS,25,21,29,24,0,0,0,99,20020205
2002,SAC,23,37,30,12,0,0,0,102,BOS,23,27,15,20,0,0,0,85,20020206
2002,HOU,24,22,28,35,0,0,0,109,CLE,28,22,30,31,0,0,0,111,20020206
2002,CHI,21,22,23,31,0,0,0,97,LAL,17,23,24,25,0,0,0,89,20020206
2002,POR,16,31,27,29,0,0,0,103,MIN,33,29,23,28,0,0,0,113,20020206
2002,DAL,34,30,20,28,0,0,0,112,NJN,27,25,34,14,0,0,0,100,20020206
2002,PHO,21,31,13,14,0,0,0,79,SEA,25,18,20,27,0,0,0,90,20020206
2002,PHI,29,18,28,25,0,0,0,100,CHH,22,28,25,18,0,0,0,93,20020207
2002,LAC,17,33,22,20,0,0,0,92,DET,24,25,22,34,0,0,0,105,20020207
2002,MEM,29,21,24,29,0,0,0,103,MIL,19,42,21,25,0,0,0,107,20020207
2002,ATL,17,27,24,21,0,0,0,89,NYK,31,18,22,21,0,0,0,92,20020207
2002,SAS,20,19,9,19,7,0,0,74,TOR,20,13,17,17,13,0,0,80,20020207
2002,SAC,22,26,24,29,0,0,0,101,WAS,35,20,34,19,0,0,0,108,20020207
2002,NJN,28,29,25,21,0,0,0,103,ATL,37,19,22,27,0,0,0,105,20020212
2002,MIL,23,23,33,13,0,0,0,92,CHI,24,21,25,26,0,0,0,96,20020212
2002,TOR,25,16,20,20,0,0,0,81,CLE,23,31,24,21,0,0,0,99,20020212
2002,BOS,34,19,24,33,0,0,0,110,DEN,27,25,17,24,0,0,0,93,20020212
2002,PHO,21,25,28,25,0,0,0,99,DET,17,14,21,19,0,0,0,71,20020212
2002,MEM,22,24,15,17,0,0,0,78,HOU,24,20,15,26,0,0,0,85,20020212
2002,UTA,22,26,24,26,0,0,0,98,IND,13,23,24,22,0,0,0,82,20020212
2002,WAS,25,23,26,20,0,0,0,94,LAL,16,19,42,26,0,0,0,103,20020212
2002,NYK,26,33,26,29,0,0,0,114,ORL,33,27,38,24,0,0,0,122,20020212
2002,SAS,21,16,21,28,0,0,0,86,SAC,20,32,23,24,0,0,0,99,20020212
2002,DAL,39,22,25,26,0,0,0,112,SEA,35,28,21,22,0,0,0,106,20020212
2002,CHI,28,15,17,31,0,0,0,91,CHH,32,29,32,20,0,0,0,113,20020213
2002,BOS,25,22,17,11,0,0,0,75,GSW,30,20,21,21,0,0,0,92,20020213
2002,ORL,26,17,29,23,0,0,0,95,MIA,31,25,24,32,0,0,0,112,20020213
2002,CLE,30,22,34,29,0,0,0,115,MIL,21,27,27,32,0,0,0,107,20020213
2002,PHO,20,25,22,25,0,0,0,92,MIN,25,29,20,33,0,0,0,107,20020213
2002,TOR,24,11,20,27,0,0,0,82,NYK,21,27,23,18,0,0,0,89,20020213
2002,DAL,26,25,31,21,0,0,0,103,POR,32,28,27,27,0,0,0,114,20020213
2002,SAS,20,19,30,20,0,0,0,89,LAC,25,15,17,19,0,0,0,76,20020214
2002,DEN,24,23,24,29,0,0,0,100,MEM,25,19,26,15,0,0,0,85,20020214
2002,DET,16,30,15,24,0,0,0,85,NJN,23,16,24,17,0,0,0,80,20020214
2002,UTA,20,26,28,24,0,0,0,98,PHI,20,22,20,29,0,0,0,91,20020214
2002,WAS,18,18,23,34,0,0,0,93,SAC,21,26,36,26,0,0,0,109,20020214
2002,LAL,22,19,18,33,0,0,0,92,SEA,23,18,25,21,0,0,0,87,20020214
2002,IND,23,29,26,28,0,0,0,106,CHH,32,24,30,30,0,0,0,116,20020215
2002,NJN,22,18,36,30,0,0,0,106,CHI,13,11,34,23,0,0,0,81,20020215
2002,SAS,28,26,23,31,0,0,0,108,GSW,34,25,23,17,0,0,0,99,20020215
2002,ATL,20,26,24,23,0,0,0,93,LAL,13,22,20,35,0,0,0,90,20020215
2002,MIA,19,28,19,16,8,0,0,90,MIL,32,12,18,20,6,0,0,88,20020215
2002,DEN,25,19,34,21,0,0,0,99,MIN,28,27,26,17,0,0,0,98,20020215
2002,DET,18,29,30,24,0,0,0,101,NYK,30,21,17,22,0,0,0,90,20020215
2002,WAS,29,24,19,25,0,0,0,97,PHO,28,26,14,28,0,0,0,96,20020215
2002,BOS,28,18,21,40,0,0,0,107,POR,22,28,19,35,0,0,0,104,20020215
2002,UTA,21,22,21,30,0,0,0,94,TOR,24,20,16,25,0,0,0,85,20020215
2002,CLE,30,20,27,37,0,0,0,114,CHI,24,25,27,25,0,0,0,101,20020216
2002,ORL,42,25,21,21,0,0,0,109,HOU,25,23,29,23,0,0,0,100,20020216
2002,DAL,32,24,25,29,0,0,0,110,LAC,29,39,24,27,0,0,0,119,20020216
2002,BOS,23,24,17,15,0,0,0,79,SEA,25,30,17,27,0,0,0,99,20020216
2002,MEM,23,23,14,32,0,0,0,92,CHH,12,28,25,13,0,0,0,78,20020217
2002,ATL,24,25,27,24,0,0,0,100,GSW,20,14,19,41,0,0,0,94,20020217
2002,PHI,20,16,26,14,0,0,0,76,IND,21,19,24,22,0,0,0,86,20020217
2002,MIA,17,19,17,27,0,0,0,80,MIN,26,24,22,21,0,0,0,93,20020217
2002,DEN,16,25,16,20,0,0,0,77,NJN,22,29,27,20,0,0,0,98,20020217
2002,UTA,25,20,21,26,0,0,0,92,NYK,25,26,22,16,0,0,0,89,20020217
2002,DAL,18,35,26,26,0,0,0,105,PHO,27,11,28,26,0,0,0,92,20020217
2002,LAL,29,27,22,27,0,0,0,105,POR,26,28,26,31,0,0,0,111,20020217
2002,SEA,26,47,25,28,0,0,0,126,SAC,23,27,32,34,0,0,0,116,20020217
2002,MIL,26,19,17,29,0,0,0,91,TOR,27,19,23,17,0,0,0,86,20020217
2002,UTA,22,28,25,28,0,0,0,103,CLE,13,22,36,21,0,0,0,92,20020218
2002,TOR,17,22,17,20,0,0,0,76,DET,23,27,22,17,0,0,0,89,20020218
2002,POR,22,20,20,18,0,0,0,80,LAC,21,16,12,30,0,0,0,79,20020218
2002,CHI,24,16,15,25,0,0,0,80,MIA,23,22,23,34,0,0,0,102,20020218
2002,CHH,27,29,18,27,0,0,0,101,MIL,27,19,24,22,0,0,0,92,20020218
2002,DEN,14,23,17,29,0,0,0,83,PHI,24,31,31,24,0,0,0,110,20020218
2002,HOU,20,28,30,24,0,0,0,102,WAS,20,29,21,19,0,0,0,89,20020218
2002,MIN,24,22,36,35,0,0,0,117,DAL,30,26,20,24,0,0,0,100,20020219
2002,BOS,22,26,29,32,0,0,0,109,LAL,34,29,26,19,0,0,0,108,20020219
2002,GSW,24,27,34,30,0,0,0,115,NJN,42,33,22,26,0,0,0,123,20020219
2002,SEA,30,24,24,25,0,0,0,103,PHO,25,31,18,17,0,0,0,91,20020219
2002,ATL,22,19,25,13,0,0,0,79,SAC,30,20,19,30,0,0,0,99,20020219
2002,MEM,25,16,30,16,6,0,0,93,SAS,27,27,17,16,12,0,0,99,20020219
2002,NYK,34,17,32,26,0,0,0,109,CHI,21,22,32,38,0,0,0,113,20020220
2002,UTA,32,24,24,30,0,0,0,110,DEN,24,25,16,34,0,0,0,99,20020220
2002,WAS,18,29,19,24,0,0,0,90,DET,25,25,16,31,0,0,0,97,20020220
2002,LAC,19,24,25,13,0,0,0,81,MIA,25,11,26,9,0,0,0,71,20020220
2002,HOU,20,21,16,19,0,0,0,76,MIL,30,24,26,35,0,0,0,115,20020220
2002,GSW,26,28,25,28,0,0,0,107,PHI,24,26,36,28,0,0,0,114,20020220
2002,POR,20,24,20,26,0,0,0,90,SEA,21,23,21,19,0,0,0,84,20020220
2002,CHH,22,18,22,16,0,0,0,78,TOR,16,20,21,20,0,0,0,77,20020220
2002,LAL,26,27,30,21,0,0,0,104,CLE,20,24,34,19,0,0,0,97,20020221
2002,BOS,30,30,18,14,0,0,0,92,DAL,28,20,23,27,0,0,0,98,20020221
2002,MIN,19,22,17,25,0,0,0,83,HOU,25,24,16,24,0,0,0,89,20020221
2002,PHO,15,27,19,17,0,0,0,78,MEM,25,18,23,6,0,0,0,72,20020221
2002,LAC,27,19,23,33,0,0,0,102,ORL,34,24,32,29,0,0,0,119,20020221
2002,ATL,14,18,26,21,0,0,0,79,POR,24,27,26,17,0,0,0,94,20020221
2002,SAC,25,20,17,30,0,0,0,92,SAS,40,28,30,17,0,0,0,115,20020221
2002,NJN,23,23,23,24,0,0,0,93,WAS,22,17,24,19,0,0,0,82,20020221
2002,LAL,23,19,25,29,0,0,0,96,CHH,22,24,23,25,0,0,0,94,20020222
2002,PHO,25,15,19,24,0,0,0,83,CHI,17,30,18,26,0,0,0,91,20020222
2002,CLE,21,32,26,24,0,0,0,103,IND,27,20,25,21,0,0,0,93,20020222
2002,GSW,34,29,28,21,0,0,0,112,MIL,30,25,30,31,0,0,0,116,20020222
2002,NYK,20,32,20,21,0,0,0,93,NJN,34,31,25,25,0,0,0,115,20020222
2002,ATL,26,23,31,16,0,0,0,96,SEA,21,25,30,23,0,0,0,99,20020222
2002,DET,24,20,13,23,0,0,0,80,TOR,12,24,18,18,0,0,0,72,20020222
2002,GSW,27,21,19,24,0,0,0,91,CHI,29,30,22,24,0,0,0,105,20020223
2002,SAC,25,27,15,30,0,0,0,97,DAL,24,24,29,34,0,0,0,111,20020223
2002,BOS,34,17,13,25,0,0,0,89,HOU,16,31,24,28,0,0,0,99,20020223
2002,LAC,21,21,30,16,0,0,0,88,IND,23,37,27,19,0,0,0,106,20020223
2002,PHI,20,20,20,27,0,0,0,87,ORL,28,28,26,23,0,0,0,105,20020223
2002,DEN,27,19,17,27,0,0,0,90,POR,21,26,33,21,0,0,0,101,20020223
2002,MIN,28,19,27,38,0,0,0,112,SAS,23,33,15,17,0,0,0,88,20020223
2002,MIA,20,26,23,28,0,0,0,97,WAS,26,24,22,23,0,0,0,95,20020223
2002,ORL,27,28,19,22,0,0,0,96,CLE,33,18,33,27,0,0,0,111,20020224
2002,ATL,29,20,17,23,0,0,0,89,DEN,20,23,23,18,0,0,0,84,20020224
2002,WAS,25,26,16,13,0,0,0,80,MIA,21,25,19,27,0,0,0,92,20020224
2002,DET,19,19,25,19,0,0,0,82,MIL,24,23,24,18,0,0,0,89,20020224
2002,CHH,28,31,23,11,0,0,0,93,NJN,18,23,27,27,0,0,0,95,20020224
2002,LAL,32,24,26,25,0,0,0,107,NYK,18,24,28,21,0,0,0,91,20020224
2002,SAS,15,22,20,26,0,0,0,83,PHO,32,15,22,23,0,0,0,92,20020224
2002,SEA,19,21,34,27,0,0,0,101,TOR,30,21,26,15,0,0,0,92,20020224
2002,MIN,23,18,27,29,0,0,0,97,CHH,22,22,25,23,0,0,0,92,20020225
2002,IND,25,20,17,21,19,0,0,102,GSW,26,28,19,10,14,0,0,97,20020225
2002,LAC,26,20,22,22,0,0,0,90,MEM,12,17,33,15,0,0,0,77,20020225
2002,POR,21,24,17,26,0,0,0,88,PHI,26,17,26,14,0,0,0,83,20020225
2002,ORL,38,26,26,22,0,0,0,112,CHI,28,23,17,29,0,0,0,97,20020226
2002,SEA,32,30,24,23,0,0,0,109,CLE,30,26,17,16,0,0,0,89,20020226
2002,MEM,21,22,25,23,0,0,0,91,DAL,34,24,26,20,0,0,0,104,20020226
2002,LAC,29,21,20,24,0,0,0,94,HOU,23,27,21,13,0,0,0,84,20020226
2002,LAL,25,32,17,25,0,0,0,99,MIL,28,18,22,21,0,0,0,89,20020226
2002,UTA,18,21,22,20,0,0,0,81,SAC,32,25,29,21,0,0,0,107,20020226
2002,PHO,19,25,23,24,0,0,0,91,SAS,26,21,25,27,0,0,0,99,20020226
2002,SEA,20,29,24,25,0,0,0,98,ATL,31,14,16,20,0,0,0,81,20020227
2002,MIL,26,20,23,26,0,0,0,95,BOS,27,22,20,23,0,0,0,92,20020227
2002,NJN,18,17,22,28,0,0,0,85,CHH,27,26,24,27,0,0,0,104,20020227
2002,CHI,25,23,18,23,0,0,0,89,DET,26,29,25,21,0,0,0,101,20020227
2002,DEN,23,32,21,17,0,0,0,93,GSW,34,32,20,24,0,0,0,110,20020227
2002,LAL,22,25,29,25,0,0,0,101,MIN,30,30,27,25,0,0,0,112,20020227
2002,MIA,14,20,19,19,0,0,0,72,PHI,24,22,17,19,0,0,0,82,20020227
2002,ORL,27,19,24,20,0,0,0,90,TOR,20,27,26,12,0,0,0,85,20020227
2002,POR,32,32,19,22,0,0,0,105,WAS,33,28,22,18,0,0,0,101,20020227
2002,SAS,28,23,25,25,6,0,0,107,CLE,30,22,25,24,13,0,0,114,20020228
2002,NYK,30,19,25,12,0,0,0,86,MIA,22,25,20,33,0,0,0,100,20020228
2002,IND,32,18,23,21,6,0,0,100,PHO,24,30,18,22,13,0,0,107,20020228
2002,MEM,20,15,18,17,0,0,0,70,UTA,33,18,29,34,0,0,0,114,20020228
2002,CHH,24,30,30,16,0,0,0,100,BOS,14,25,22,26,0,0,0,87,20020301
2002,WAS,16,21,21,23,0,0,0,81,CHI,23,23,19,25,0,0,0,90,20020301
2002,MEM,25,24,11,23,0,0,0,83,DEN,27,22,31,16,0,0,0,96,20020301
2002,ORL,31,20,22,29,0,0,0,102,DET,23,25,28,34,0,0,0,110,20020301
2002,SAC,28,31,30,27,0,0,0,116,GSW,18,35,22,33,0,0,0,108,20020301
2002,IND,16,25,26,17,0,0,0,84,LAL,26,23,20,27,0,0,0,96,20020301
2002,SAS,22,22,21,20,0,0,0,85,MIN,19,16,25,17,0,0,0,77,20020301
2002,SEA,25,20,19,23,0,0,0,87,NYK,19,20,22,28,0,0,0,89,20020301
2002,NJN,12,31,26,33,0,0,0,102,PHI,31,27,27,25,0,0,0,110,20020301
2002,POR,19,30,22,20,0,0,0,91,TOR,20,26,20,15,0,0,0,81,20020301
2002,CLE,33,13,20,15,0,0,0,81,ATL,18,23,22,21,0,0,0,84,20020302
2002,MIA,28,27,29,25,0,0,0,109,DAL,25,23,15,32,0,0,0,95,20020302
2002,GSW,26,22,26,21,0,0,0,95,LAC,30,24,23,32,0,0,0,109,20020302
2002,POR,25,30,23,16,10,0,0,104,MIL,26,33,21,14,9,0,0,103,20020302
2002,HOU,25,24,26,29,0,0,0,104,PHO,26,23,26,22,0,0,0,97,20020302
2002,MIN,25,26,29,36,0,0,0,116,UTA,24,21,34,26,0,0,0,105,20020302
2002,DET,20,33,18,12,0,0,0,83,CHH,20,22,19,20,0,0,0,81,20020303
2002,MIL,23,30,27,21,0,0,0,101,CLE,27,22,15,27,0,0,0,91,20020303
2002,DAL,33,23,27,19,14,0,0,116,DEN,25,31,22,24,8,0,0,110,20020303
2002,HOU,19,19,20,21,0,0,0,79,LAL,18,28,25,24,0,0,0,95,20020303
2002,SEA,25,26,23,22,0,0,0,96,MEM,20,20,12,19,0,0,0,71,20020303
2002,CHI,17,22,14,31,0,0,0,84,NJN,25,22,19,26,0,0,0,92,20020303
2002,SAS,21,27,30,21,0,0,0,99,NYK,18,19,25,21,0,0,0,83,20020303
2002,IND,23,27,16,31,0,0,0,97,SAC,22,26,21,17,0,0,0,86,20020303
2002,PHI,24,27,22,23,0,0,0,96,TOR,15,25,25,19,0,0,0,84,20020303
2002,ORL,18,21,34,22,7,0,0,102,WAS,23,26,25,21,12,0,0,107,20020303
2002,MEM,18,22,15,21,0,0,0,76,ATL,29,19,25,22,0,0,0,95,20020304
2002,BOS,20,28,24,28,0,0,0,100,PHI,19,22,28,25,0,0,0,94,20020304
2002,SAC,21,24,24,26,0,0,0,95,POR,31,20,32,24,0,0,0,107,20020304
2002,DEN,15,21,21,25,0,0,0,82,UTA,24,21,23,32,0,0,0,100,20020304
2002,ATL,18,19,34,25,0,0,0,96,CLE,22,25,29,27,0,0,0,103,20020305
2002,PHO,23,21,14,19,0,0,0,77,DAL,17,23,23,18,0,0,0,81,20020305
2002,MIA,23,26,31,13,0,0,0,93,DET,28,27,16,20,0,0,0,91,20020305
2002,TOR,31,31,21,26,0,0,0,109,HOU,26,21,35,30,0,0,0,112,20020305
2002,ORL,23,26,20,29,0,0,0,98,IND,26,30,26,29,0,0,0,111,20020305
2002,NJN,21,20,22,29,0,0,0,92,LAL,21,28,21,31,0,0,0,101,20020305
2002,MIL,29,16,27,17,0,0,0,89,NYK,26,26,30,20,0,0,0,102,20020305
2002,GSW,22,20,21,25,0,0,0,88,SAS,26,31,26,26,0,0,0,109,20020305
2002,MIN,23,28,17,15,0,0,0,83,SEA,35,10,24,28,0,0,0,97,20020305
2002,CHI,21,25,23,21,0,0,0,90,WAS,32,24,29,30,0,0,0,115,20020305
2002,ORL,25,29,28,28,0,0,0,110,BOS,39,25,40,26,0,0,0,130,20020306
2002,MIA,19,24,24,25,0,0,0,92,CHI,24,18,14,31,0,0,0,87,20020306
2002,LAC,22,24,23,17,0,0,0,86,MIL,17,24,25,26,0,0,0,92,20020306
2002,CLE,15,16,20,25,0,0,0,76,PHI,23,12,20,30,0,0,0,85,20020306
2002,NJN,25,26,25,11,0,0,0,87,PHO,22,26,21,20,0,0,0,89,20020306
2002,MIN,20,18,20,20,0,0,0,78,POR,18,24,14,29,0,0,0,85,20020306
2002,LAL,20,27,15,22,0,0,0,84,UTA,22,22,26,22,0,0,0,92,20020306
2002,TOR,24,30,23,26,0,0,0,103,DAL,33,22,33,34,0,0,0,122,20020307
2002,NYK,23,25,21,24,0,0,0,93,DEN,31,27,19,27,0,0,0,104,20020307
2002,IND,33,26,27,25,0,0,0,111,MEM,37,34,15,36,0,0,0,122,20020307
2002,HOU,17,21,30,29,0,0,0,97,SAS,32,19,23,25,0,0,0,99,20020307
2002,CHH,24,17,27,17,4,0,0,89,SEA,26,22,21,16,7,0,0,92,20020307
2002,DET,25,29,20,21,0,0,0,95,WAS,33,19,21,19,0,0,0,92,20020307
2002,DET,24,24,15,29,0,0,0,92,BOS,30,23,27,37,0,0,0,117,20020308
2002,LAC,22,20,26,26,0,0,0,94,CHI,22,22,24,22,0,0,0,90,20020308
2002,GSW,28,28,24,28,0,0,0,108,HOU,26,28,27,14,0,0,0,95,20020308
2002,TOR,24,20,20,19,0,0,0,83,MIA,28,23,11,12,0,0,0,74,20020308
2002,CLE,16,27,25,31,16,0,0,115,MIL,26,17,25,31,10,0,0,109,20020308
2002,WAS,23,24,26,23,0,0,0,96,ORL,32,27,19,21,0,0,0,99,20020308
2002,IND,28,22,20,30,0,0,0,100,PHI,33,21,20,35,0,0,0,109,20020308
2002,MIN,28,11,21,16,0,0,0,76,PHO,15,24,17,25,0,0,0,81,20020308
2002,NJN,20,17,22,14,0,0,0,73,POR,23,20,22,17,0,0,0,82,20020308
2002,CHH,25,18,21,23,0,0,0,87,SAC,31,17,22,29,0,0,0,99,20020308
2002,NYK,18,23,20,24,0,0,0,85,UTA,18,18,28,15,0,0,0,79,20020308
2002,PHI,27,22,32,31,0,0,0,112,ATL,15,28,28,20,0,0,0,91,20020309
2002,SAS,27,28,21,24,0,0,0,100,CHI,16,19,17,21,0,0,0,73,20020309
2002,GSW,22,32,24,27,0,0,0,105,DAL,32,25,28,22,0,0,0,107,20020309
2002,POR,36,17,21,21,11,0,0,106,DEN,22,20,24,29,14,0,0,109,20020309
2002,MIA,24,21,26,22,0,0,0,93,MEM,16,24,21,27,0,0,0,88,20020309
2002,NJN,21,27,22,20,0,0,0,90,SEA,25,24,21,26,0,0,0,96,20020309
2002,WAS,21,32,20,18,0,0,0,91,BOS,23,25,26,24,0,0,0,98,20020310
2002,LAC,26,20,25,24,0,0,0,95,CLE,20,18,14,26,0,0,0,78,20020310
2002,IND,24,23,21,21,0,0,0,89,DET,18,22,24,20,0,0,0,84,20020310
2002,UTA,19,20,23,30,0,0,0,92,HOU,27,13,27,28,0,0,0,95,20020310
2002,NYK,36,24,20,23,0,0,0,103,LAL,28,32,28,29,0,0,0,117,20020310
2002,SAC,25,21,32,20,0,0,0,98,MIL,20,14,19,20,0,0,0,73,20020310
2002,TOR,18,26,21,14,0,0,0,79,ORL,24,25,28,15,0,0,0,92,20020310
2002,CHH,26,28,17,17,0,0,0,88,PHO,24,14,20,24,0,0,0,82,20020310
2002,GSW,28,18,32,18,0,0,0,96,ATL,30,35,30,26,0,0,0,121,20020311
2002,SAC,25,34,26,22,0,0,0,107,CHI,27,23,33,20,0,0,0,103,20020311
2002,SEA,28,32,24,24,0,0,0,108,DAL,35,36,20,28,0,0,0,119,20020311
2002,SAS,22,27,18,26,0,0,0,93,DEN,17,23,19,19,0,0,0,78,20020311
2002,UTA,18,24,18,18,0,0,0,78,MEM,22,15,26,16,0,0,0,79,20020311
2002,LAC,22,28,25,33,0,0,0,108,MIN,24,23,28,24,0,0,0,99,20020311
2002,BOS,28,25,21,30,0,0,0,104,WAS,24,22,24,29,0,0,0,99,20020311
2002,SEA,21,33,22,22,0,0,0,98,HOU,24,27,25,25,0,0,0,101,20020312
2002,GSW,32,19,35,15,0,0,0,101,IND,31,34,27,23,0,0,0,115,20020312
2002,CHH,16,17,21,12,0,0,0,66,LAL,26,23,25,33,0,0,0,107,20020312
2002,PHO,15,18,23,22,0,0,0,78,MIA,24,22,17,27,0,0,0,90,20020312
2002,CHI,24,22,13,22,0,0,0,81,MIL,28,25,34,23,0,0,0,110,20020312
2002,TOR,24,19,24,17,0,0,0,84,NJN,24,18,22,22,0,0,0,86,20020312
2002,PHI,19,26,31,28,0,0,0,104,NYK,25,35,14,22,0,0,0,96,20020312
2002,MEM,21,22,24,17,0,0,0,84,SAS,19,29,18,32,0,0,0,98,20020312
2002,DEN,24,26,26,26,0,0,0,102,ATL,26,31,28,20,0,0,0,105,20020313
2002,NJN,25,19,25,20,0,0,0,89,BOS,25,23,26,23,0,0,0,97,20020313
2002,CLE,16,19,26,23,0,0,0,84,DET,27,18,19,21,0,0,0,85,20020313
2002,WAS,18,20,24,13,0,0,0,75,LAC,28,25,23,20,0,0,0,96,20020313
2002,HOU,23,23,20,30,0,0,0,96,MIN,24,17,31,23,0,0,0,95,20020313
2002,PHO,22,31,29,27,5,0,0,114,ORL,28,34,24,23,10,0,0,119,20020313
2002,SAC,24,21,19,28,0,0,0,92,PHI,31,21,17,19,0,0,0,88,20020313
2002,UTA,18,19,19,26,0,0,0,82,CHH,26,29,21,24,0,0,0,100,20020314
2002,LAL,25,25,24,36,0,0,0,110,GSW,22,19,32,29,0,0,0,102,20020314
2002,SAC,19,29,23,25,0,0,0,96,NYK,38,26,24,25,0,0,0,113,20020314
2002,DAL,24,22,24,36,0,0,0,106,POR,32,41,38,21,0,0,0,132,20020314
2002,CHI,19,23,23,21,0,0,0,86,SAS,22,24,22,23,0,0,0,91,20020314
2002,PHO,22,20,23,24,0,0,0,89,ATL,24,30,25,25,0,0,0,104,20020315
2002,UTA,24,25,26,25,0,0,0,100,DET,23,17,30,27,0,0,0,97,20020315
2002,LAC,17,24,30,21,0,0,0,92,LAL,21,22,23,32,0,0,0,98,20020315
2002,BOS,27,26,24,26,0,0,0,103,MEM,26,25,24,22,0,0,0,97,20020315
2002,IND,30,29,20,19,0,0,0,98,MIN,35,17,9,24,0,0,0,85,20020315
2002,MIA,19,18,22,19,0,0,0,78,NJN,29,22,18,28,0,0,0,97,20020315
2002,DEN,26,32,25,19,0,0,0,102,ORL,33,31,29,31,0,0,0,124,20020315
2002,WAS,26,22,21,34,0,0,0,103,SEA,23,24,28,23,0,0,0,98,20020315
2002,PHO,25,18,20,13,0,0,0,76,CHH,20,24,19,24,0,0,0,87,20020316
2002,DAL,30,29,33,25,0,0,0,117,GSW,33,24,19,24,0,0,0,100,20020316
2002,CHI,24,28,20,26,8,8,0,114,HOU,30,21,26,21,8,6,0,112,20020316
2002,SEA,18,27,23,27,0,0,0,95,LAC,25,16,22,24,0,0,0,87,20020316
2002,DEN,16,18,22,20,0,0,0,76,MIA,24,31,21,25,0,0,0,101,20020316
2002,DET,24,23,27,28,0,0,0,102,MIL,27,22,25,20,0,0,0,94,20020316
2002,CLE,22,32,17,24,0,0,0,95,NYK,23,24,24,34,0,0,0,105,20020316
2002,WAS,21,30,11,18,0,0,0,80,POR,22,26,29,18,0,0,0,95,20020316
2002,BOS,28,29,22,25,0,0,0,104,SAS,29,29,22,31,0,0,0,111,20020316
2002,NYK,26,21,28,24,0,0,0,99,CLE,31,24,23,26,0,0,0,104,20020317
2002,ATL,17,11,16,24,0,0,0,68,IND,23,21,17,24,0,0,0,85,20020317
2002,DAL,26,33,17,27,0,0,0,103,LAL,25,32,23,25,0,0,0,105,20020317
2002,NJN,15,31,24,17,0,0,0,87,MEM,17,17,21,21,0,0,0,76,20020317
2002,UTA,15,24,25,32,0,0,0,96,MIN,19,23,16,31,0,0,0,89,20020317
2002,ORL,29,26,26,24,0,0,0,105,PHI,30,24,23,26,0,0,0,103,20020317
2002,SAC,33,25,29,29,0,0,0,116,TOR,31,32,27,23,0,0,0,113,20020317
2002,POR,28,30,19,23,0,0,0,100,BOS,29,20,25,17,0,0,0,91,20020318
2002,MIL,31,30,25,24,0,0,0,110,CHH,27,28,36,22,0,0,0,113,20020318
2002,DET,34,21,23,20,0,0,0,98,DEN,18,28,23,22,0,0,0,91,20020318
2002,WAS,26,30,22,21,0,0,0,99,GSW,32,22,25,17,0,0,0,96,20020318
2002,HOU,20,17,30,19,0,0,0,86,LAC,23,22,24,24,0,0,0,93,20020318
2002,ATL,28,25,18,31,0,0,0,102,CHI,22,23,20,31,0,0,0,96,20020319
2002,NJN,23,29,23,22,0,0,0,97,CLE,26,26,20,28,0,0,0,100,20020319
2002,LAL,28,24,16,30,0,0,0,98,DAL,31,18,33,32,0,0,0,114,20020319
2002,NYK,29,17,22,33,0,0,0,101,MEM,29,16,31,16,0,0,0,92,20020319
2002,PHI,19,22,25,25,0,0,0,91,MIA,20,25,15,19,0,0,0,79,20020319
2002,TOR,21,29,10,20,0,0,0,80,MIN,26,29,24,33,0,0,0,112,20020319
2002,MIL,23,15,28,25,0,0,0,91,ORL,33,21,26,21,0,0,0,101,20020319
2002,HOU,19,19,31,18,0,0,0,87,SAC,23,27,36,24,0,0,0,110,20020319
2002,GSW,23,30,21,19,0,0,0,93,SEA,35,24,35,16,0,0,0,110,20020319
2002,DET,21,13,30,30,0,0,0,94,UTA,26,18,17,26,0,0,0,87,20020319
2002,CLE,21,20,12,17,0,0,0,70,BOS,22,20,23,31,0,0,0,96,20020320
2002,IND,28,21,19,20,0,0,0,88,CHH,32,19,23,20,0,0,0,94,20020320
2002,WAS,30,24,38,15,0,0,0,107,DEN,25,14,17,19,0,0,0,75,20020320
2002,POR,27,13,24,18,0,0,0,82,NJN,28,20,21,28,0,0,0,97,20020320
2002,MIA,19,26,18,19,0,0,0,82,PHI,22,16,23,16,0,0,0,77,20020320
2002,LAL,25,15,16,34,0,0,0,90,SAS,33,29,25,21,0,0,0,108,20020320
2002,NYK,23,25,18,23,0,0,0,89,ATL,32,30,31,25,0,0,0,118,20020321
2002,SAS,24,29,27,25,0,0,0,105,DAL,23,19,35,25,0,0,0,102,20020321
2002,LAC,31,26,32,27,0,0,0,116,GSW,27,23,23,23,0,0,0,96,20020321
2002,MIN,27,29,18,21,0,0,0,95,MEM,34,18,19,22,0,0,0,93,20020321
2002,DET,23,28,22,22,0,0,0,95,PHO,23,19,11,29,0,0,0,82,20020321
2002,DEN,28,20,18,16,0,0,0,82,SAC,34,35,25,24,0,0,0,118,20020321
2002,WAS,27,19,13,20,0,0,0,79,UTA,28,25,17,24,0,0,0,94,20020321
2002,PHI,18,27,31,20,0,0,0,96,BOS,31,19,27,14,0,0,0,91,20020322
2002,POR,22,32,33,22,0,0,0,109,CHI,21,25,26,21,0,0,0,93,20020322
2002,TOR,21,26,32,15,0,0,0,94,CLE,11,21,27,21,0,0,0,80,20020322
2002,DET,20,19,21,22,0,0,0,82,LAL,27,16,27,24,0,0,0,94,20020322
2002,IND,26,30,20,28,0,0,0,104,MIA,18,23,27,26,0,0,0,94,20020322
2002,MIL,22,26,14,22,0,0,0,84,NJN,18,32,36,22,0,0,0,108,20020322
2002,CHH,31,20,32,23,0,0,0,106,ORL,21,26,25,20,0,0,0,92,20020322
2002,HOU,21,13,26,22,0,0,0,82,SEA,36,25,20,31,0,0,0,112,20020322
2002,CHI,25,27,24,20,0,0,0,96,ATL,33,29,24,26,0,0,0,112,20020323
2002,MEM,25,22,28,25,0,0,0,100,DAL,36,27,31,17,0,0,0,111,20020323
2002,SEA,22,26,22,15,0,0,0,85,DEN,26,22,27,13,0,0,0,88,20020323
2002,PHO,26,23,21,27,0,0,0,97,LAC,13,27,26,28,0,0,0,94,20020323
2002,POR,29,18,25,36,0,0,0,108,MIN,32,25,14,28,0,0,0,99,20020323
2002,MIA,14,22,22,21,0,0,0,79,SAS,21,23,27,18,0,0,0,89,20020323
2002,GSW,24,22,30,27,0,0,0,103,UTA,23,36,23,30,0,0,0,112,20020323
2002,BOS,22,31,17,31,0,0,0,101,DET,32,24,26,27,0,0,0,109,20020324
2002,HOU,30,32,32,22,0,0,0,116,GSW,19,32,31,22,0,0,0,104,20020324
2002,CHH,28,28,19,24,0,0,0,99,IND,20,20,24,20,0,0,0,84,20020324
2002,ORL,19,25,25,16,0,0,0,85,MIL,31,26,36,17,0,0,0,110,20020324
2002,ATL,25,32,26,19,0,0,0,102,NJN,28,27,29,32,0,0,0,116,20020324
2002,NYK,19,20,16,27,0,0,0,82,PHI,19,21,22,28,0,0,0,90,20020324
2002,LAL,27,24,22,24,0,0,0,97,SAC,30,19,25,22,0,0,0,96,20020324
2002,WAS,21,18,25,27,0,0,0,91,TOR,24,23,19,26,0,0,0,92,20020324
2002,SAS,25,20,22,24,0,0,0,91,LAC,24,25,23,13,0,0,0,85,20020325
2002,BOS,14,24,22,27,0,0,0,87,MIA,21,17,22,22,0,0,0,82,20020325
2002,DEN,16,22,21,25,0,0,0,84,NYK,24,25,19,15,0,0,0,83,20020325
2002,CLE,24,14,25,33,0,0,0,96,PHO,32,15,17,38,0,0,0,102,20020325
2002,MEM,17,27,20,39,0,0,0,103,POR,37,20,26,17,0,0,0,100,20020325
2002,UTA,19,18,32,23,0,0,0,92,SEA,20,32,24,30,0,0,0,106,20020325
2002,NJN,19,25,15,18,0,0,0,77,ATL,23,36,21,23,0,0,0,103,20020326
2002,DET,23,20,25,28,0,0,0,96,IND,24,16,20,17,0,0,0,77,20020326
2002,CLE,20,24,30,42,0,0,0,116,LAL,27,28,36,30,0,0,0,121,20020326
2002,DAL,18,27,23,27,17,0,0,112,MIL,25,31,22,17,11,0,0,106,20020326
2002,GSW,29,25,30,31,0,0,0,115,MIN,25,24,29,28,0,0,0,106,20020326
2002,CHI,22,24,15,21,0,0,0,82,ORL,24,26,22,24,0,0,0,96,20020326
2002,LAC,21,24,27,18,0,0,0,90,SAC,28,24,27,28,0,0,0,107,20020326
2002,HOU,34,21,28,22,0,0,0,105,UTA,23,28,25,33,0,0,0,109,20020326
2002,DEN,16,17,25,29,0,0,0,87,WAS,29,32,24,18,0,0,0,103,20020326
2002,GSW,24,21,22,32,0,0,0,99,BOS,23,14,36,29,0,0,0,102,20020327
2002,ORL,27,25,21,31,0,0,0,104,CHH,36,22,21,32,0,0,0,111,20020327
2002,NYK,27,25,19,18,0,0,0,89,DET,31,17,15,19,0,0,0,82,20020327
2002,NJN,10,28,28,22,0,0,0,88,PHI,16,18,22,24,0,0,0,80,20020327
2002,LAL,34,22,27,23,0,0,0,106,PHO,31,31,23,33,0,0,0,118,20020327
2002,SAS,25,23,26,19,0,0,0,93,POR,23,22,27,26,0,0,0,98,20020327
2002,MEM,24,23,18,17,0,0,0,82,SEA,25,22,23,26,0,0,0,96,20020327
2002,MIA,20,23,18,19,0,0,0,80,TOR,28,16,16,21,0,0,0,81,20020327
2002,TOR,26,21,17,21,0,0,0,85,ATL,18,29,23,13,0,0,0,83,20020328
2002,PHI,16,37,22,24,0,0,0,99,CHI,17,11,24,27,0,0,0,79,20020328
2002,SAC,29,24,25,23,0,0,0,101,HOU,23,17,21,13,0,0,0,74,20020328
2002,DEN,27,17,22,22,0,0,0,88,MIL,27,26,17,25,0,0,0,95,20020328
2002,DAL,30,24,31,26,0,0,0,111,MIN,30,36,29,18,0,0,0,113,20020328
2002,CLE,18,25,21,27,0,0,0,91,UTA,28,27,33,24,0,0,0,112,20020328
2002,DAL,21,31,37,19,0,0,0,108,BOS,23,17,11,31,0,0,0,82,20020329
2002,SAC,27,23,25,17,0,0,0,92,CHH,36,19,18,14,0,0,0,87,20020329
2002,GSW,26,35,23,19,0,0,0,103,DET,24,33,26,27,0,0,0,110,20020329
2002,POR,21,28,19,11,0,0,0,79,LAL,28,23,20,20,0,0,0,91,20020329
2002,ATL,15,17,20,28,0,0,0,80,MIA,19,20,30,23,0,0,0,92,20020329
2002,MIN,20,36,25,17,0,0,0,98,NYK,16,21,12,28,0,0,0,77,20020329
2002,IND,27,24,18,37,0,0,0,106,ORL,26,30,35,23,0,0,0,114,20020329
2002,LAC,17,15,36,28,0,0,0,96,PHO,19,24,24,27,0,0,0,94,20020329
2002,SAS,22,16,23,15,0,0,0,76,SEA,17,21,19,22,0,0,0,79,20020329
2002,MIL,26,26,21,25,0,0,0,98,WAS,31,24,32,20,0,0,0,107,20020329
2002,DEN,26,26,27,21,0,0,0,100,CHI,20,22,22,20,0,0,0,84,20020330
2002,CHH,21,23,20,29,0,0,0,93,CLE,21,26,23,15,0,0,0,85,20020330
2002,PHO,27,27,18,18,0,0,0,90,HOU,18,25,21,24,0,0,0,88,20020330
2002,UTA,26,27,27,25,0,0,0,105,LAC,29,16,26,21,0,0,0,92,20020330
2002,GSW,27,22,22,28,0,0,0,99,MEM,26,25,33,21,0,0,0,105,20020330
2002,PHI,21,16,29,26,0,0,0,92,NJN,26,28,21,27,0,0,0,102,20020330
2002,SEA,29,27,15,21,0,0,0,92,POR,26,24,20,17,0,0,0,87,20020330
2002,SAC,20,25,25,22,0,0,0,92,ATL,22,26,25,18,0,0,0,91,20020331
2002,MIL,16,27,20,17,0,0,0,80,BOS,26,28,28,28,0,0,0,110,20020331
2002,DEN,21,20,24,17,0,0,0,82,DET,22,26,11,27,0,0,0,86,20020331
2002,MIA,19,15,29,18,0,0,0,81,IND,22,33,27,18,0,0,0,100,20020331
2002,SAS,22,26,29,18,0,0,0,95,LAL,23,22,29,22,0,0,0,96,20020331
2002,NJN,17,21,24,23,0,0,0,85,MIN,28,29,20,9,0,0,0,86,20020331
2002,NYK,24,26,21,19,0,0,0,90,ORL,23,18,33,23,0,0,0,97,20020331
2002,TOR,19,13,21,19,0,0,0,72,PHI,26,17,9,18,0,0,0,70,20020331
2002,DAL,22,25,32,31,0,0,0,110,WAS,22,23,29,29,0,0,0,103,20020331
2002,MIL,25,19,21,27,0,0,0,92,ATL,14,30,31,25,0,0,0,100,20020402
2002,PHO,24,25,16,31,0,0,0,96,CLE,25,28,22,26,0,0,0,101,20020402
2002,UTA,27,17,17,29,0,0,0,90,DEN,23,15,29,31,0,0,0,98,20020402
2002,POR,32,26,20,13,0,0,0,91,GSW,33,21,23,30,0,0,0,107,20020402
2002,SEA,28,28,22,20,0,0,0,98,HOU,31,17,22,30,0,0,0,100,20020402
2002,BOS,24,23,22,36,0,0,0,105,IND,33,22,25,14,0,0,0,94,20020402
2002,SAC,28,31,28,20,0,0,0,107,MEM,20,17,20,26,0,0,0,83,20020402
2002,DET,25,24,23,18,0,0,0,90,MIA,26,27,16,18,0,0,0,87,20020402
2002,CHH,23,27,12,23,0,0,0,85,NYK,32,16,24,19,0,0,0,91,20020402
2002,LAL,37,29,24,23,0,0,0,113,WAS,24,25,22,22,0,0,0,93,20020402
2002,MIA,23,16,26,25,0,0,0,90,CHH,26,23,15,33,0,0,0,97,20020403
2002,SAC,37,25,24,21,0,0,0,107,DET,16,27,18,25,0,0,0,86,20020403
2002,WAS,18,19,31,22,0,0,0,90,MIL,34,21,24,26,0,0,0,105,20020403
2002,MEM,18,22,17,24,0,0,0,81,MIN,21,24,25,22,0,0,0,92,20020403
2002,LAL,21,19,28,24,0,0,0,92,NJN,33,22,19,20,0,0,0,94,20020403
2002,PHO,22,18,20,15,8,0,0,83,PHI,18,22,17,18,14,0,0,89,20020403
2002,SEA,26,28,15,19,0,0,0,88,SAS,20,25,31,14,0,0,0,90,20020403
2002,CHI,31,26,22,25,0,0,0,104,TOR,37,33,30,17,0,0,0,117,20020403
2002,LAC,9,21,25,32,0,0,0,87,UTA,22,19,32,26,0,0,0,99,20020403
2002,IND,21,20,27,26,0,0,0,94,ATL,26,23,22,24,0,0,0,95,20020404
2002,LAC,27,16,25,22,0,0,0,90,DAL,21,23,34,37,0,0,0,115,20020404
2002,MIN,27,20,17,23,0,0,0,87,DEN,21,25,17,25,0,0,0,88,20020404
2002,SAS,28,27,21,26,0,0,0,102,HOU,25,20,20,13,0,0,0,78,20020404
2002,CLE,22,30,25,24,0,0,0,101,ORL,22,24,23,36,0,0,0,105,20020404
2002,NYK,15,17,26,22,0,0,0,80,POR,24,20,29,15,0,0,0,88,20020404
2002,LAL,17,16,25,23,0,0,0,81,BOS,23,16,27,33,0,0,0,99,20020405
2002,WAS,18,25,19,29,0,0,0,91,CHH,23,34,22,18,0,0,0,97,20020405
2002,TOR,26,25,20,27,0,0,0,98,CHI,31,19,19,27,0,0,0,96,20020405
2002,DEN,20,29,27,28,0,0,0,104,GSW,28,36,23,21,0,0,0,108,20020405
2002,PHO,22,20,25,20,0,0,0,87,IND,27,29,23,18,0,0,0,97,20020405
2002,HOU,16,23,27,15,0,0,0,81,MEM,31,29,15,24,0,0,0,99,20020405
2002,MIL,27,26,25,19,0,0,0,97,MIA,16,32,29,25,0,0,0,102,20020405
2002,ORL,19,19,22,25,0,0,0,85,NJN,27,30,24,29,0,0,0,110,20020405
2002,DET,21,27,24,20,0,0,0,92,PHI,14,30,22,22,0,0,0,88,20020405
2002,NYK,18,26,18,24,0,0,0,86,SEA,27,15,18,23,0,0,0,83,20020405
2002,SAC,36,25,25,31,0,0,0,117,UTA,18,33,29,29,0,0,0,109,20020405
2002,CHH,28,21,22,22,0,0,0,93,ATL,15,34,17,20,0,0,0,86,20020406
2002,CHI,21,26,31,23,0,0,0,101,CLE,34,37,31,18,0,0,0,120,20020406
2002,PHO,20,32,25,27,0,0,0,104,MIN,27,25,22,34,0,0,0,108,20020406
2002,GSW,22,18,30,16,0,0,0,86,POR,26,31,29,27,0,0,0,113,20020406
2002,DAL,22,21,20,24,0,0,0,87,SAS,25,28,14,22,0,0,0,89,20020406
2002,MEM,26,22,13,24,0,0,0,85,WAS,26,21,18,23,0,0,0,88,20020406
2002,DEN,16,19,15,25,0,0,0,75,LAC,26,25,23,23,0,0,0,97,20020407
2002,LAL,19,28,26,23,0,0,0,96,MIA,13,24,30,21,0,0,0,88,20020407
2002,BOS,28,27,23,24,0,0,0,102,NJN,25,17,21,27,0,0,0,90,20020407
2002,MIL,26,25,19,17,0,0,0,87,PHI,25,23,21,20,0,0,0,89,20020407
2002,NYK,23,12,18,29,0,0,0,82,SAC,30,36,26,24,0,0,0,116,20020407
2002,IND,22,23,21,18,0,0,0,84,TOR,21,25,21,27,0,0,0,94,20020407
2002,BOS,23,20,31,26,0,0,0,100,CHI,24,24,27,30,0,0,0,105,20020408
2002,ATL,29,21,22,27,0,0,0,99,DET,25,29,23,28,0,0,0,105,20020408
2002,MIN,22,24,26,28,0,0,0,100,GSW,21,25,23,24,0,0,0,93,20020408
2002,CLE,17,31,25,38,0,0,0,111,IND,24,29,22,24,0,0,0,99,20020408
2002,HOU,12,17,22,23,0,0,0,74,ORL,22,16,19,26,0,0,0,83,20020408
2002,POR,20,19,24,24,0,0,0,87,SAS,23,32,26,18,0,0,0,99,20020408
2002,LAC,24,25,24,27,0,0,0,100,SEA,28,21,31,22,0,0,0,102,20020408
2002,DAL,27,29,21,28,0,0,0,105,UTA,28,29,18,21,0,0,0,96,20020408
2002,POR,28,24,21,23,0,0,0,96,DAL,34,22,23,29,0,0,0,108,20020409
2002,UTA,20,19,31,12,0,0,0,82,LAL,27,28,32,25,0,0,0,112,20020409
2002,DEN,26,23,12,25,0,0,0,86,MEM,28,33,18,18,0,0,0,97,20020409
2002,HOU,16,22,38,24,9,8,0,117,MIA,29,20,30,21,9,11,0,120,20020409
2002,PHI,26,23,19,24,0,0,0,92,MIL,25,24,21,20,0,0,0,90,20020409
2002,WAS,18,25,22,23,0,0,0,88,NJN,28,27,31,15,0,0,0,101,20020409
2002,ORL,27,29,31,21,0,0,0,108,NYK,24,25,22,26,0,0,0,97,20020409
2002,SEA,18,26,24,24,0,0,0,92,PHO,27,23,25,24,0,0,0,99,20020409
2002,MIN,21,21,31,30,0,0,0,103,SAC,27,32,32,31,0,0,0,122,20020409
2002,CHH,26,20,18,16,0,0,0,80,TOR,14,30,18,22,0,0,0,84,20020409
2002,MIA,18,18,20,9,0,0,0,65,BOS,24,16,12,18,0,0,0,70,20020410
2002,ATL,20,28,29,24,0,0,0,101,CHH,28,18,25,24,0,0,0,95,20020410
2002,MIL,29,22,13,17,0,0,0,81,CLE,35,34,19,18,0,0,0,106,20020410
2002,CHI,18,27,32,25,0,0,0,102,DET,30,21,33,17,0,0,0,101,20020410
2002,SAC,38,35,24,21,0,0,0,118,GSW,27,37,18,34,0,0,0,116,20020410
2002,TOR,16,24,23,19,0,0,0,82,IND,37,8,31,22,0,0,0,98,20020410
2002,DEN,17,15,25,22,0,0,0,79,SAS,33,18,19,17,0,0,0,87,20020410
2002,PHI,19,14,24,20,0,0,0,77,WAS,15,33,21,21,0,0,0,90,20020410
2002,HOU,11,24,28,22,13,0,0,98,DAL,21,30,16,18,10,0,0,95,20020411
2002,MIN,20,14,23,26,0,0,0,83,LAL,20,26,30,20,0,0,0,96,20020411
2002,POR,26,16,32,25,0,0,0,99,MEM,22,26,30,24,0,0,0,102,20020411
2002,CHI,26,31,26,13,8,0,0,104,NYK,31,24,27,14,5,0,0,101,20020411
2002,NJN,28,18,19,25,11,0,0,101,ORL,27,20,24,19,9,0,0,99,20020411
2002,UTA,18,26,25,28,0,0,0,97,PHO,25,23,23,25,0,0,0,96,20020411
2002,NYK,17,26,21,28,0,0,0,92,BOS,32,33,22,20,0,0,0,107,20020412
2002,CLE,18,32,24,26,0,0,0,100,CHH,24,27,33,28,0,0,0,112,20020412
2002,GSW,25,25,22,17,0,0,0,89,DEN,28,26,14,29,0,0,0,97,20020412
2002,SAS,21,27,30,18,0,0,0,96,DET,27,24,19,16,0,0,0,86,20020412
2002,POR,17,25,17,21,0,0,0,80,HOU,17,19,18,25,0,0,0,79,20020412
2002,MIL,23,22,28,25,9,0,0,107,IND,22,20,33,23,14,0,0,112,20020412
2002,SAC,27,32,30,36,0,0,0,125,LAC,22,29,22,33,0,0,0,106,20020412
2002,ORL,30,22,20,22,0,0,0,94,MIA,20,31,17,31,0,0,0,99,20020412
2002,WAS,27,25,18,21,0,0,0,91,PHI,28,25,26,21,0,0,0,100,20020412
2002,ATL,17,19,21,16,0,0,0,73,TOR,29,34,21,28,0,0,0,112,20020412
2002,CLE,19,29,30,27,10,8,0,123,ATL,27,17,34,27,10,13,0,128,20020413
2002,DET,31,32,27,34,0,0,0,124,CHI,24,28,27,27,0,0,0,106,20020413
2002,PHO,24,16,20,34,0,0,0,94,DEN,22,30,26,20,0,0,0,98,20020413
2002,UTA,17,29,30,33,0,0,0,109,GSW,23,22,25,31,0,0,0,101,20020413
2002,MIN,29,19,31,22,0,0,0,101,LAC,18,31,29,20,0,0,0,98,20020413
2002,SAS,44,20,27,22,0,0,0,113,MEM,23,21,24,24,0,0,0,92,20020413
2002,DAL,26,36,34,20,0,0,0,116,SEA,25,21,20,33,0,0,0,99,20020413
2002,MEM,36,20,22,20,0,0,0,98,HOU,27,25,23,20,0,0,0,95,20020414
2002,NYK,20,25,28,21,0,0,0,94,MIA,26,15,18,8,0,0,0,67,20020414
2002,CHH,22,17,23,29,0,0,0,91,MIL,26,19,26,27,0,0,0,98,20020414
2002,PHI,16,33,22,24,0,0,0,95,ORL,22,19,28,20,0,0,0,89,20020414
2002,LAL,21,31,25,28,10,5,0,120,POR,27,18,25,35,10,13,0,128,20020414
2002,DAL,31,32,22,28,0,0,0,113,SAC,22,26,25,27,0,0,0,100,20020414
2002,NJN,19,9,17,37,0,0,0,82,TOR,28,22,29,22,0,0,0,101,20020414
2002,IND,30,14,20,22,0,0,0,86,WAS,18,28,19,15,0,0,0,80,20020414
2002,SEA,29,25,21,29,0,0,0,104,LAL,28,32,33,18,0,0,0,111,20020415
2002,BOS,26,14,32,21,0,0,0,93,MIN,19,22,24,25,0,0,0,90,20020415
2002,CHI,22,24,30,22,0,0,0,98,PHI,25,30,28,13,0,0,0,96,20020415
2002,ORL,28,22,24,28,0,0,0,102,ATL,25,23,17,30,0,0,0,95,20020416
2002,IND,29,26,18,26,0,0,0,99,CLE,22,21,23,29,0,0,0,95,20020416
2002,UTA,21,23,21,22,0,0,0,87,DAL,25,23,22,26,0,0,0,96,20020416
2002,HOU,14,13,17,26,0,0,0,70,DEN,24,21,27,29,0,0,0,101,20020416
2002,MEM,26,15,24,19,0,0,0,84,LAC,24,24,25,19,0,0,0,92,20020416
2002,CHH,21,22,17,28,0,0,0,88,MIA,18,34,19,10,0,0,0,81,20020416
2002,TOR,34,24,16,15,0,0,0,89,MIL,28,27,24,26,0,0,0,105,20020416
2002,DET,26,20,23,34,0,0,0,103,NJN,23,22,24,29,0,0,0,98,20020416
2002,GSW,33,23,27,23,0,0,0,106,SAC,29,34,32,25,0,0,0,120,20020416
2002,PHO,15,18,16,22,0,0,0,71,SAS,31,26,16,22,0,0,0,95,20020416
2002,NYK,29,22,27,34,0,0,0,112,WAS,28,31,31,26,0,0,0,116,20020416
2002,ATL,11,28,27,15,0,0,0,81,BOS,24,25,22,18,0,0,0,89,20020417
2002,CHI,21,32,22,31,0,0,0,106,CHH,20,28,28,36,0,0,0,112,20020417
2002,MIL,23,21,18,27,0,0,0,89,DET,32,32,32,27,0,0,0,123,20020417
2002,LAC,18,25,35,25,0,0,0,103,GSW,33,28,19,27,0,0,0,107,20020417
2002,PHI,17,18,22,23,0,0,0,80,IND,23,26,24,30,0,0,0,103,20020417
2002,SAC,26,28,22,19,0,0,0,95,LAL,30,26,31,22,0,0,0,109,20020417
2002,DEN,14,24,23,29,0,0,0,90,MIN,25,28,23,28,0,0,0,104,20020417
2002,NJN,24,15,29,31,0,0,0,99,NYK,23,20,29,22,0,0,0,94,20020417
2002,MIA,27,34,16,26,0,0,0,103,ORL,31,15,21,22,0,0,0,89,20020417
2002,DAL,23,22,16,15,0,0,0,76,PHO,32,23,20,14,0,0,0,89,20020417
2002,HOU,9,21,23,26,0,0,0,79,POR,26,16,22,28,0,0,0,92,20020417
2002,MEM,29,17,24,24,0,0,0,94,SEA,26,36,37,10,0,0,0,109,20020417
2002,CLE,27,25,16,17,0,0,0,85,TOR,22,28,27,26,0,0,0,103,20020417
2002,SAS,25,21,21,19,0,0,0,86,UTA,19,23,20,22,0,0,0,84,20020417
2002,ORL,28,16,24,11,0,0,0,79,CHH,20,19,18,23,0,0,0,80,20020420
2002,IND,28,24,11,26,0,0,0,89,NJN,22,20,19,22,0,0,0,83,20020420
2002,UTA,20,27,17,22,0,0,0,86,SAC,25,21,25,18,0,0,0,89,20020420
2002,SEA,29,23,13,24,0,0,0,89,SAS,24,28,38,20,0,0,0,110,20020420
2002,PHI,28,20,11,23,0,0,0,82,BOS,31,23,19,19,0,0,0,92,20020421
2002,MIN,31,16,26,21,0,0,0,94,DAL,22,28,23,28,0,0,0,101,20020421
2002,TOR,9,25,11,18,0,0,0,63,DET,16,26,23,20,0,0,0,85,20020421
2002,POR,23,21,18,25,0,0,0,87,LAL,19,27,22,27,0,0,0,95,20020421
2002,IND,19,19,22,19,0,0,0,79,NJN,18,31,23,23,0,0,0,95,20020422
2002,SEA,22,30,21,25,0,0,0,98,SAS,36,18,17,19,0,0,0,90,20020422
2002,ORL,27,35,15,22,12,0,0,111,CHH,26,21,28,24,4,0,0,103,20020423
2002,UTA,15,29,20,29,0,0,0,93,SAC,14,15,23,34,0,0,0,86,20020423
2002,MIN,28,31,28,23,0,0,0,110,DAL,33,30,34,25,0,0,0,122,20020424
2002,TOR,30,19,18,24,0,0,0,91,DET,27,19,26,24,0,0,0,96,20020424
2002,PHI,21,19,21,24,0,0,0,85,BOS,26,22,21,24,0,0,0,93,20020425
2002,POR,18,19,26,33,0,0,0,96,LAL,27,24,26,26,0,0,0,103,20020425
2002,NJN,23,21,20,21,0,0,0,85,IND,21,16,29,18,0,0,0,84,20020426
2002,CHH,27,23,16,26,18,0,0,110,ORL,27,18,24,23,8,0,0,100,20020427
2002,SAS,23,34,22,23,0,0,0,102,SEA,21,18,15,21,0,0,0,75,20020427
2002,DET,17,23,27,17,0,0,0,84,TOR,26,25,28,15,0,0,0,94,20020427
2002,SAC,32,14,23,21,0,0,0,90,UTA,21,24,21,21,0,0,0,87,20020427
2002,DAL,40,27,30,18,0,0,0,115,MIN,28,29,22,23,0,0,0,102,20020428
2002,BOS,21,31,29,22,0,0,0,103,PHI,30,28,25,25,0,0,0,108,20020428
2002,LAL,19,31,17,25,0,0,0,92,POR,19,22,26,24,0,0,0,91,20020428
2002,DET,21,15,25,22,0,0,0,83,TOR,21,25,20,23,0,0,0,89,20020429
2002,SAC,28,18,21,24,0,0,0,91,UTA,20,20,22,24,0,0,0,86,20020429
2002,NJN,19,14,20,21,0,0,0,74,IND,22,16,30,29,0,0,0,97,20020430
2002,CHH,25,26,24,27,0,0,0,102,ORL,24,17,28,16,0,0,0,85,20020430
2002,BOS,20,16,25,20,0,0,0,81,PHI,16,22,18,27,0,0,0,83,20020501
2002,SAS,13,18,28,20,0,0,0,79,SEA,24,33,19,15,0,0,0,91,20020501
2002,TOR,26,22,11,23,0,0,0,82,DET,21,25,17,22,0,0,0,85,20020502
2002,IND,24,27,28,17,11,2,0,109,NJN,27,24,28,17,11,13,0,120,20020502
2002,PHI,22,25,20,20,0,0,0,87,BOS,27,32,18,43,0,0,0,120,20020503
2002,SEA,10,16,32,20,0,0,0,78,SAS,27,28,26,20,0,0,0,101,20020503
2002,DAL,24,26,24,17,0,0,0,91,SAC,27,28,27,26,0,0,0,108,20020504
2002,BOS,22,21,19,22,0,0,0,84,DET,22,28,28,18,0,0,0,96,20020505
2002,SAS,17,21,23,19,0,0,0,80,LAL,13,19,25,29,0,0,0,86,20020505
2002,CHH,22,29,22,20,0,0,0,93,NJN,26,19,32,22,0,0,0,99,20020505
2002,DAL,23,36,22,29,0,0,0,110,SAC,36,24,20,22,0,0,0,102,20020506
2002,SAS,31,25,17,15,0,0,0,88,LAL,26,14,25,20,0,0,0,85,20020507
2002,CHH,19,31,22,16,0,0,0,88,NJN,24,29,27,22,0,0,0,102,20020507
2002,BOS,28,22,17,18,0,0,0,85,DET,20,16,23,18,0,0,0,77,20020508
2002,NJN,18,27,24,28,0,0,0,97,CHH,28,23,33,31,0,0,0,115,20020509
2002,SAC,38,28,25,34,0,0,0,125,DAL,25,41,25,28,0,0,0,119,20020509
2002,DET,17,16,15,16,0,0,0,64,BOS,17,20,11,18,0,0,0,66,20020510
2002,LAL,24,29,21,25,0,0,0,99,SAS,28,24,19,18,0,0,0,89,20020510
2002,SAC,25,26,31,27,6,0,0,115,DAL,27,27,35,20,4,0,0,113,20020511
2002,DET,17,22,19,21,0,0,0,79,BOS,21,20,25,24,0,0,0,90,20020512
2002,NJN,25,14,25,25,0,0,0,89,CHH,24,20,20,15,0,0,0,79,20020512
2002,LAL,25,17,25,20,0,0,0,87,SAS,25,21,29,10,0,0,0,85,20020512
2002,DAL,26,27,20,28,0,0,0,101,SAC,32,27,27,28,0,0,0,114,20020513
2002,BOS,24,20,20,26,0,0,0,90,DET,21,24,10,26,0,0,0,81,20020514
2002,SAS,22,23,16,26,0,0,0,87,LAL,15,24,23,31,0,0,0,93,20020514
2002,CHH,24,26,22,23,0,0,0,95,NJN,25,23,27,28,0,0,0,103,20020515
2002,LAL,36,22,24,24,0,0,0,106,SAC,22,23,24,30,0,0,0,99,20020518
2002,BOS,27,22,19,29,0,0,0,97,NJN,31,26,24,23,0,0,0,104,20020519
2002,LAL,26,24,17,23,0,0,0,90,SAC,25,27,24,20,0,0,0,96,20020520
2002,BOS,27,21,27,18,0,0,0,93,NJN,17,25,19,25,0,0,0,86,20020521
2002,SAC,32,20,23,28,0,0,0,103,LAL,15,25,12,38,0,0,0,90,20020524
2002,NJN,28,26,20,16,0,0,0,90,BOS,13,21,19,41,0,0,0,94,20020525
2002,SAC,40,25,15,19,0,0,0,99,LAL,20,31,22,27,0,0,0,100,20020526
2002,NJN,31,17,25,21,0,0,0,94,BOS,18,24,27,23,0,0,0,92,20020527
2002,LAL,33,13,28,17,0,0,0,91,SAC,27,24,22,19,0,0,0,92,20020528
2002,BOS,16,22,31,23,0,0,0,92,NJN,31,24,17,31,0,0,0,103,20020529
2002,NJN,21,23,26,26,0,0,0,96,BOS,28,26,15,19,0,0,0,88,20020531
2002,SAC,26,30,19,27,0,0,0,102,LAL,28,23,24,31,0,0,0,106,20020531
2002,LAL,22,30,21,27,12,0,0,112,SAC,21,33,20,26,6,0,0,106,20020602
2002,NJN,14,22,27,31,0,0,0,94,LAL,29,19,24,27,0,0,0,99,20020605
2002,NJN,21,22,18,22,0,0,0,83,LAL,27,22,28,29,0,0,0,106,20020607
2002,LAL,31,21,26,28,0,0,0,106,NJN,23,23,32,25,0,0,0,103,20020609
2002,LAL,27,31,26,29,0,0,0,113,NJN,34,23,23,27,0,0,0,107,20020612
2003,SAS,24,17,24,22,0,0,0,87,LAL,18,23,21,20,0,0,0,82,20021029
2003,PHI,30,21,22,15,0,0,0,88,ORL,29,22,23,21,0,0,0,95,20021029
2003,CLE,14,18,10,25,0,0,0,67,SAC,19,25,22,28,0,0,0,94,20021029
2003,CHI,26,19,35,19,0,0,0,99,BOS,32,19,33,12,0,0,0,96,20021030
2003,NYK,27,18,20,12,0,0,0,77,DET,19,21,20,26,0,0,0,86,20021030
2003,SAS,21,26,23,28,0,0,0,98,GSW,19,30,24,33,0,0,0,106,20021030
2003,HOU,22,21,19,20,0,0,0,82,IND,24,20,27,20,0,0,0,91,20021030
2003,CLE,17,28,25,28,0,0,0,98,LAC,22,26,22,26,0,0,0,96,20021030
2003,DAL,31,33,36,19,0,0,0,119,MEM,23,31,26,28,0,0,0,108,20021030
2003,ORL,24,30,26,20,0,0,0,100,MIA,30,15,24,17,0,0,0,86,20021030
2003,DEN,16,23,24,14,0,0,0,77,MIN,24,30,16,13,0,0,0,83,20021030
2003,ATL,22,18,25,29,0,0,0,94,NJN,31,20,26,28,0,0,0,105,20021030
2003,UTA,22,16,26,11,0,0,0,75,NOH,20,29,19,32,0,0,0,100,20021030
2003,MIL,25,22,21,25,0,0,0,93,PHI,31,22,22,20,0,0,0,95,20021030
2003,LAL,23,17,21,29,0,0,0,90,POR,21,39,24,18,0,0,0,102,20021030
2003,PHO,24,18,18,13,0,0,0,73,SEA,15,24,21,26,0,0,0,86,20021030
2003,WAS,14,22,9,23,0,0,0,68,TOR,20,24,15,15,0,0,0,74,20021030
2003,UTA,23,23,17,35,0,0,0,98,ATL,29,21,27,28,0,0,0,105,20021031
2003,POR,13,23,19,17,0,0,0,72,SAC,20,27,28,25,0,0,0,100,20021031
2003,BOS,21,19,20,9,0,0,0,69,WAS,24,34,27,29,0,0,0,114,20021031
2003,NOH,17,22,17,23,0,0,0,79,CHI,18,24,19,23,0,0,0,84,20021101
2003,HOU,29,11,16,27,0,0,0,83,DEN,23,15,15,21,0,0,0,74,20021101
2003,MEM,18,16,23,29,0,0,0,86,DET,31,23,26,29,0,0,0,109,20021101
2003,SEA,34,21,23,28,0,0,0,106,GSW,22,28,25,18,0,0,0,93,20021101
2003,LAL,34,26,25,23,0,0,0,108,LAC,20,21,32,20,0,0,0,93,20021101
2003,ORL,17,25,34,29,0,0,0,105,MIN,36,30,22,23,0,0,0,111,20021101
2003,IND,20,21,20,30,0,0,0,91,NJN,21,27,28,26,0,0,0,102,20021101
2003,NYK,21,18,30,17,0,0,0,86,PHI,22,16,19,41,0,0,0,98,20021101
2003,CLE,26,18,15,15,0,0,0,74,PHO,18,22,12,26,0,0,0,78,20021101
2003,TOR,19,21,26,6,0,0,0,72,SAS,19,27,24,21,0,0,0,91,20021101
2003,CHI,21,23,21,27,0,0,0,92,ATL,28,29,17,24,0,0,0,98,20021102
2003,PHO,25,18,17,23,0,0,0,83,DAL,31,24,26,16,0,0,0,97,20021102
2003,TOR,20,19,14,23,0,0,0,76,HOU,29,21,24,14,0,0,0,88,20021102
2003,MIN,24,20,18,18,0,0,0,80,IND,17,26,23,21,0,0,0,87,20021102
2003,SAC,19,36,33,28,0,0,0,116,MEM,28,21,20,30,0,0,0,99,20021102
2003,ORL,21,31,24,24,0,0,0,100,MIL,20,24,12,34,0,0,0,90,20021102
2003,MIA,26,27,18,24,0,0,0,95,NOH,20,21,34,25,0,0,0,100,20021102
2003,BOS,30,29,26,32,0,0,0,117,NYK,27,27,32,21,0,0,0,107,20021102
2003,DEN,25,18,25,28,0,0,0,96,POR,22,27,14,16,0,0,0,79,20021102
2003,GSW,16,31,22,23,0,0,0,92,UTA,24,26,27,24,0,0,0,101,20021102
2003,NJN,22,13,24,28,0,0,0,87,WAS,15,21,19,24,0,0,0,79,20021102
2003,DET,20,20,15,17,0,0,0,72,LAC,15,17,26,16,0,0,0,74,20021103
2003,POR,15,23,22,25,10,0,0,95,LAL,19,20,19,27,13,0,0,98,20021103
2003,SAC,20,21,18,19,0,0,0,78,MIA,21,27,18,22,0,0,0,88,20021103
2003,UTA,9,20,20,28,0,0,0,77,SEA,20,25,21,25,0,0,0,91,20021103
2003,GSW,20,25,27,28,0,0,0,100,DAL,32,31,18,26,0,0,0,107,20021104
2003,SAS,31,18,26,15,13,0,0,103,MEM,28,22,17,23,11,0,0,101,20021104
2003,MIN,25,14,22,21,0,0,0,82,NJN,22,22,39,23,0,0,0,106,20021104
2003,MIL,25,31,15,26,0,0,0,97,NYK,20,22,24,22,0,0,0,88,20021104
2003,DET,22,25,19,18,0,0,0,84,PHO,21,19,15,27,0,0,0,82,20021104
2003,CHI,24,22,16,32,11,0,0,105,TOR,30,25,25,14,15,0,0,109,20021104
2003,LAL,17,22,21,10,0,0,0,70,CLE,17,26,24,22,0,0,0,89,20021105
2003,ATL,25,33,16,29,0,0,0,103,DEN,18,25,30,14,0,0,0,87,20021105
2003,SEA,22,24,32,26,0,0,0,104,HOU,25,22,15,35,0,0,0,97,20021105
2003,IND,18,23,22,20,0,0,0,83,MIA,21,18,22,18,0,0,0,79,20021105
2003,WAS,21,30,24,11,0,0,0,86,MIN,25,18,23,24,0,0,0,90,20021105
2003,SAC,36,27,25,33,0,0,0,121,ORL,31,37,24,33,0,0,0,125,20021105
2003,GSW,23,22,12,16,0,0,0,73,SAS,23,19,31,20,0,0,0,93,20021105
2003,BOS,23,30,18,20,0,0,0,91,CHI,18,16,16,19,0,0,0,69,20021106
2003,NJN,23,21,23,26,0,0,0,93,MIL,24,27,24,24,0,0,0,99,20021106
2003,SEA,20,21,19,24,0,0,0,84,NOH,25,26,18,17,0,0,0,86,20021106
2003,SAC,26,26,20,16,0,0,0,88,NYK,27,27,20,21,0,0,0,95,20021106
2003,LAC,27,16,33,16,7,0,0,99,PHI,26,21,27,18,9,0,0,101,20021106
2003,ATL,25,22,28,13,0,0,0,88,PHO,21,25,18,29,0,0,0,93,20021106
2003,MEM,22,26,21,19,0,0,0,88,POR,29,14,27,24,0,0,0,94,20021106
2003,DAL,24,25,31,26,0,0,0,106,TOR,16,32,27,17,0,0,0,92,20021106
2003,DET,24,25,10,21,0,0,0,80,UTA,19,25,16,18,0,0,0,78,20021106
2003,CLE,13,30,23,34,0,0,0,100,WAS,28,18,27,34,0,0,0,107,20021106
2003,LAL,15,20,36,18,6,0,0,95,BOS,26,24,17,22,9,0,0,98,20021107
2003,DET,17,24,28,20,0,0,0,89,DEN,14,17,14,18,0,0,0,63,20021107
2003,MIL,29,25,31,25,0,0,0,110,MIN,29,27,27,31,0,0,0,114,20021107
2003,DAL,34,28,31,21,0,0,0,114,CHI,20,22,22,23,0,0,0,87,20021108
2003,NYK,25,21,25,23,0,0,0,94,IND,38,21,18,30,0,0,0,107,20021108
2003,LAC,26,30,22,14,0,0,0,92,NJN,33,16,28,29,0,0,0,106,20021108
2003,GSW,24,27,22,31,0,0,0,104,NOH,24,31,29,26,0,0,0,110,20021108
2003,SEA,27,20,25,26,0,0,0,98,ORL,20,29,22,34,0,0,0,105,20021108
2003,CLE,15,22,35,12,0,0,0,84,PHI,22,31,40,15,0,0,0,108,20021108
2003,POR,13,27,18,17,0,0,0,75,PHO,17,16,37,16,0,0,0,86,20021108
2003,MEM,14,27,33,17,0,0,0,91,SAC,35,26,23,15,0,0,0,99,20021108
2003,ATL,24,28,25,20,0,0,0,97,UTA,32,19,34,25,0,0,0,110,20021108
2003,LAL,23,17,20,39,0,0,0,99,WAS,27,22,25,26,0,0,0,100,20021108
2003,NJN,24,23,17,29,0,0,0,93,CHI,26,26,18,30,0,0,0,100,20021109
2003,WAS,17,26,22,28,0,0,0,93,CLE,15,25,15,24,0,0,0,79,20021109
2003,DET,20,23,10,22,0,0,0,75,DAL,37,31,27,19,0,0,0,114,20021109
2003,MEM,14,25,18,16,0,0,0,73,DEN,16,30,26,12,0,0,0,84,20021109
2003,GSW,28,20,25,31,0,0,0,104,HOU,21,29,28,33,0,0,0,111,20021109
2003,TOR,27,30,11,16,0,0,0,84,IND,19,25,30,34,0,0,0,108,20021109
2003,SEA,31,18,15,20,0,0,0,84,MIA,20,24,21,17,0,0,0,82,20021109
2003,PHI,19,26,27,24,9,0,0,105,MIL,27,28,19,22,14,0,0,110,20021109
2003,BOS,24,24,29,28,0,0,0,105,MIN,31,26,19,23,0,0,0,99,20021109
2003,POR,20,24,25,26,0,0,0,95,SAS,10,26,22,18,0,0,0,76,20021109
2003,NOH,17,23,22,21,14,0,0,97,NYK,24,26,21,12,8,0,0,91,20021110
2003,LAC,25,32,33,30,0,0,0,120,ORL,31,31,22,33,0,0,0,117,20021110
2003,ATL,20,27,24,26,0,0,0,97,SAC,28,20,27,30,0,0,0,105,20021110
2003,UTA,14,31,28,22,0,0,0,95,BOS,29,12,41,30,0,0,0,112,20021111
2003,POR,20,18,12,23,0,0,0,73,DAL,16,18,28,20,0,0,0,82,20021111
2003,GSW,25,23,33,27,0,0,0,108,MEM,21,24,24,32,0,0,0,101,20021111
2003,MIN,18,13,23,21,0,0,0,75,SAS,26,26,18,21,0,0,0,91,20021111
2003,NOH,29,16,11,31,0,0,0,87,DET,20,23,24,26,0,0,0,93,20021112
2003,POR,29,19,16,19,0,0,0,83,HOU,18,20,25,23,0,0,0,86,20021112
2003,CLE,17,18,14,26,0,0,0,75,IND,26,22,19,28,0,0,0,95,20021112
2003,ATL,21,24,28,22,0,0,0,95,LAL,17,23,22,21,0,0,0,83,20021112
2003,LAC,24,21,28,28,0,0,0,101,MIA,22,29,15,16,0,0,0,82,20021112
2003,UTA,22,26,34,26,0,0,0,108,NYK,18,12,24,33,0,0,0,87,20021112
2003,TOR,31,19,30,35,0,0,0,115,ORL,27,30,34,18,0,0,0,109,20021112
2003,SEA,25,33,24,19,0,0,0,101,WAS,28,24,19,24,0,0,0,95,20021112
2003,PHI,18,20,27,16,0,0,0,81,BOS,22,23,20,26,0,0,0,91,20021113
2003,DAL,23,25,22,33,0,0,0,103,CLE,31,21,19,28,0,0,0,99,20021113
2003,PHO,19,14,29,13,0,0,0,75,DEN,20,22,11,19,0,0,0,72,20021113
2003,SAC,39,26,25,14,0,0,0,104,GSW,22,34,20,17,0,0,0,93,20021113
2003,CHI,30,14,27,30,0,0,0,101,MIL,25,42,17,24,0,0,0,108,20021113
2003,SAS,27,16,18,21,0,0,0,82,NJN,21,20,23,27,0,0,0,91,20021113
2003,MIN,22,32,27,17,0,0,0,98,NOH,22,31,20,29,0,0,0,102,20021113
2003,ORL,25,24,29,23,0,0,0,101,LAC,22,21,15,22,0,0,0,80,20021114
2003,SAS,25,16,25,28,0,0,0,94,PHI,31,24,17,27,0,0,0,99,20021114
2003,UTA,19,21,31,31,0,0,0,102,WAS,32,16,26,31,0,0,0,105,20021114
2003,DAL,25,25,20,27,0,0,0,97,BOS,20,19,22,25,0,0,0,86,20021115
2003,UTA,14,23,15,23,0,0,0,75,DET,23,20,28,15,0,0,0,86,20021115
2003,MIL,28,20,14,30,8,0,0,100,IND,28,27,25,12,11,0,0,103,20021115
2003,GSW,20,20,25,20,4,0,0,89,LAL,25,19,23,18,11,0,0,96,20021115
2003,MIN,24,25,28,22,0,0,0,99,MEM,22,26,23,24,0,0,0,95,20021115
2003,NJN,23,18,32,20,0,0,0,93,MIA,22,22,22,18,0,0,0,84,20021115
2003,CHI,26,26,14,21,0,0,0,87,NOH,27,22,34,22,0,0,0,105,20021115
2003,HOU,27,22,22,16,0,0,0,87,PHO,25,20,23,20,0,0,0,88,20021115
2003,LAC,17,21,14,36,0,0,0,88,POR,36,23,26,27,0,0,0,112,20021115
2003,SAC,25,25,23,24,0,0,0,97,SEA,25,37,31,18,0,0,0,111,20021115
2003,DEN,16,21,22,20,0,0,0,79,TOR,24,19,17,24,0,0,0,84,20021115
2003,NOH,24,15,22,21,0,0,0,82,ATL,25,19,26,19,0,0,0,89,20021116
2003,MEM,24,22,22,25,0,0,0,93,CHI,29,31,22,29,0,0,0,111,20021116
2003,SAS,22,21,23,24,0,0,0,90,CLE,16,16,19,26,0,0,0,77,20021116
2003,DEN,14,15,12,12,0,0,0,53,DET,15,13,18,28,0,0,0,74,20021116
2003,ORL,25,24,21,22,0,0,0,92,GSW,31,34,35,35,0,0,0,135,20021116
2003,BOS,26,27,18,14,0,0,0,85,MIL,29,25,24,26,0,0,0,104,20021116
2003,IND,31,20,28,28,0,0,0,107,MIN,25,19,24,33,0,0,0,101,20021116
2003,DAL,25,23,19,29,0,0,0,96,NJN,21,22,30,15,0,0,0,88,20021116
2003,PHI,21,28,18,26,0,0,0,93,NYK,12,32,23,25,0,0,0,92,20021116
2003,MIA,14,18,19,14,0,0,0,65,WAS,28,31,22,14,0,0,0,95,20021116
2003,SEA,19,14,21,30,0,0,0,84,LAC,28,15,21,14,0,0,0,78,20021117
2003,HOU,21,21,17,34,0,0,0,93,LAL,19,24,21,25,0,0,0,89,20021117
2003,WAS,26,16,26,16,0,0,0,84,PHI,26,29,20,25,0,0,0,100,20021117
2003,ORL,25,21,25,28,0,0,0,99,SAC,20,21,29,31,0,0,0,101,20021117
2003,UTA,10,26,22,24,0,0,0,82,TOR,16,12,27,23,0,0,0,78,20021117
2003,TOR,22,15,27,28,0,0,0,92,ATL,33,33,27,24,0,0,0,117,20021118
2003,LAC,27,25,21,26,0,0,0,99,GSW,17,21,20,31,0,0,0,89,20021118
2003,DEN,15,14,19,31,0,0,0,79,NJN,30,25,28,16,0,0,0,99,20021118
2003,DET,20,14,26,31,0,0,0,91,NYK,38,26,18,12,0,0,0,94,20021118
2003,CLE,23,14,21,20,0,0,0,78,SAS,23,25,21,35,0,0,0,104,20021118
2003,LAL,25,14,18,15,0,0,0,72,DAL,25,29,27,17,0,0,0,98,20021119
2003,CLE,18,20,25,17,0,0,0,80,HOU,27,18,24,28,0,0,0,97,20021119
2003,MIA,32,24,24,17,0,0,0,97,MIL,25,27,16,25,0,0,0,93,20021119
2003,MEM,28,25,25,20,8,0,0,106,MIN,27,23,26,22,12,0,0,110,20021119
2003,PHI,19,30,23,26,0,0,0,98,NOH,38,18,19,24,0,0,0,99,20021119
2003,CHI,26,22,26,24,0,0,0,98,SAC,33,25,29,24,0,0,0,111,20021119
2003,ORL,27,25,28,21,0,0,0,101,SEA,30,15,18,21,0,0,0,84,20021119
2003,PHO,22,18,17,19,0,0,0,76,UTA,25,25,29,20,0,0,0,99,20021119
2003,MIN,26,33,20,24,0,0,0,103,ATL,24,12,31,26,0,0,0,93,20021120
2003,NJN,21,16,14,28,0,0,0,79,BOS,23,21,29,23,0,0,0,96,20021120
2003,UTA,32,21,25,18,0,0,0,96,DEN,26,15,24,14,0,0,0,79,20021120
2003,MIA,16,18,12,22,0,0,0,68,DET,16,21,21,21,0,0,0,79,20021120
2003,CHI,24,18,26,26,0,0,0,94,GSW,30,25,26,19,0,0,0,100,20021120
2003,SAC,27,17,19,30,0,0,0,93,LAC,21,25,22,21,0,0,0,89,20021120
2003,PHI,26,28,21,20,0,0,0,95,MEM,24,22,17,25,0,0,0,88,20021120
2003,ORL,22,13,23,26,0,0,0,84,POR,26,20,25,27,0,0,0,98,20021120
2003,LAL,22,24,24,18,0,0,0,88,SAS,16,34,17,28,0,0,0,95,20021120
2003,IND,25,24,23,25,0,0,0,97,TOR,29,27,21,18,0,0,0,95,20021120
2003,HOU,20,26,28,16,0,0,0,90,DAL,29,20,31,23,0,0,0,103,20021121
2003,POR,19,21,25,24,0,0,0,89,SEA,27,22,13,23,0,0,0,85,20021121
2003,ATL,26,23,24,16,5,4,0,98,BOS,24,25,14,26,5,11,0,105,20021122
2003,LAC,22,16,24,8,0,0,0,70,DEN,19,14,16,23,0,0,0,72,20021122
2003,MIL,17,22,24,32,0,0,0,95,GSW,27,20,23,21,0,0,0,91,20021122
2003,WAS,24,21,16,25,0,0,0,86,HOU,26,18,31,18,0,0,0,93,20021122
2003,ORL,12,17,25,16,0,0,0,70,IND,29,22,29,26,0,0,0,106,20021122
2003,CHI,21,20,17,15,0,0,0,73,LAL,25,17,27,17,0,0,0,86,20021122
2003,DET,20,18,12,25,0,0,0,75,MIA,20,22,14,16,0,0,0,72,20021122
2003,CLE,22,19,22,16,0,0,0,79,NJN,37,23,20,40,0,0,0,120,20021122
2003,NYK,31,22,22,18,4,0,0,97,NOH,16,29,30,18,12,0,0,105,20021122
2003,TOR,29,13,20,18,0,0,0,80,PHI,15,24,27,24,0,0,0,90,20021122
2003,PHO,30,19,24,28,0,0,0,101,SAC,29,23,40,26,0,0,0,118,20021122
2003,MEM,21,22,13,30,0,0,0,86,SAS,27,21,29,18,0,0,0,95,20021122
2003,BOS,26,31,20,32,0,0,0,109,ATL,23,31,20,25,0,0,0,99,20021123
2003,NOH,25,22,27,23,0,0,0,97,CLE,24,21,20,19,0,0,0,84,20021123
2003,SEA,34,21,30,20,0,0,0,105,DAL,18,29,29,39,0,0,0,115,20021123
2003,DET,19,32,26,29,0,0,0,106,IND,23,28,21,19,0,0,0,91,20021123
2003,WAS,21,21,11,21,0,0,0,74,MEM,24,16,18,27,0,0,0,85,20021123
2003,NJN,30,25,24,17,0,0,0,96,MIN,18,22,21,21,0,0,0,82,20021123
2003,DEN,18,13,22,27,0,0,0,80,PHO,23,16,19,21,0,0,0,79,20021123
2003,SAC,22,24,23,26,0,0,0,95,POR,23,25,26,20,0,0,0,94,20021123
2003,CHI,29,22,18,21,0,0,0,90,UTA,35,23,24,28,0,0,0,110,20021123
2003,HOU,14,24,31,20,0,0,0,89,LAC,31,17,18,24,0,0,0,90,20021124
2003,MIL,31,23,23,22,0,0,0,99,LAL,32,30,26,23,0,0,0,111,20021124
2003,MIN,29,22,29,26,0,0,0,106,NYK,18,27,24,19,0,0,0,88,20021124
2003,MIA,23,16,21,15,0,0,0,75,ORL,18,24,17,18,0,0,0,77,20021124
2003,SEA,23,21,21,26,0,0,0,91,SAS,21,28,25,16,0,0,0,90,20021124
2003,PHI,25,26,15,28,0,0,0,94,TOR,17,26,20,21,0,0,0,84,20021124
2003,NOH,21,26,19,21,0,0,0,87,PHI,34,22,20,32,0,0,0,108,20021125
2003,MIL,22,25,10,24,0,0,0,81,PHO,25,22,14,25,0,0,0,86,20021125
2003,SEA,28,24,28,25,11,0,0,116,ATL,33,20,27,25,14,0,0,119,20021126
2003,SAC,17,27,25,22,0,0,0,91,CLE,21,29,19,16,0,0,0,85,20021126
2003,SAS,16,31,18,16,0,0,0,81,DEN,21,20,18,26,0,0,0,85,20021126
2003,UTA,19,21,35,24,0,0,0,99,LAC,26,15,31,22,0,0,0,94,20021126
2003,LAL,25,16,20,24,0,0,0,85,MIA,28,22,22,25,0,0,0,97,20021126
2003,HOU,13,19,21,18,0,0,0,71,POR,16,18,23,20,0,0,0,77,20021126
2003,IND,25,20,20,23,0,0,0,88,WAS,18,14,21,31,0,0,0,84,20021126
2003,CHI,19,24,21,18,0,0,0,82,BOS,28,22,30,12,0,0,0,92,20021127
2003,DAL,28,29,29,16,0,0,0,102,DET,26,19,11,26,0,0,0,82,20021127
2003,HOU,18,23,26,24,0,0,0,91,GSW,18,22,18,26,0,0,0,84,20021127
2003,SEA,23,36,21,19,0,0,0,99,MEM,35,29,30,23,0,0,0,117,20021127
2003,CLE,24,18,21,17,0,0,0,80,MIL,21,29,33,29,0,0,0,112,20021127
2003,SAC,10,28,19,17,0,0,0,74,MIN,29,14,27,20,0,0,0,90,20021127
2003,ATL,22,29,13,30,0,0,0,94,NOH,24,22,37,23,0,0,0,106,20021127
2003,LAL,21,29,23,29,0,0,0,102,ORL,31,22,28,31,0,0,0,112,20021127
2003,MIA,18,15,23,18,0,0,0,74,PHI,18,27,17,21,0,0,0,83,20021127
2003,NJN,19,21,18,17,0,0,0,75,PHO,23,18,20,21,0,0,0,82,20021127
2003,DEN,3,19,18,28,0,0,0,68,SAS,21,25,27,26,0,0,0,99,20021127
2003,NYK,18,21,19,29,0,0,0,87,TOR,17,15,28,21,0,0,0,81,20021127
2003,DAL,29,20,20,29,0,0,0,98,IND,29,30,25,26,0,0,0,110,20021128
2003,NJN,29,25,31,26,7,0,0,118,LAC,30,20,27,34,15,0,0,126,20021128
2003,MIA,20,26,26,16,6,0,0,94,ATL,23,24,18,23,12,0,0,100,20021129
2003,TOR,32,17,29,20,0,0,0,98,BOS,24,26,28,17,0,0,0,95,20021129
2003,PHI,21,26,37,22,0,0,0,106,CLE,26,25,21,27,0,0,0,99,20021129
2003,GSW,16,24,26,26,0,0,0,92,DEN,23,26,18,15,0,0,0,82,20021129
2003,MIL,24,21,26,20,0,0,0,91,DET,31,22,23,20,0,0,0,96,20021129
2003,WAS,27,28,18,11,0,0,0,84,IND,26,21,31,22,0,0,0,100,20021129
2003,LAL,28,24,23,23,14,0,0,112,MEM,20,30,26,22,8,0,0,106,20021129
2003,SAS,21,21,18,27,0,0,0,87,PHO,15,22,20,37,0,0,0,94,20021129
2003,LAC,22,19,27,26,0,0,0,94,SAC,30,20,33,24,0,0,0,107,20021129
2003,HOU,18,18,32,15,0,0,0,83,SEA,18,28,11,15,0,0,0,72,20021129
2003,MIN,26,23,19,9,0,0,0,77,UTA,29,19,29,18,0,0,0,95,20021129
2003,CHI,21,25,22,22,0,0,0,90,DAL,31,26,20,26,0,0,0,103,20021130
2003,PHO,24,19,20,27,0,0,0,90,GSW,22,21,32,25,0,0,0,100,20021130
2003,CLE,17,24,14,24,0,0,0,79,MIA,21,21,21,22,0,0,0,85,20021130
2003,DET,24,28,16,18,0,0,0,86,MIL,33,29,25,22,0,0,0,109,20021130
2003,NOH,19,24,15,22,6,0,0,86,NYK,17,22,25,16,12,0,0,92,20021130
2003,ATL,29,21,16,26,0,0,0,92,ORL,33,36,30,18,0,0,0,117,20021130
2003,NJN,17,28,32,16,0,0,0,93,POR,21,20,16,29,0,0,0,86,20021130
2003,UTA,26,21,17,21,0,0,0,85,SAS,19,31,31,26,0,0,0,107,20021130
2003,PHI,20,26,28,21,0,0,0,95,WAS,25,25,20,24,0,0,0,94,20021130
2003,NOH,24,22,19,21,0,0,0,86,BOS,26,25,20,24,0,0,0,95,20021201
2003,IND,20,23,21,28,0,0,0,92,LAC,17,20,26,24,0,0,0,87,20021201
2003,MIN,28,22,26,34,0,0,0,110,LAL,29,31,16,31,0,0,0,107,20021201
2003,TOR,19,18,27,28,0,0,0,92,MEM,18,28,21,20,0,0,0,87,20021201
2003,HOU,19,19,20,26,0,0,0,84,SAC,30,19,32,22,0,0,0,103,20021201
2003,NJN,29,22,22,22,0,0,0,95,SEA,20,32,21,23,0,0,0,96,20021201
2003,TOR,25,27,26,24,0,0,0,102,DAL,24,29,29,31,0,0,0,113,20021202
2003,CLE,19,19,33,22,0,0,0,93,NYK,28,37,34,26,0,0,0,125,20021202
2003,BOS,25,20,36,21,0,0,0,102,ORL,23,25,27,22,0,0,0,97,20021202
2003,MIA,23,18,22,16,21,0,0,100,PHO,25,19,24,11,11,0,0,90,20021202
2003,IND,27,23,17,24,0,0,0,91,UTA,27,26,26,23,0,0,0,102,20021202
2003,NOH,28,22,33,32,0,0,0,115,CHI,24,20,23,23,0,0,0,90,20021203
2003,DEN,16,21,26,26,0,0,0,89,GSW,34,21,27,28,0,0,0,110,20021203
2003,SAS,21,18,25,11,0,0,0,75,HOU,21,28,12,28,0,0,0,89,20021203
2003,MEM,16,21,32,22,0,0,0,91,LAL,22,22,31,26,0,0,0,101,20021203
2003,ATL,18,17,18,19,0,0,0,72,NJN,27,24,22,14,0,0,0,87,20021203
2003,MIN,20,26,22,18,0,0,0,86,SAC,28,20,26,24,0,0,0,98,20021203
2003,MIL,23,16,18,21,0,0,0,78,WAS,24,32,25,22,0,0,0,103,20021203
2003,CHI,24,21,31,25,0,0,0,101,CLE,26,34,27,24,0,0,0,111,20021204
2003,SAC,32,24,19,17,0,0,0,92,DEN,23,19,31,17,0,0,0,90,20021204
2003,WAS,20,19,22,27,0,0,0,88,DET,18,27,18,20,0,0,0,83,20021204
2003,MIA,17,20,18,25,0,0,0,80,LAC,25,24,24,16,0,0,0,89,20021204
2003,TOR,22,18,18,16,0,0,0,74,NOH,18,23,22,26,0,0,0,89,20021204
2003,ORL,28,26,16,17,0,0,0,87,NYK,26,23,24,12,0,0,0,85,20021204
2003,BOS,32,24,15,22,0,0,0,93,PHI,24,25,26,24,0,0,0,99,20021204
2003,MEM,25,18,25,17,0,0,0,85,PHO,19,30,24,25,0,0,0,98,20021204
2003,DAL,23,31,24,25,0,0,0,103,POR,23,22,24,19,0,0,0,88,20021204
2003,IND,22,28,29,23,12,0,0,114,SEA,32,20,26,24,9,0,0,111,20021204
2003,LAL,20,20,13,32,0,0,0,85,UTA,22,22,18,31,0,0,0,93,20021204
2003,MIL,25,27,17,11,0,0,0,80,ATL,31,24,22,21,0,0,0,98,20021205
2003,MIN,33,31,18,32,0,0,0,114,GSW,24,28,22,24,0,0,0,98,20021205
2003,NYK,22,16,19,23,0,0,0,80,BOS,23,25,27,16,0,0,0,91,20021206
2003,DAL,29,35,24,15,0,0,0,103,LAL,24,12,25,44,0,0,0,105,20021206
2003,HOU,18,28,23,15,12,0,0,96,NOH,23,21,30,10,14,0,0,98,20021206
2003,WAS,24,11,19,24,0,0,0,78,ORL,29,20,18,21,0,0,0,88,20021206
2003,IND,36,20,18,22,0,0,0,96,PHO,29,29,15,29,0,0,0,102,20021206
2003,MIA,11,11,19,28,0,0,0,69,POR,26,22,18,22,0,0,0,88,20021206
2003,DEN,20,15,26,16,0,0,0,77,SAC,32,16,30,20,0,0,0,98,20021206
2003,PHI,22,20,26,25,0,0,0,93,SAS,26,23,31,18,0,0,0,98,20021206
2003,CHI,20,24,20,25,0,0,0,89,TOR,25,23,21,34,0,0,0,103,20021206
2003,MEM,15,19,16,21,0,0,0,71,UTA,22,29,26,27,0,0,0,104,20021206
2003,DET,26,12,27,27,0,0,0,92,ATL,19,28,29,18,0,0,0,94,20021207
2003,CLE,26,23,27,28,0,0,0,104,CHI,34,25,31,22,0,0,0,112,20021207
2003,IND,17,20,27,17,0,0,0,81,DEN,23,26,18,25,0,0,0,92,20021207
2003,DAL,21,33,31,36,0,0,0,121,GSW,25,37,32,22,0,0,0,116,20021207
2003,PHI,23,17,22,10,0,0,0,72,HOU,23,25,23,26,0,0,0,97,20021207
2003,MIN,25,26,18,19,0,0,0,88,LAC,24,28,29,23,0,0,0,104,20021207
2003,NOH,18,16,34,26,0,0,0,94,MIL,31,19,23,15,0,0,0,88,20021207
2003,ORL,21,17,27,23,0,0,0,88,NJN,24,34,35,28,0,0,0,121,20021207
2003,MIA,12,21,18,20,0,0,0,71,SEA,34,15,17,34,0,0,0,100,20021207
2003,NYK,26,21,24,26,0,0,0,97,WAS,27,29,24,20,0,0,0,100,20021207
2003,UTA,21,31,24,25,0,0,0,101,LAL,34,24,30,22,0,0,0,110,20021208
2003,PHO,24,20,24,26,0,0,0,94,MEM,21,28,23,30,0,0,0,102,20021208
2003,SAC,23,27,29,25,0,0,0,104,SAS,22,22,21,15,0,0,0,80,20021208
2003,POR,29,29,24,22,0,0,0,104,TOR,27,25,23,16,0,0,0,91,20021208
2003,ORL,26,25,24,20,14,0,0,109,BOS,21,28,20,26,19,0,0,114,20021209
2003,MIL,28,28,34,13,15,22,0,140,CLE,27,20,28,28,15,15,0,133,20021209
2003,MIN,24,23,18,27,0,0,0,92,DEN,21,23,17,23,0,0,0,84,20021209
2003,PHO,31,18,13,31,0,0,0,93,NJN,22,27,34,23,0,0,0,106,20021209
2003,LAC,20,23,22,29,0,0,0,94,NOH,15,20,25,30,0,0,0,90,20021209
2003,ORL,22,21,25,19,0,0,0,87,CHI,29,28,25,25,0,0,0,107,20021210
2003,LAC,21,24,17,33,0,0,0,95,DAL,26,42,27,27,0,0,0,122,20021210
2003,LAL,30,18,26,28,0,0,0,102,GSW,23,30,26,27,0,0,0,106,20021210
2003,SAC,22,23,26,25,0,0,0,96,HOU,24,38,19,22,0,0,0,103,20021210
2003,MEM,34,20,22,31,0,0,0,107,MIA,27,24,27,18,0,0,0,96,20021210
2003,SEA,18,17,24,21,0,0,0,80,NYK,22,24,25,26,0,0,0,97,20021210
2003,POR,29,28,24,17,0,0,0,98,WAS,18,21,18,22,0,0,0,79,20021210
2003,PHO,22,26,24,31,0,0,0,103,BOS,28,28,16,22,0,0,0,94,20021211
2003,TOR,24,22,21,16,0,0,0,83,CLE,23,21,30,22,0,0,0,96,20021211
2003,ATL,20,17,16,27,0,0,0,80,DET,25,24,16,26,0,0,0,91,20021211
2003,DEN,15,22,31,25,0,0,0,93,MEM,27,24,24,21,0,0,0,96,20021211
2003,IND,28,28,33,25,12,0,0,126,MIL,26,25,30,33,5,0,0,119,20021211
2003,POR,21,26,21,36,0,0,0,104,NJN,24,35,19,27,0,0,0,105,20021211
2003,SEA,22,26,19,25,0,0,0,92,PHI,33,27,14,14,0,0,0,88,20021211
2003,DAL,29,25,15,35,0,0,0,104,SAS,29,24,27,31,0,0,0,111,20021211
2003,DET,23,18,18,27,0,0,0,86,CHI,16,16,23,21,0,0,0,76,20021212
2003,ATL,30,26,17,22,0,0,0,95,MIN,29,34,24,26,0,0,0,113,20021212
2003,NOH,12,23,36,22,0,0,0,93,UTA,24,14,29,21,0,0,0,88,20021212
2003,CLE,23,30,31,16,0,0,0,100,BOS,40,23,30,22,0,0,0,115,20021213
2003,DEN,15,13,24,20,0,0,0,72,IND,22,31,24,17,0,0,0,94,20021213
2003,NOH,29,31,18,20,0,0,0,98,LAL,28,20,18,16,0,0,0,82,20021213
2003,HOU,25,30,27,23,4,0,0,109,MEM,26,29,24,26,9,0,0,114,20021213
2003,NYK,25,36,18,18,0,0,0,97,MIA,26,24,21,21,0,0,0,92,20021213
2003,POR,21,24,15,19,0,0,0,79,MIL,25,23,32,21,0,0,0,101,20021213
2003,WAS,14,14,20,17,0,0,0,65,NJN,22,16,19,22,0,0,0,79,20021213
2003,GSW,20,29,17,19,0,0,0,85,ORL,30,33,26,22,0,0,0,111,20021213
2003,PHO,25,29,24,21,0,0,0,99,PHI,24,23,22,22,0,0,0,91,20021213
2003,LAC,25,22,17,20,0,0,0,84,SAS,30,26,22,19,0,0,0,97,20021213
2003,SEA,26,16,21,28,0,0,0,91,TOR,16,19,17,27,0,0,0,79,20021213
2003,PHO,18,30,30,24,0,0,0,102,ATL,27,22,16,23,0,0,0,88,20021214
2003,MIL,25,18,25,27,0,0,0,95,CHI,22,28,26,21,0,0,0,97,20021214
2003,DEN,35,24,27,18,0,0,0,104,CLE,31,30,28,22,0,0,0,111,20021214
2003,MEM,17,28,20,22,0,0,0,87,DAL,33,22,25,24,0,0,0,104,20021214
2003,SEA,20,24,18,16,0,0,0,78,DET,26,28,19,18,0,0,0,91,20021214
2003,LAC,33,21,24,16,0,0,0,94,HOU,22,23,23,15,0,0,0,83,20021214
2003,GSW,22,12,30,28,0,0,0,92,MIA,23,30,21,27,0,0,0,101,20021214
2003,POR,21,24,31,9,13,0,0,98,MIN,22,25,21,17,7,0,0,92,20021214
2003,BOS,26,26,31,30,0,0,0,113,NYK,20,24,16,30,0,0,0,90,20021214
2003,SAC,24,25,23,26,0,0,0,98,UTA,20,31,21,24,0,0,0,96,20021214
2003,NJN,24,25,17,25,0,0,0,91,DET,13,35,28,25,0,0,0,101,20021215
2003,PHI,33,17,24,23,0,0,0,97,IND,32,33,24,18,0,0,0,107,20021215
2003,ORL,26,16,27,15,0,0,0,84,LAL,33,17,30,27,0,0,0,107,20021215
2003,NOH,29,16,23,24,0,0,0,92,SAC,29,23,27,28,0,0,0,107,20021215
2003,WAS,25,22,25,23,0,0,0,95,TOR,20,29,17,16,0,0,0,82,20021215
2003,BOS,23,14,19,27,0,0,0,83,CHI,24,24,19,27,0,0,0,94,20021216
2003,SEA,36,27,21,27,0,0,0,111,CLE,26,21,23,28,0,0,0,98,20021216
2003,SAS,28,15,14,22,0,0,0,79,LAC,23,26,24,18,0,0,0,91,20021216
2003,GSW,23,25,27,16,0,0,0,91,MEM,29,26,23,26,0,0,0,104,20021216
2003,HOU,22,24,29,16,14,0,0,105,MIA,29,11,23,28,9,0,0,100,20021216
2003,DEN,10,12,23,26,0,0,0,71,PHI,21,20,25,27,0,0,0,93,20021216
2003,ORL,28,23,17,16,0,0,0,84,PHO,18,25,28,16,0,0,0,87,20021216
2003,WAS,34,30,22,23,0,0,0,109,ATL,22,31,26,20,0,0,0,99,20021217
2003,IND,26,24,28,19,0,0,0,97,DAL,35,27,37,19,0,0,0,118,20021217
2003,TOR,32,23,23,26,18,0,0,122,MIL,33,24,25,22,13,0,0,117,20021217
2003,LAL,18,20,19,23,0,0,0,80,MIN,26,28,17,25,0,0,0,96,20021217
2003,NJN,28,26,21,24,0,0,0,99,NYK,26,23,27,25,0,0,0,101,20021217
2003,NOH,28,21,19,25,0,0,0,93,POR,25,25,26,26,0,0,0,102,20021217
2003,PHO,20,27,19,20,0,0,0,86,SAC,32,20,23,20,0,0,0,95,20021217
2003,MIA,25,23,20,23,0,0,0,91,BOS,16,12,26,27,0,0,0,81,20021218
2003,TOR,25,24,22,12,0,0,0,83,CHI,29,27,19,21,0,0,0,96,20021218
2003,DET,22,34,18,27,10,0,0,111,CLE,21,29,22,29,5,0,0,106,20021218
2003,DAL,20,22,22,16,0,0,0,80,DEN,14,23,14,24,0,0,0,75,20021218
2003,NOH,20,32,26,28,0,0,0,106,GSW,27,33,19,32,0,0,0,111,20021218
2003,IND,20,14,22,27,0,0,0,83,HOU,25,19,14,37,0,0,0,95,20021218
2003,POR,23,23,21,30,0,0,0,97,LAC,26,26,25,16,0,0,0,93,20021218
2003,MIN,20,22,28,24,0,0,0,94,PHI,29,32,15,23,0,0,0,99,20021218
2003,SAS,25,28,19,19,0,0,0,91,SEA,21,28,22,17,0,0,0,88,20021218
2003,ORL,25,19,29,24,0,0,0,97,UTA,29,23,20,18,0,0,0,90,20021218
2003,MEM,22,24,28,26,0,0,0,100,WAS,32,35,24,27,0,0,0,118,20021218
2003,LAL,18,19,22,12,0,0,0,71,NJN,21,25,22,30,0,0,0,98,20021219
2003,SAS,17,27,20,19,0,0,0,83,SAC,21,18,22,20,0,0,0,81,20021219
2003,MIN,22,33,25,19,0,0,0,99,BOS,21,42,20,25,0,0,0,108,20021220
2003,UTA,26,21,29,17,0,0,0,93,DAL,24,17,18,22,0,0,0,81,20021220
2003,ORL,23,17,22,27,0,0,0,89,DEN,22,20,21,17,0,0,0,80,20021220
2003,CLE,18,31,26,25,7,0,0,107,DET,18,30,26,26,9,0,0,109,20021220
2003,POR,30,28,30,25,0,0,0,113,GSW,34,27,27,23,0,0,0,111,20021220
2003,ATL,28,21,19,14,0,0,0,82,HOU,20,18,37,26,0,0,0,101,20021220
2003,CHI,24,20,20,22,0,0,0,86,IND,34,34,16,17,0,0,0,101,20021220
2003,PHO,23,25,20,19,0,0,0,87,LAC,21,12,16,27,0,0,0,76,20021220
2003,MIL,19,28,23,14,0,0,0,84,MEM,25,16,23,31,0,0,0,95,20021220
2003,LAL,23,25,25,21,10,0,0,104,PHI,20,23,37,14,13,0,0,107,20021220
2003,NOH,17,26,17,21,7,0,0,88,SEA,31,15,12,23,5,0,0,86,20021220
2003,MIA,23,30,26,18,0,0,0,97,TOR,25,12,16,24,0,0,0,77,20021220
2003,PHI,21,15,21,20,0,0,0,77,ATL,27,12,20,20,0,0,0,79,20021221
2003,IND,19,25,28,31,0,0,0,103,CHI,26,20,25,39,0,0,0,110,20021221
2003,BOS,25,17,21,26,0,0,0,89,CLE,18,35,20,9,0,0,0,82,20021221
2003,DEN,24,28,17,20,0,0,0,89,LAC,24,28,21,19,0,0,0,92,20021221
2003,NYK,23,22,22,23,0,0,0,90,MIL,22,29,17,26,0,0,0,94,20021221
2003,HOU,20,25,24,17,0,0,0,86,MIN,30,23,21,24,0,0,0,98,20021221
2003,DET,21,23,24,24,0,0,0,92,NJN,23,30,27,20,0,0,0,100,20021221
2003,SAC,29,23,26,23,0,0,0,101,PHO,32,30,19,29,0,0,0,110,20021221
2003,SEA,17,25,23,15,0,0,0,80,POR,21,17,20,23,0,0,0,81,20021221
2003,WAS,24,21,21,15,0,0,0,81,SAS,20,15,31,26,0,0,0,92,20021221
2003,UTA,21,33,27,22,0,0,0,103,MEM,11,20,17,26,0,0,0,74,20021222
2003,MIA,23,21,23,25,0,0,0,92,NYK,31,18,16,19,0,0,0,84,20021222
2003,GSW,20,25,12,31,0,0,0,88,SAC,32,26,19,26,0,0,0,103,20021222
2003,LAL,32,22,25,23,7,0,0,109,TOR,21,24,29,28,5,0,0,107,20021222
2003,MIA,22,13,21,16,0,0,0,72,CLE,23,11,21,19,0,0,0,74,20021223
2003,WAS,26,19,20,21,0,0,0,86,DAL,25,25,15,27,0,0,0,92,20021223
2003,UTA,20,16,31,29,0,0,0,96,HOU,23,20,25,23,0,0,0,91,20021223
2003,ATL,28,26,22,21,0,0,0,97,IND,32,32,28,20,0,0,0,112,20021223
2003,CHI,23,21,13,26,0,0,0,83,NJN,23,27,31,18,0,0,0,99,20021223
2003,MIL,21,34,19,34,0,0,0,108,ORL,24,28,24,27,0,0,0,103,20021223
2003,SEA,22,28,23,15,0,0,0,88,PHO,33,18,22,16,0,0,0,89,20021223
2003,NOH,23,22,30,15,4,0,0,94,SAS,31,22,22,15,9,0,0,99,20021223
2003,SAC,24,25,28,28,0,0,0,105,LAL,24,29,21,25,0,0,0,99,20021225
2003,BOS,17,23,30,11,0,0,0,81,NJN,28,35,32,22,0,0,0,117,20021225
2003,DET,19,24,28,28,0,0,0,99,ORL,28,25,29,22,0,0,0,104,20021225
2003,DAL,22,20,26,15,0,0,0,83,NOH,23,21,22,15,0,0,0,81,20021226
2003,TOR,20,21,21,26,0,0,0,88,SEA,24,24,23,26,0,0,0,97,20021226
2003,DET,25,16,20,26,0,0,0,87,WAS,25,24,14,19,0,0,0,82,20021226
2003,SAS,19,15,23,22,0,0,0,79,ATL,16,28,18,19,0,0,0,81,20021227
2003,MIN,29,25,31,28,0,0,0,113,CHI,19,29,21,31,0,0,0,100,20021227
2003,IND,31,29,32,21,0,0,0,113,CLE,21,20,25,23,0,0,0,89,20021227
2003,TOR,27,25,25,19,0,0,0,96,GSW,31,27,18,25,0,0,0,101,20021227
2003,NYK,24,26,21,28,0,0,0,99,HOU,20,21,24,18,0,0,0,83,20021227
2003,ORL,32,25,15,14,0,0,0,86,MEM,25,22,26,26,0,0,0,99,20021227
2003,BOS,25,16,20,9,0,0,0,70,MIA,27,28,13,22,0,0,0,90,20021227
2003,MIL,26,27,17,20,0,0,0,90,NJN,26,34,26,24,0,0,0,110,20021227
2003,LAC,22,22,22,29,0,0,0,95,PHO,33,20,31,24,0,0,0,108,20021227
2003,UTA,29,16,22,31,0,0,0,98,POR,24,30,27,22,0,0,0,103,20021227
2003,SAS,34,22,26,27,0,0,0,109,CHI,20,26,18,31,0,0,0,95,20021228
2003,NYK,20,22,15,25,0,0,0,82,DAL,29,26,29,23,0,0,0,107,20021228
2003,LAL,31,24,27,30,0,0,0,112,DEN,18,29,22,24,0,0,0,93,20021228
2003,MIN,26,18,17,21,0,0,0,82,DET,29,25,25,27,0,0,0,106,20021228
2003,NOH,21,14,24,25,0,0,0,84,IND,24,21,17,29,0,0,0,91,20021228
2003,GSW,27,23,30,19,0,0,0,99,LAC,16,25,31,20,0,0,0,92,20021228
2003,NJN,32,17,26,29,0,0,0,104,MIL,16,27,21,32,0,0,0,96,20021228
2003,BOS,20,27,24,24,0,0,0,95,ORL,33,32,17,19,0,0,0,101,20021228
2003,POR,29,27,27,19,17,0,0,119,SAC,29,29,19,25,11,0,0,113,20021228
2003,PHI,12,17,13,27,0,0,0,69,UTA,22,22,33,21,0,0,0,98,20021228
2003,ATL,16,20,19,21,0,0,0,76,WAS,22,16,21,25,0,0,0,84,20021228
2003,PHO,38,20,21,24,0,0,0,103,CLE,25,19,23,17,0,0,0,84,20021229
2003,NOH,21,22,24,18,0,0,0,85,HOU,33,19,7,38,0,0,0,97,20021229
2003,TOR,20,24,21,23,0,0,0,88,LAL,28,30,22,24,0,0,0,104,20021229
2003,MIL,19,31,27,33,0,0,0,110,DAL,28,25,30,24,0,0,0,107,20021230
2003,SEA,25,9,25,20,0,0,0,79,DEN,20,19,11,27,0,0,0,77,20021230
2003,POR,18,28,22,17,0,0,0,85,DET,21,20,18,15,0,0,0,74,20021230
2003,PHI,16,36,24,22,0,0,0,98,GSW,27,30,21,26,0,0,0,104,20021230
2003,ATL,15,26,17,26,0,0,0,84,MIA,23,25,23,22,0,0,0,93,20021230
2003,PHO,18,22,29,29,0,0,0,98,MIN,26,32,20,26,0,0,0,104,20021230
2003,CLE,20,21,25,22,0,0,0,88,NJN,26,27,30,19,0,0,0,102,20021230
2003,SAS,23,19,27,26,0,0,0,95,NYK,19,26,28,23,0,0,0,96,20021230
2003,WAS,22,27,25,21,0,0,0,95,ORL,29,29,27,27,0,0,0,112,20021230
2003,TOR,26,12,27,20,0,0,0,85,UTA,24,29,28,26,0,0,0,107,20021230
2003,MEM,28,19,24,18,0,0,0,89,BOS,28,23,31,14,0,0,0,96,20021231
2003,POR,23,23,26,15,0,0,0,87,CHI,34,23,20,25,0,0,0,102,20021231
2003,MIL,18,18,22,22,0,0,0,80,HOU,18,32,33,20,0,0,0,103,20021231
2003,PHI,15,16,29,23,0,0,0,83,LAC,21,20,13,21,0,0,0,75,20021231
2003,IND,18,21,33,17,0,0,0,89,NOH,27,22,22,15,0,0,0,86,20021231
2003,SAS,24,26,21,32,0,0,0,103,WAS,24,28,21,32,0,0,0,105,20021231
2003,MIA,22,33,28,24,0,0,0,107,ATL,25,17,18,13,0,0,0,73,20030101
2003,TOR,23,14,25,13,0,0,0,75,NYK,22,28,22,23,0,0,0,95,20030101
2003,WAS,32,23,27,25,0,0,0,107,CHI,20,17,19,26,0,0,0,82,20030102
2003,LAC,12,19,28,33,0,0,0,92,DAL,23,24,31,24,0,0,0,102,20030102
2003,PHI,16,27,20,15,0,0,0,78,PHO,23,19,31,23,0,0,0,96,20030102
2003,POR,36,24,23,25,0,0,0,108,BOS,25,22,30,26,0,0,0,103,20030103
2003,LAC,19,27,40,25,0,0,0,111,MEM,33,38,19,26,0,0,0,116,20030103
2003,NJN,28,26,24,22,0,0,0,100,MIA,12,27,21,20,0,0,0,80,20030103
2003,UTA,23,32,41,22,0,0,0,118,MIL,23,28,27,37,0,0,0,115,20030103
2003,ORL,27,15,23,24,0,0,0,89,NOH,19,27,25,29,0,0,0,100,20030103
2003,IND,29,29,21,17,0,0,0,96,NYK,22,19,27,30,0,0,0,98,20030103
2003,GSW,20,24,26,25,0,0,0,95,SAS,27,19,21,31,0,0,0,98,20030103
2003,DEN,20,16,26,32,0,0,0,94,SEA,28,15,24,15,0,0,0,82,20030103
2003,CLE,26,21,15,19,0,0,0,81,TOR,24,21,16,19,0,0,0,80,20030103
2003,DET,27,15,24,24,0,0,0,90,ATL,26,16,20,24,0,0,0,86,20030104
2003,CLE,12,21,18,28,0,0,0,79,CHI,24,25,17,19,0,0,0,85,20030104
2003,PHI,24,18,20,21,0,0,0,83,DAL,34,24,22,22,0,0,0,102,20030104
2003,SAC,27,19,21,20,0,0,0,87,DEN,21,21,8,26,0,0,0,76,20030104
2003,GSW,26,24,19,17,0,0,0,86,HOU,22,24,20,18,0,0,0,84,20030104
2003,UTA,25,25,34,21,0,0,0,105,MIN,38,18,13,28,0,0,0,97,20030104
2003,NJN,25,21,31,11,0,0,0,88,ORL,21,21,17,24,0,0,0,83,20030104
2003,LAL,23,17,21,32,0,0,0,93,PHO,22,27,22,36,0,0,0,107,20030104
2003,IND,22,31,23,19,4,5,0,104,WAS,31,22,21,21,4,8,0,107,20030104
2003,SAS,17,20,30,27,0,0,0,94,LAC,16,20,26,24,0,0,0,86,20030105
2003,PHO,24,21,23,29,0,0,0,97,LAL,29,22,26,32,0,0,0,109,20030105
2003,POR,23,23,28,18,0,0,0,92,NYK,19,30,21,19,0,0,0,89,20030105
2003,MIA,12,22,22,14,0,0,0,70,SAC,23,22,30,21,0,0,0,96,20030105
2003,NOH,26,24,25,24,0,0,0,99,TOR,26,20,25,13,0,0,0,84,20030105
2003,NJN,29,21,30,21,0,0,0,101,ATL,19,21,31,23,0,0,0,94,20030106
2003,WAS,21,18,35,26,0,0,0,100,BOS,24,24,27,20,0,0,0,95,20030106
2003,UTA,24,24,18,32,0,0,0,98,CHI,25,28,32,28,0,0,0,113,20030106
2003,MIL,28,24,29,25,0,0,0,106,CLE,30,19,26,19,0,0,0,94,20030106
2003,DEN,20,20,19,12,0,0,0,71,DAL,14,26,24,22,0,0,0,86,20030106
2003,TOR,17,23,16,18,0,0,0,74,DET,19,20,16,27,0,0,0,82,20030106
2003,MIA,27,21,20,17,0,0,0,85,GSW,34,23,18,24,0,0,0,99,20030106
2003,NOH,24,12,32,34,0,0,0,102,MEM,30,28,24,24,0,0,0,106,20030106
2003,NYK,31,32,15,22,0,0,0,100,ORL,23,28,28,24,0,0,0,103,20030106
2003,IND,33,25,27,11,9,0,0,105,PHI,20,25,32,19,8,0,0,104,20030106
2003,MIN,19,17,21,29,0,0,0,86,HOU,15,27,32,20,0,0,0,94,20030107
2003,SEA,20,25,26,27,0,0,0,98,LAL,25,35,26,33,0,0,0,119,20030107
2003,SAC,29,27,21,24,0,0,0,101,MIL,22,22,12,20,0,0,0,76,20030107
2003,PHO,17,19,24,28,0,0,0,88,POR,25,24,18,14,0,0,0,81,20030107
2003,DAL,37,21,30,29,0,0,0,117,ATL,22,36,18,23,0,0,0,99,20030108
2003,MIA,21,21,17,17,0,0,0,76,DEN,22,27,16,21,0,0,0,86,20030108
2003,NYK,32,18,17,20,0,0,0,87,IND,26,17,26,20,0,0,0,89,20030108
2003,MEM,16,27,31,21,0,0,0,95,LAC,31,23,21,28,0,0,0,103,20030108
2003,GSW,24,18,24,29,0,0,0,95,MIN,30,22,27,23,0,0,0,102,20030108
2003,BOS,20,22,27,24,0,0,0,93,NOH,27,19,24,13,0,0,0,83,20030108
2003,HOU,24,25,22,20,0,0,0,91,ORL,17,22,19,23,0,0,0,81,20030108
2003,DET,21,29,20,18,15,0,0,103,PHI,20,24,22,22,6,0,0,94,20030108
2003,SAS,27,22,28,29,0,0,0,106,SEA,18,33,17,27,0,0,0,95,20030108
2003,PHO,23,25,30,15,0,0,0,93,UTA,26,18,31,24,0,0,0,99,20030108
2003,CHI,27,32,14,25,0,0,0,98,WAS,26,22,36,17,0,0,0,101,20030108
2003,SAC,34,35,27,22,0,0,0,118,NJN,23,18,17,24,0,0,0,82,20030109
2003,SAS,12,23,20,32,0,0,0,87,POR,24,17,23,26,0,0,0,90,20030109
2003,HOU,13,18,28,16,0,0,0,75,ATL,24,21,18,21,0,0,0,84,20030110
2003,BOS,22,19,19,18,0,0,0,78,DAL,24,36,32,11,0,0,0,103,20030110
2003,POR,25,21,13,22,0,0,0,81,DEN,26,20,16,20,0,0,0,82,20030110
2003,CLE,26,23,25,25,0,0,0,99,LAL,27,38,32,18,0,0,0,115,20030110
2003,CHI,21,21,16,23,4,0,0,85,MIL,23,26,10,22,12,0,0,93,20030110
2003,SAC,19,15,39,30,6,0,0,109,MIN,26,20,31,26,12,0,0,115,20030110
2003,DET,21,22,18,27,13,0,0,101,NOH,25,26,21,16,11,0,0,99,20030110
2003,IND,22,23,27,23,6,0,0,101,ORL,29,18,31,17,2,0,0,97,20030110
2003,NYK,26,26,29,33,0,0,0,114,PHI,19,34,29,30,0,0,0,112,20030110
2003,MEM,24,22,21,23,0,0,0,90,PHO,23,23,22,28,0,0,0,96,20030110
2003,LAC,21,25,24,20,0,0,0,90,SEA,14,21,27,26,0,0,0,88,20030110
2003,NJN,22,29,19,24,0,0,0,94,TOR,22,18,19,20,0,0,0,79,20030110
2003,MIA,12,25,25,14,0,0,0,76,UTA,26,25,20,21,0,0,0,92,20030110
2003,GSW,28,21,31,24,0,0,0,104,WAS,28,23,30,18,0,0,0,99,20030110
2003,NOH,20,23,18,19,0,0,0,80,ATL,22,27,20,18,0,0,0,87,20030111
2003,MIL,28,21,20,20,0,0,0,89,DET,22,19,17,29,0,0,0,87,20030111
2003,DEN,12,21,17,35,0,0,0,85,HOU,21,16,26,24,0,0,0,87,20030111
2003,GSW,30,32,21,21,0,0,0,104,IND,38,30,21,27,0,0,0,116,20030111
2003,WAS,21,22,21,25,0,0,0,89,NYK,19,18,27,20,0,0,0,84,20030111
2003,DAL,24,25,25,22,0,0,0,96,LAC,21,23,28,18,0,0,0,90,20030112
2003,MIA,20,30,11,20,0,0,0,81,LAL,27,23,30,26,0,0,0,106,20030112
2003,ORL,22,25,26,34,0,0,0,107,PHI,27,32,22,24,0,0,0,105,20030112
2003,UTA,22,26,26,25,0,0,0,99,PHO,23,20,31,33,0,0,0,107,20030112
2003,MEM,24,23,27,24,0,0,0,98,SAC,37,24,29,16,0,0,0,106,20030112
2003,BOS,16,24,30,10,0,0,0,80,SAS,27,20,18,16,0,0,0,81,20030112
2003,CLE,24,18,24,21,0,0,0,87,SEA,23,23,25,8,0,0,0,79,20030112
2003,MIN,22,24,26,19,0,0,0,91,TOR,28,36,22,19,0,0,0,105,20030112
2003,NYK,17,26,21,30,0,0,0,94,CHI,18,29,25,29,0,0,0,101,20030113
2003,MEM,28,30,29,23,0,0,0,110,GSW,31,25,25,27,0,0,0,108,20030113
2003,BOS,17,29,22,24,0,0,0,92,HOU,29,21,19,32,0,0,0,101,20030113
2003,DEN,25,22,18,10,0,0,0,75,MIN,17,26,27,19,0,0,0,89,20030113
2003,DET,22,31,29,19,0,0,0,101,ORL,29,25,21,11,0,0,0,86,20030113
2003,CLE,22,20,24,28,0,0,0,94,POR,31,34,29,24,0,0,0,118,20030113
2003,DET,26,25,14,20,0,0,0,85,MIA,29,14,22,23,0,0,0,88,20030114
2003,ATL,29,20,23,16,0,0,0,88,MIL,29,22,28,18,0,0,0,97,20030114
2003,CHI,21,27,15,23,0,0,0,86,NYK,27,29,24,18,0,0,0,98,20030114
2003,PHO,26,18,21,29,6,0,0,100,SAS,20,23,28,23,14,0,0,108,20030114
2003,TOR,18,20,21,25,0,0,0,84,WAS,20,23,13,19,0,0,0,75,20030114
2003,ATL,23,10,18,15,0,0,0,66,BOS,25,22,21,18,0,0,0,86,20030115
2003,UTA,20,22,24,26,0,0,0,92,DEN,20,16,26,19,0,0,0,81,20030115
2003,CLE,24,25,17,14,0,0,0,80,GSW,32,22,22,32,0,0,0,108,20030115
2003,PHO,30,8,25,33,0,0,0,96,HOU,22,20,28,32,0,0,0,102,20030115
2003,MIA,24,18,18,21,0,0,0,81,IND,32,19,32,21,0,0,0,104,20030115
2003,MIN,23,25,20,27,0,0,0,95,LAC,13,20,20,11,0,0,0,64,20030115
2003,LAL,23,32,19,16,0,0,0,90,NOH,29,19,21,13,0,0,0,82,20030115
2003,NJN,24,20,30,33,0,0,0,107,PHI,20,34,26,28,0,0,0,108,20030115
2003,MEM,30,25,19,18,0,0,0,92,POR,29,23,26,22,0,0,0,100,20030115
2003,DAL,26,16,29,23,0,0,0,94,SAC,39,23,32,29,0,0,0,123,20030115
2003,MIL,28,31,17,23,0,0,0,99,TOR,21,22,18,26,0,0,0,87,20030115
2003,SEA,22,28,11,24,0,0,0,85,UTA,16,19,34,23,0,0,0,92,20030116
2003,ORL,22,27,22,22,0,0,0,93,WAS,38,17,19,34,0,0,0,108,20030116
2003,IND,23,28,21,21,0,0,0,93,BOS,29,28,22,19,0,0,0,98,20030117
2003,CLE,23,26,12,19,0,0,0,80,DEN,25,29,28,15,0,0,0,97,20030117
2003,NYK,25,19,11,27,0,0,0,82,DET,27,25,28,19,0,0,0,99,20030117
2003,MIN,30,23,18,27,0,0,0,98,GSW,22,29,25,31,0,0,0,107,20030117
2003,LAL,28,19,22,23,12,0,0,104,HOU,22,24,25,21,16,0,0,108,20030117
2003,TOR,19,21,13,24,0,0,0,77,NJN,22,29,23,14,0,0,0,88,20030117
2003,CHI,16,23,15,29,0,0,0,83,NOH,29,14,27,20,0,0,0,90,20030117
2003,MIL,28,32,21,18,0,0,0,99,PHI,26,19,23,27,0,0,0,95,20030117
2003,DAL,23,34,28,21,0,0,0,106,PHO,23,26,29,33,0,0,0,111,20030117
2003,ATL,20,22,20,31,0,0,0,93,SAS,26,23,22,35,0,0,0,106,20030117
2003,MEM,18,17,26,27,9,0,0,97,SEA,27,26,15,20,15,0,0,103,20030117
2003,NYK,23,26,21,25,0,0,0,95,ATL,26,19,27,20,0,0,0,92,20030118
2003,DET,16,27,22,21,0,0,0,86,IND,26,14,28,20,0,0,0,88,20030118
2003,SAC,29,25,30,23,0,0,0,107,LAC,28,20,32,32,0,0,0,112,20030118
2003,CHI,19,29,22,16,9,6,0,101,MIA,31,24,21,10,9,7,0,102,20030118
2003,BOS,27,31,20,19,0,0,0,97,MIL,29,19,17,30,0,0,0,95,20030118
2003,MIN,25,26,26,27,0,0,0,104,POR,23,30,23,22,0,0,0,98,20030118
2003,CLE,25,22,16,15,0,0,0,78,UTA,28,20,26,21,0,0,0,95,20030118
2003,PHI,23,24,24,17,0,0,0,88,WAS,19,22,20,19,0,0,0,80,20030118
2003,DAL,22,22,22,15,0,0,0,81,SEA,21,23,17,24,0,0,0,85,20030119
2003,ORL,23,32,30,16,0,0,0,101,TOR,20,26,24,23,0,0,0,93,20030119
2003,CHI,26,23,25,41,0,0,0,115,ATL,22,33,28,19,0,0,0,102,20030120
2003,IND,25,19,18,16,0,0,0,78,DET,21,16,25,26,0,0,0,88,20030120
2003,SAC,32,15,32,23,0,0,0,102,GSW,21,16,19,24,0,0,0,80,20030120
2003,LAC,24,21,25,22,0,0,0,92,LAL,26,19,24,27,0,0,0,96,20030120
2003,POR,24,24,18,33,0,0,0,99,MEM,19,23,25,20,0,0,0,87,20030120
2003,TOR,20,22,15,24,0,0,0,81,MIN,19,25,21,24,0,0,0,89,20030120
2003,PHO,28,24,20,30,0,0,0,102,NOH,26,34,23,31,0,0,0,114,20030120
2003,MIA,12,18,24,11,0,0,0,65,NYK,18,9,29,16,0,0,0,72,20030120
2003,BOS,20,18,39,23,0,0,0,100,PHI,27,31,19,22,0,0,0,99,20030120
2003,HOU,16,25,18,23,0,0,0,82,SAS,19,29,24,15,0,0,0,87,20030120
2003,NJN,19,23,27,22,12,0,0,103,UTA,21,20,25,25,15,0,0,106,20030120
2003,DEN,26,16,15,17,0,0,0,74,WAS,23,16,25,25,0,0,0,89,20030120
2003,ORL,34,27,26,16,0,0,0,103,CLE,19,29,18,28,0,0,0,94,20030121
2003,HOU,27,13,26,20,0,0,0,86,DAL,30,29,23,25,0,0,0,107,20030121
2003,NJN,18,27,25,32,0,0,0,102,SAC,29,25,30,25,0,0,0,109,20030121
2003,POR,38,22,12,24,8,8,0,112,ATL,21,28,26,21,8,6,0,110,20030122
2003,MIL,33,23,28,22,0,0,0,106,BOS,26,28,22,21,0,0,0,97,20030122
2003,PHI,19,20,20,33,0,0,0,92,DET,17,25,18,23,0,0,0,83,20030122
2003,TOR,28,24,19,27,0,0,0,98,IND,19,23,26,33,0,0,0,101,20030122
2003,GSW,27,31,28,28,0,0,0,114,LAL,30,32,22,26,0,0,0,110,20030122
2003,PHO,21,22,17,25,0,0,0,85,MIA,26,27,18,21,0,0,0,92,20030122
2003,SEA,24,23,18,26,0,0,0,91,MIN,39,15,17,25,0,0,0,96,20030122
2003,WAS,28,21,19,26,0,0,0,94,NOH,31,27,29,16,0,0,0,103,20030122
2003,DEN,25,29,13,21,0,0,0,88,NYK,27,23,24,23,0,0,0,97,20030122
2003,CHI,25,23,19,24,0,0,0,91,ORL,25,28,22,19,0,0,0,94,20030122
2003,MEM,23,20,24,31,0,0,0,98,SAS,25,21,24,23,0,0,0,93,20030122
2003,LAC,23,29,23,21,0,0,0,96,UTA,19,18,26,26,0,0,0,89,20030122
2003,NJN,20,21,29,27,0,0,0,97,GSW,20,32,29,24,0,0,0,105,20030123
2003,SAC,22,33,24,25,0,0,0,104,MEM,30,30,24,14,0,0,0,98,20030123
2003,DAL,31,17,31,28,0,0,0,107,PHI,18,22,27,27,0,0,0,94,20030123
2003,SAC,30,27,27,20,0,0,0,104,ATL,22,27,34,32,0,0,0,115,20030124
2003,DEN,11,18,16,13,0,0,0,58,BOS,24,20,12,21,0,0,0,77,20030124
2003,WAS,19,24,28,26,0,0,0,97,CHI,21,31,22,30,0,0,0,104,20030124
2003,DET,19,28,27,24,0,0,0,98,HOU,20,21,15,18,0,0,0,74,20030124
2003,SEA,22,27,21,10,0,0,0,80,IND,28,19,27,19,0,0,0,93,20030124
2003,NJN,23,14,22,30,0,0,0,89,LAL,19,21,22,21,0,0,0,83,20030124
2003,LAC,20,27,21,17,0,0,0,85,MIN,25,14,20,29,0,0,0,88,20030124
2003,POR,23,26,22,17,9,0,0,97,NOH,18,26,24,20,8,0,0,96,20030124
2003,DAL,29,17,28,27,0,0,0,101,NYK,29,24,21,16,0,0,0,90,20030124
2003,PHO,33,36,19,22,0,0,0,110,ORL,23,31,36,17,0,0,0,107,20030124
2003,SAS,22,19,21,29,0,0,0,91,UTA,24,18,27,21,0,0,0,90,20030124
2003,ATL,25,21,25,22,9,0,0,102,CLE,24,28,22,19,8,0,0,101,20030125
2003,UTA,25,22,22,26,0,0,0,95,GSW,37,24,26,21,0,0,0,108,20030125
2003,SEA,31,15,28,21,0,0,0,95,MEM,23,28,15,17,0,0,0,83,20030125
2003,PHI,22,27,22,26,0,0,0,97,MIA,26,23,25,17,0,0,0,91,20030125
2003,DEN,27,12,19,17,0,0,0,75,MIL,19,21,25,23,0,0,0,88,20030125
2003,DET,14,23,17,22,0,0,0,76,SAS,30,27,30,21,0,0,0,108,20030125
2003,MIN,20,23,31,23,0,0,0,97,WAS,30,28,16,15,0,0,0,89,20030125
2003,ORL,15,17,24,27,0,0,0,83,BOS,21,21,17,32,0,0,0,91,20030126
2003,HOU,28,29,20,21,0,0,0,98,CHI,26,23,32,19,0,0,0,100,20030126
2003,POR,19,22,27,32,0,0,0,100,DAL,31,22,13,27,0,0,0,93,20030126
2003,LAC,29,29,20,23,0,0,0,101,IND,32,26,25,25,0,0,0,108,20030126
2003,PHO,27,21,21,29,0,0,0,98,NYK,37,27,25,17,0,0,0,106,20030126
2003,SAC,21,26,27,23,0,0,0,97,TOR,27,23,24,27,0,0,0,101,20030126
2003,LAC,30,21,29,20,0,0,0,100,CLE,23,24,28,29,0,0,0,104,20030127
2003,NJN,21,20,26,25,0,0,0,92,DEN,16,10,20,20,0,0,0,66,20030127
2003,HOU,20,23,25,32,0,0,0,100,MEM,22,20,24,29,0,0,0,95,20030127
2003,IND,25,21,24,32,0,0,0,102,MIA,27,21,24,23,0,0,0,95,20030127
2003,SAS,26,25,17,27,0,0,0,95,MIN,22,29,25,30,0,0,0,106,20030127
2003,MIL,29,27,30,22,0,0,0,108,NOH,26,24,16,27,0,0,0,93,20030127
2003,PHO,21,22,21,29,0,0,0,93,WAS,26,28,20,24,0,0,0,98,20030127
2003,BOS,22,16,19,26,0,0,0,83,DET,25,19,23,19,0,0,0,86,20030128
2003,PHI,34,27,23,24,0,0,0,108,MIL,16,18,29,18,0,0,0,81,20030128
2003,ATL,26,22,27,23,0,0,0,98,NYK,34,24,19,26,0,0,0,103,20030128
2003,DEN,26,28,23,15,0,0,0,92,POR,27,26,21,24,0,0,0,98,20030128
2003,UTA,23,30,23,26,0,0,0,102,SAC,32,8,31,21,0,0,0,92,20030128
2003,GSW,20,16,25,27,0,0,0,88,SEA,22,30,15,24,0,0,0,91,20030128
2003,DAL,24,22,37,21,0,0,0,104,HOU,27,26,16,12,0,0,0,81,20030129
2003,SAS,23,34,25,24,0,0,0,106,IND,26,19,24,28,0,0,0,97,20030129
2003,CHI,24,13,19,19,0,0,0,75,LAC,17,13,21,26,0,0,0,77,20030129
2003,NYK,21,22,17,20,0,0,0,80,MIA,26,24,16,16,0,0,0,82,20030129
2003,WAS,19,24,16,19,0,0,0,78,NJN,17,22,26,21,0,0,0,86,20030129
2003,TOR,25,25,21,12,0,0,0,83,NOH,29,30,22,23,0,0,0,104,20030129
2003,CLE,24,33,25,26,0,0,0,108,ORL,22,32,30,29,0,0,0,113,20030129
2003,ATL,27,30,19,21,0,0,0,97,PHI,18,17,27,21,0,0,0,83,20030129
2003,LAL,24,26,22,27,0,0,0,99,PHO,17,22,24,27,0,0,0,90,20030129
2003,POR,20,27,15,9,0,0,0,71,UTA,17,20,29,29,0,0,0,95,20030129
2003,MIN,29,24,28,28,0,0,0,109,DAL,30,16,37,29,0,0,0,112,20030130
2003,WAS,24,23,21,22,0,0,0,90,MIL,32,21,14,30,0,0,0,97,20030130
2003,SAC,29,20,22,24,0,0,0,95,SEA,23,24,15,15,0,0,0,77,20030130
2003,CLE,27,18,21,25,0,0,0,91,ATL,30,22,21,23,0,0,0,96,20030131
2003,DET,32,29,25,32,0,0,0,118,BOS,20,14,17,15,0,0,0,66,20030131
2003,MIN,27,24,23,27,0,0,0,101,HOU,25,33,32,31,0,0,0,121,20030131
2003,PHO,18,24,26,30,0,0,0,98,LAC,24,19,26,23,0,0,0,92,20030131
2003,NYK,26,32,29,21,0,0,0,108,MEM,22,25,26,29,0,0,0,102,20030131
2003,NOH,16,21,16,19,0,0,0,72,NJN,24,20,27,18,0,0,0,89,20030131
2003,SAS,22,32,31,24,0,0,0,109,ORL,26,26,29,27,0,0,0,108,20030131
2003,MIA,22,25,25,27,0,0,0,99,PHI,33,24,19,28,0,0,0,104,20030131
2003,CHI,29,21,22,22,0,0,0,94,POR,31,23,29,24,0,0,0,107,20030131
2003,LAL,28,35,26,35,0,0,0,124,SAC,19,36,29,29,0,0,0,113,20030131
2003,IND,25,21,18,26,0,0,0,90,TOR,21,24,24,33,0,0,0,102,20030131
2003,GSW,31,21,19,23,0,0,0,94,UTA,29,30,20,23,0,0,0,102,20030131
2003,DEN,31,23,16,30,0,0,0,100,DAL,29,29,40,24,0,0,0,122,20030201
2003,NJN,25,16,20,23,0,0,0,84,DET,34,25,17,30,0,0,0,106,20030201
2003,BOS,23,29,26,22,0,0,0,100,IND,30,28,30,21,0,0,0,109,20030201
2003,UTA,14,21,29,23,0,0,0,87,LAL,23,22,28,26,0,0,0,99,20030201
2003,SAS,18,13,22,14,0,0,0,67,MIA,10,22,18,15,0,0,0,65,20030201
2003,NYK,16,26,24,34,0,0,0,100,MIL,14,29,26,38,0,0,0,107,20030201
2003,GSW,21,37,18,31,0,0,0,107,PHO,34,23,24,35,0,0,0,116,20030201
2003,CHI,22,20,12,23,0,0,0,77,SEA,21,24,25,20,0,0,0,90,20030201
2003,NOH,18,33,31,22,0,0,0,104,WAS,27,19,30,33,0,0,0,109,20030201
2003,ORL,16,20,28,25,0,0,0,89,ATL,24,23,24,26,0,0,0,97,20030202
2003,POR,34,26,31,23,0,0,0,114,CLE,16,27,29,23,0,0,0,95,20030202
2003,MEM,26,23,19,10,0,0,0,78,DEN,25,22,21,25,0,0,0,93,20030202
2003,SAC,12,20,34,23,0,0,0,89,HOU,32,27,29,17,0,0,0,105,20030202
2003,PHI,21,23,22,25,0,0,0,91,MIN,24,24,29,22,0,0,0,99,20030202
2003,LAC,20,20,27,19,0,0,0,86,TOR,14,22,35,29,0,0,0,100,20030202
2003,MEM,20,29,22,20,0,0,0,91,GSW,31,35,18,17,0,0,0,101,20030203
2003,ATL,22,19,17,21,0,0,0,79,MIA,18,24,30,27,0,0,0,99,20030203
2003,SEA,20,34,24,22,8,0,0,108,NJN,33,32,20,15,9,0,0,109,20030203
2003,BOS,21,25,22,28,0,0,0,96,NOH,28,28,18,29,0,0,0,103,20030203
2003,CHI,34,20,29,22,6,0,0,111,PHO,27,26,26,26,10,0,0,115,20030203
2003,DAL,29,22,15,26,0,0,0,92,UTA,14,28,25,23,0,0,0,90,20030203
2003,SAC,37,27,24,22,0,0,0,110,DAL,24,34,27,24,0,0,0,109,20030204
2003,CHI,22,16,23,30,9,0,0,100,DEN,20,26,20,25,11,0,0,102,20030204
2003,LAL,26,20,28,23,0,0,0,97,IND,28,20,22,24,0,0,0,94,20030204
2003,TOR,27,29,18,24,0,0,0,98,MIL,20,26,30,19,0,0,0,95,20030204
2003,HOU,21,24,22,22,0,0,0,89,MIN,25,20,29,29,0,0,0,103,20030204
2003,LAC,17,30,25,20,0,0,0,92,NYK,25,30,30,20,0,0,0,105,20030204
2003,POR,14,32,17,33,0,0,0,96,ORL,20,22,19,28,0,0,0,89,20030204
2003,CLE,29,16,21,18,0,0,0,84,WAS,31,21,18,23,0,0,0,93,20030204
2003,SEA,25,19,17,13,0,0,0,74,BOS,27,34,18,35,0,0,0,114,20030205
2003,HOU,22,23,26,31,0,0,0,102,CLE,28,26,27,24,0,0,0,105,20030205
2003,LAC,18,14,23,25,0,0,0,80,DET,21,35,21,12,0,0,0,89,20030205
2003,SAS,33,32,16,22,0,0,0,103,GSW,18,31,26,24,0,0,0,99,20030205
2003,POR,21,20,32,28,0,0,0,101,MIA,29,17,25,16,0,0,0,87,20030205
2003,SAC,26,20,19,19,0,0,0,84,NOH,32,23,30,23,0,0,0,108,20030205
2003,NJN,23,34,28,26,0,0,0,111,PHI,24,19,18,24,0,0,0,85,20030205
2003,MEM,25,24,20,15,0,0,0,84,UTA,24,18,29,34,0,0,0,105,20030205
2003,SAS,20,20,28,15,0,0,0,83,DEN,12,20,19,23,0,0,0,74,20030206
2003,SEA,25,20,23,23,0,0,0,91,MIL,23,25,19,30,0,0,0,97,20030206
2003,LAL,24,36,37,17,0,0,0,114,NYK,19,26,22,42,0,0,0,109,20030206
2003,GSW,32,32,22,30,0,0,0,116,ATL,24,22,29,38,0,0,0,113,20030211
2003,DET,24,25,24,16,0,0,0,89,CHI,14,26,26,13,0,0,0,79,20030211
2003,UTA,26,22,21,25,9,0,0,103,HOU,24,23,25,22,7,0,0,101,20030211
2003,CLE,20,24,30,22,0,0,0,96,IND,33,23,28,23,0,0,0,107,20030211
2003,DEN,22,23,21,27,0,0,0,93,LAL,32,26,42,21,0,0,0,121,20030211
2003,NOH,21,13,26,18,0,0,0,78,MIA,20,13,15,21,0,0,0,69,20030211
2003,DAL,23,18,32,25,0,0,0,98,MIN,34,24,19,23,0,0,0,100,20030211
2003,NJN,15,25,23,20,0,0,0,83,ORL,18,20,24,30,0,0,0,92,20030211
2003,LAC,26,33,18,30,0,0,0,107,PHO,30,28,23,25,0,0,0,106,20030211
2003,SAS,28,23,27,24,14,0,0,116,POR,27,17,35,23,9,0,0,111,20030211
2003,WAS,19,20,11,30,0,0,0,80,SAC,25,25,25,24,0,0,0,99,20030211
2003,BOS,29,26,7,20,0,0,0,82,SEA,20,13,15,28,0,0,0,76,20030211
2003,MIN,32,25,23,22,0,0,0,102,CLE,32,22,12,25,0,0,0,91,20030212
2003,LAL,26,44,32,11,0,0,0,113,DEN,15,23,31,33,0,0,0,102,20030212
2003,WAS,27,24,33,24,0,0,0,108,LAC,19,32,23,30,0,0,0,104,20030212
2003,NJN,8,28,24,30,0,0,0,90,MEM,25,21,17,34,0,0,0,97,20030212
2003,DAL,28,28,32,26,0,0,0,114,MIL,26,29,33,32,0,0,0,120,20030212
2003,IND,19,24,22,18,0,0,0,83,NOH,15,16,18,23,0,0,0,72,20030212
2003,GSW,29,24,29,31,0,0,0,113,NYK,30,18,26,33,0,0,0,107,20030212
2003,CHI,30,19,36,24,2,0,0,111,PHI,32,27,31,19,10,0,0,119,20030212
2003,ATL,28,18,28,22,0,0,0,96,TOR,16,32,20,29,0,0,0,97,20030212
2003,HOU,26,26,29,25,0,0,0,106,UTA,18,22,19,17,0,0,0,76,20030212
2003,ORL,26,21,15,26,0,0,0,88,DET,26,26,19,27,0,0,0,98,20030213
2003,BOS,39,12,21,28,0,0,0,100,POR,23,20,28,21,0,0,0,92,20030213
2003,MIA,26,30,14,24,0,0,0,94,HOU,18,23,20,21,0,0,0,82,20030214
2003,ATL,26,18,19,24,10,0,0,97,IND,24,31,17,15,11,0,0,98,20030214
2003,SAS,21,21,30,31,0,0,0,103,LAL,22,19,22,32,0,0,0,95,20030214
2003,DAL,31,26,28,25,0,0,0,110,MEM,29,25,22,27,0,0,0,103,20030214
2003,DET,24,25,22,15,0,0,0,86,MIL,31,20,20,25,0,0,0,96,20030214
2003,NOH,29,17,24,23,0,0,0,93,MIN,37,22,28,27,0,0,0,114,20030214
2003,CHI,14,23,17,18,0,0,0,72,NJN,25,22,28,15,0,0,0,90,20030214
2003,ORL,21,26,22,29,0,0,0,98,PHI,21,30,21,27,0,0,0,99,20030214
2003,NYK,32,31,33,20,0,0,0,116,PHO,37,30,23,25,0,0,0,115,20030214
2003,SEA,12,31,15,23,0,0,0,81,SAC,34,26,31,19,0,0,0,110,20030214
2003,GSW,28,27,26,21,16,0,0,118,TOR,24,24,21,33,12,0,0,114,20030214
2003,WAS,13,17,16,31,0,0,0,77,UTA,26,32,26,25,0,0,0,109,20030214
2003,DEN,18,19,15,17,0,0,0,69,CHI,18,18,26,26,0,0,0,88,20030215
2003,MIA,24,25,19,24,0,0,0,92,DAL,26,16,24,32,0,0,0,98,20030215
2003,BOS,23,21,22,26,0,0,0,92,LAC,21,19,25,19,0,0,0,84,20030215
2003,SEA,25,31,16,24,0,0,0,96,POR,31,23,24,23,0,0,0,101,20030215
2003,IND,20,25,20,21,0,0,0,86,ATL,29,20,23,27,0,0,0,99,20030216
2003,DET,25,26,22,17,0,0,0,90,CLE,20,18,14,23,0,0,0,75,20030216
2003,NYK,21,29,35,32,0,0,0,117,LAL,25,22,29,34,0,0,0,110,20030216
2003,MEM,13,35,30,23,0,0,0,101,MIL,24,27,20,24,0,0,0,95,20030216
2003,GSW,22,25,28,27,0,0,0,102,MIN,24,32,34,19,0,0,0,109,20030216
2003,PHI,23,21,18,28,0,0,0,90,NJN,24,23,19,17,0,0,0,83,20030216
2003,DEN,20,23,24,25,0,0,0,92,NOH,30,26,23,21,0,0,0,100,20030216
2003,BOS,28,25,26,13,0,0,0,92,PHO,27,25,26,24,0,0,0,102,20030216
2003,SAS,26,26,30,22,0,0,0,104,SAC,31,20,24,26,0,0,0,101,20030216
2003,ORL,18,20,32,27,0,0,0,97,TOR,25,28,23,23,0,0,0,99,20030216
2003,MIA,14,18,15,15,0,0,0,62,DET,26,19,31,17,0,0,0,93,20030217
2003,NYK,24,18,28,21,0,0,0,91,POR,24,23,29,23,0,0,0,99,20030217
2003,MIN,31,24,22,20,0,0,0,97,UTA,20,29,31,29,0,0,0,109,20030217
2003,CHI,39,18,29,21,0,0,0,107,CLE,27,22,27,25,0,0,0,101,20030218
2003,ATL,19,20,18,22,0,0,0,79,DAL,28,21,36,20,0,0,0,105,20030218
2003,BOS,30,39,26,30,0,0,0,125,GSW,28,21,33,35,0,0,0,117,20030218
2003,HOU,16,26,14,26,9,8,0,99,LAL,25,16,23,18,9,15,0,106,20030218
2003,IND,25,20,27,26,5,0,0,103,MEM,19,29,30,20,10,0,0,108,20030218
2003,MIA,13,26,24,16,0,0,0,79,NJN,27,20,13,24,0,0,0,84,20030218
2003,NOH,32,23,22,17,0,0,0,94,ORL,16,33,20,30,0,0,0,99,20030218
2003,MIL,28,26,23,16,0,0,0,93,SAC,26,30,21,25,0,0,0,102,20030218
2003,DEN,22,12,17,25,0,0,0,76,SAS,21,30,26,24,0,0,0,101,20030218
2003,PHI,28,19,36,27,0,0,0,110,CHI,28,25,8,21,0,0,0,82,20030219
2003,MIN,23,22,20,20,0,0,0,85,DEN,26,18,19,14,0,0,0,77,20030219
2003,MIL,28,25,24,27,0,0,0,104,LAC,34,26,20,30,0,0,0,110,20030219
2003,WAS,16,24,20,15,0,0,0,75,NOH,27,19,19,22,0,0,0,87,20030219
2003,HOU,18,32,27,30,0,0,0,107,PHO,22,18,21,28,0,0,0,89,20030219
2003,GSW,21,28,25,24,0,0,0,98,POR,44,32,22,27,0,0,0,125,20030219
2003,NYK,15,23,28,28,0,0,0,94,SEA,29,17,34,23,0,0,0,103,20030219
2003,DET,15,30,19,25,0,0,0,89,TOR,23,18,14,29,0,0,0,84,20030219
2003,LAL,25,21,18,29,0,0,0,93,UTA,20,26,16,25,0,0,0,87,20030219
2003,SAS,19,24,17,27,0,0,0,87,DAL,29,17,27,22,0,0,0,95,20030220
2003,IND,23,32,14,22,0,0,0,91,NJN,20,25,25,28,0,0,0,98,20030220
2003,BOS,18,21,20,24,0,0,0,83,SAC,29,24,29,23,0,0,0,105,20030220
2003,PHI,37,28,25,29,0,0,0,119,CLE,17,24,30,28,0,0,0,99,20030221
2003,NYK,28,29,27,23,0,0,0,107,GSW,32,29,18,32,0,0,0,111,20030221
2003,DAL,23,26,26,25,0,0,0,100,HOU,30,15,21,19,0,0,0,85,20030221
2003,POR,26,16,25,17,0,0,0,84,LAL,27,22,15,28,0,0,0,92,20030221
2003,DET,16,20,30,30,0,0,0,96,MIN,27,28,21,27,0,0,0,103,20030221
2003,MEM,25,32,29,26,11,0,0,123,NOH,34,25,27,26,13,0,0,125,20030221
2003,CHI,29,23,23,21,0,0,0,96,ORL,31,32,33,14,0,0,0,110,20030221
2003,MIL,11,25,12,10,0,0,0,58,SEA,19,29,23,17,0,0,0,88,20030221
2003,PHO,31,15,18,25,0,0,0,89,TOR,24,19,25,24,0,0,0,92,20030221
2003,NJN,21,24,23,18,0,0,0,86,WAS,20,24,25,20,0,0,0,89,20030221
2003,NOH,15,25,25,28,0,0,0,93,DET,27,22,19,23,0,0,0,91,20030222
2003,MEM,21,24,14,23,0,0,0,82,HOU,25,31,27,10,0,0,0,93,20030222
2003,ATL,16,28,28,17,0,0,0,89,LAC,27,21,19,20,0,0,0,87,20030222
2003,CHI,19,25,11,35,0,0,0,90,MIA,19,24,24,33,0,0,0,100,20030222
2003,MIL,25,23,15,30,0,0,0,93,POR,24,27,17,22,0,0,0,90,20030222
2003,IND,21,18,20,37,0,0,0,96,SAS,26,24,33,22,0,0,0,105,20030222
2003,DEN,22,19,13,35,0,0,0,89,UTA,19,22,27,31,0,0,0,99,20030222
2003,ATL,25,22,29,17,0,0,0,93,GSW,24,35,33,23,0,0,0,115,20030223
2003,SEA,28,29,22,22,0,0,0,101,LAL,24,38,23,21,0,0,0,106,20030223
2003,PHO,23,29,25,20,0,0,0,97,MIN,32,30,19,18,0,0,0,99,20030223
2003,ORL,33,28,29,23,0,0,0,113,NJN,27,23,39,16,0,0,0,105,20030223
2003,CLE,31,23,23,26,0,0,0,103,PHI,35,34,25,22,0,0,0,116,20030223
2003,NYK,21,26,20,25,0,0,0,92,SAC,21,26,27,25,0,0,0,99,20030223
2003,DAL,13,31,30,16,16,0,0,106,WAS,26,23,16,25,11,0,0,101,20030223
2003,HOU,22,28,16,22,13,0,0,101,BOS,27,27,19,15,7,0,0,95,20030224
2003,PHO,21,24,13,29,0,0,0,87,CHI,24,13,31,22,0,0,0,90,20030224
2003,GSW,17,35,23,19,0,0,0,94,DEN,22,16,29,22,0,0,0,89,20030224
2003,UTA,21,21,21,29,0,0,0,92,MEM,25,23,25,30,0,0,0,103,20030224
2003,MIN,31,29,29,28,0,0,0,117,MIL,32,19,21,42,0,0,0,114,20030224
2003,DET,22,17,20,20,0,0,0,79,SEA,27,18,14,27,0,0,0,86,20030224
2003,NJN,12,19,33,26,0,0,0,90,CLE,25,20,22,26,0,0,0,93,20030225
2003,WAS,19,19,28,17,0,0,0,83,IND,20,16,20,22,0,0,0,78,20030225
2003,LAC,21,30,21,26,0,0,0,98,LAL,26,24,28,31,0,0,0,109,20030225
2003,HOU,32,24,13,26,0,0,0,95,NYK,22,28,20,32,0,0,0,102,20030225
2003,DAL,28,27,20,18,0,0,0,93,ORL,28,21,28,21,0,0,0,98,20030225
2003,ATL,17,23,22,24,0,0,0,86,POR,29,19,18,23,0,0,0,89,20030225
2003,DET,26,11,19,19,0,0,0,75,SAC,17,20,20,24,0,0,0,81,20030225
2003,MIA,15,15,14,25,0,0,0,69,SAS,24,19,23,18,0,0,0,84,20030225
2003,IND,14,19,21,15,0,0,0,69,BOS,21,19,15,16,0,0,0,71,20030226
2003,TOR,23,23,26,23,0,0,0,95,CHI,21,21,27,34,0,0,0,103,20030226
2003,POR,23,21,19,31,0,0,0,94,DEN,22,22,27,13,0,0,0,84,20030226
2003,GSW,30,30,27,21,0,0,0,108,LAC,20,22,25,27,0,0,0,94,20030226
2003,PHO,26,31,27,34,0,0,0,118,MIL,18,33,26,35,0,0,0,112,20030226
2003,UTA,23,20,19,23,0,0,0,85,MIN,19,22,23,28,0,0,0,92,20030226
2003,NYK,21,19,20,16,0,0,0,76,NJN,25,24,26,30,0,0,0,105,20030226
2003,MIA,16,26,17,23,0,0,0,82,NOH,20,20,27,24,0,0,0,91,20030226
2003,MEM,31,29,24,23,0,0,0,107,PHI,35,28,23,25,0,0,0,111,20030226
2003,ATL,18,23,13,22,0,0,0,76,SEA,23,32,13,25,0,0,0,93,20030226
2003,SAC,27,33,34,24,8,0,0,126,DAL,21,40,33,24,6,0,0,124,20030227
2003,DET,22,19,28,16,0,0,0,85,LAL,25,21,29,20,0,0,0,95,20030227
2003,HOU,20,15,23,30,10,0,0,98,WAS,29,26,19,14,12,0,0,100,20030227
2003,TOR,23,18,19,25,0,0,0,85,BOS,27,17,23,23,0,0,0,90,20030228
2003,ATL,36,26,23,25,0,0,0,110,CHI,19,22,22,25,0,0,0,88,20030228
2003,NOH,21,25,20,28,0,0,0,94,DEN,25,21,21,21,0,0,0,88,20030228
2003,MIL,27,19,20,32,0,0,0,98,IND,26,28,32,21,0,0,0,107,20030228
2003,MIA,31,18,22,33,12,0,0,116,MEM,37,24,25,18,22,0,0,126,20030228
2003,CLE,28,22,21,24,0,0,0,95,MIN,35,32,27,24,0,0,0,118,20030228
2003,ORL,18,26,26,25,8,7,0,110,NYK,22,28,19,26,8,15,0,118,20030228
2003,UTA,28,13,22,20,0,0,0,83,PHI,24,31,27,22,0,0,0,104,20030228
2003,LAC,24,25,22,32,0,0,0,103,POR,22,26,23,38,0,0,0,109,20030228
2003,LAL,29,16,16,29,0,0,0,90,SEA,23,33,27,24,0,0,0,107,20030228
2003,MEM,28,21,17,21,0,0,0,87,DAL,32,20,28,34,0,0,0,114,20030301
2003,DET,14,27,22,27,0,0,0,90,GSW,23,17,26,26,0,0,0,92,20030301
2003,SEA,28,28,25,28,0,0,0,109,LAC,25,27,16,33,0,0,0,101,20030301
2003,NOH,29,20,18,30,0,0,0,97,PHO,21,25,25,21,0,0,0,92,20030301
2003,SAC,24,23,24,29,0,0,0,100,SAS,35,25,24,24,0,0,0,108,20030301
2003,CHI,19,27,18,29,0,0,0,93,WAS,24,15,38,24,0,0,0,101,20030301
2003,ORL,24,25,39,14,0,0,0,102,CLE,20,25,12,19,0,0,0,76,20030302
2003,PHI,22,31,28,19,0,0,0,100,DEN,29,18,21,26,0,0,0,94,20030302
2003,SAS,30,21,23,23,0,0,0,97,HOU,18,21,20,29,0,0,0,88,20030302
2003,WAS,16,22,25,20,0,0,0,83,MIA,22,23,19,29,0,0,0,93,20030302
2003,ATL,26,23,28,16,0,0,0,93,MIL,32,28,32,28,0,0,0,120,20030302
2003,NYK,14,18,23,35,0,0,0,90,MIN,31,25,19,24,0,0,0,99,20030302
2003,UTA,15,24,28,24,0,0,0,91,NJN,22,26,22,20,0,0,0,90,20030302
2003,DET,26,16,18,26,0,0,0,86,POR,22,22,34,25,0,0,0,103,20030302
2003,BOS,23,26,19,24,0,0,0,92,TOR,25,19,38,22,0,0,0,104,20030302
2003,ORL,25,25,28,26,0,0,0,104,CHI,21,27,15,26,0,0,0,89,20030303
2003,NOH,33,27,15,36,0,0,0,111,LAC,30,22,21,35,0,0,0,108,20030303
2003,BOS,36,31,20,24,0,0,0,111,MEM,29,33,22,26,0,0,0,110,20030303
2003,PHI,27,25,25,22,0,0,0,99,SAC,25,26,25,31,0,0,0,107,20030303
2003,DEN,19,21,26,20,0,0,0,86,ATL,15,28,27,22,0,0,0,92,20030304
2003,NJN,12,23,23,21,0,0,0,79,DAL,15,24,21,28,0,0,0,88,20030304
2003,HOU,16,15,30,22,0,0,0,83,DET,20,29,25,22,0,0,0,96,20030304
2003,IND,31,20,22,27,0,0,0,100,GSW,34,24,22,27,0,0,0,107,20030304
2003,MIL,25,27,21,27,0,0,0,100,MIA,22,26,22,21,0,0,0,91,20030304
2003,CLE,21,20,23,16,0,0,0,80,NYK,34,15,20,20,0,0,0,89,20030304
2003,PHO,30,23,19,32,0,0,0,104,SAS,28,19,20,30,0,0,0,97,20030304
2003,MIN,24,23,22,14,0,0,0,83,SEA,24,23,28,17,0,0,0,92,20030304
2003,TOR,24,20,21,24,0,0,0,89,WAS,25,23,16,22,0,0,0,86,20030304
2003,NYK,24,20,25,26,0,0,0,95,BOS,28,22,24,23,0,0,0,97,20030305
2003,ATL,29,30,31,21,0,0,0,111,CLE,36,19,34,16,0,0,0,105,20030305
2003,IND,16,21,32,26,0,0,0,95,LAL,18,36,20,23,0,0,0,97,20030305
2003,DEN,21,22,20,23,0,0,0,86,MEM,26,18,34,18,0,0,0,96,20030305
2003,MIL,25,19,22,33,0,0,0,99,ORL,30,28,31,22,0,0,0,111,20030305
2003,POR,20,21,26,25,0,0,0,92,PHO,30,19,24,25,0,0,0,98,20030305
2003,MIN,20,17,23,23,12,0,0,95,SAC,22,18,22,21,13,0,0,96,20030305
2003,HOU,16,24,25,32,0,0,0,97,TOR,21,26,24,24,0,0,0,95,20030305
2003,SEA,22,19,23,19,0,0,0,83,UTA,20,25,27,22,0,0,0,94,20030305
2003,LAC,24,19,8,29,0,0,0,80,WAS,26,27,26,20,0,0,0,99,20030305
2003,GSW,20,27,25,33,0,0,0,105,CHI,29,23,36,31,0,0,0,119,20030306
2003,PHI,14,20,21,33,0,0,0,88,POR,19,13,12,16,0,0,0,60,20030306
2003,NJN,16,20,17,25,0,0,0,78,SAS,18,22,23,29,0,0,0,92,20030306
2003,LAC,17,13,20,22,0,0,0,72,BOS,19,12,29,23,0,0,0,83,20030307
2003,MIN,22,21,30,23,0,0,0,96,LAL,29,24,25,28,0,0,0,106,20030307
2003,DAL,20,16,30,25,0,0,0,91,MIA,21,23,22,23,0,0,0,89,20030307
2003,CLE,17,27,9,23,0,0,0,76,NOH,31,30,18,23,0,0,0,102,20030307
2003,NYK,27,20,34,30,0,0,0,111,ORL,20,34,19,29,0,0,0,102,20030307
2003,PHI,30,25,30,23,0,0,0,108,SEA,25,23,25,26,0,0,0,99,20030307
2003,SAC,27,21,24,23,13,0,0,108,UTA,26,21,21,27,10,0,0,105,20030307
2003,MIL,24,22,19,20,0,0,0,85,WAS,22,18,19,23,0,0,0,82,20030307
2003,TOR,25,34,24,24,0,0,0,107,ATL,28,28,26,16,0,0,0,98,20030308
2003,LAC,28,31,22,22,0,0,0,103,CHI,30,17,23,27,0,0,0,97,20030308
2003,MEM,28,33,30,24,0,0,0,115,CLE,30,25,18,16,0,0,0,89,20030308
2003,UTA,14,18,21,24,0,0,0,77,DAL,22,33,26,20,0,0,0,101,20030308
2003,NJN,16,8,20,27,0,0,0,71,HOU,23,21,18,21,0,0,0,83,20030308
2003,DEN,9,31,30,28,0,0,0,98,MIA,16,27,20,29,0,0,0,92,20030308
2003,GSW,23,34,36,29,11,0,0,133,MIL,25,24,32,41,16,0,0,138,20030308
2003,IND,24,17,21,18,0,0,0,80,POR,30,22,22,20,0,0,0,94,20030308
2003,SAS,23,25,26,20,0,0,0,94,BOS,13,17,20,28,0,0,0,78,20030309
2003,GSW,22,25,28,30,0,0,0,105,DET,27,23,26,31,0,0,0,107,20030309
2003,PHI,23,25,22,22,0,0,0,92,LAL,24,29,27,26,0,0,0,106,20030309
2003,NJN,26,21,28,27,0,0,0,102,NOH,21,19,28,24,0,0,0,92,20030309
2003,WAS,21,32,21,22,0,0,0,96,NYK,26,30,26,15,0,0,0,97,20030309
2003,DEN,18,14,31,35,0,0,0,98,ORL,26,37,25,23,0,0,0,111,20030309
2003,MIN,25,32,25,23,0,0,0,105,PHO,23,37,16,22,0,0,0,98,20030309
2003,IND,22,27,24,15,0,0,0,88,SAC,34,20,30,23,0,0,0,107,20030309
2003,MEM,30,25,29,35,0,0,0,119,TOR,25,23,32,26,0,0,0,106,20030309
2003,LAC,18,21,23,24,0,0,0,86,ATL,23,22,28,22,0,0,0,95,20030310
2003,MIN,24,23,18,27,0,0,0,92,DAL,11,22,22,28,0,0,0,83,20030310
2003,UTA,15,24,27,17,0,0,0,83,MIA,12,18,27,16,0,0,0,73,20030310
2003,LAL,27,26,24,22,0,0,0,99,CHI,35,25,31,25,0,0,0,116,20030311
2003,MIA,25,22,20,10,0,0,0,77,CLE,24,18,19,14,0,0,0,75,20030311
2003,TOR,16,16,21,34,0,0,0,87,DEN,27,27,16,25,0,0,0,95,20030311
2003,PHO,29,23,21,25,0,0,0,98,GSW,32,32,20,29,0,0,0,113,20030311
2003,NOH,22,20,17,22,0,0,0,81,IND,21,15,23,12,0,0,0,71,20030311
2003,SAS,20,27,27,31,0,0,0,105,MIL,17,32,34,19,0,0,0,102,20030311
2003,MEM,17,28,18,24,0,0,0,87,NYK,20,22,24,19,0,0,0,85,20030311
2003,POR,30,12,27,23,0,0,0,92,SEA,18,30,11,18,0,0,0,77,20030311
2003,ORL,30,21,26,28,0,0,0,105,WAS,34,20,25,27,0,0,0,106,20030311
2003,MIL,22,30,19,21,0,0,0,92,ATL,31,21,31,28,0,0,0,111,20030312
2003,NOH,15,15,17,18,0,0,0,65,BOS,25,22,23,23,0,0,0,93,20030312
2003,LAL,29,16,24,19,0,0,0,88,DET,18,31,25,37,0,0,0,111,20030312
2003,LAC,28,26,27,23,10,0,0,114,HOU,26,29,25,24,14,0,0,118,20030312
2003,CHI,29,31,20,15,0,0,0,95,MEM,41,33,24,26,0,0,0,124,20030312
2003,SAS,26,22,30,33,0,0,0,111,MIN,17,19,30,33,0,0,0,99,20030312
2003,UTA,26,32,30,23,0,0,0,111,ORL,24,25,39,20,0,0,0,108,20030312
2003,IND,25,19,23,26,0,0,0,93,PHI,22,17,23,34,0,0,0,96,20030312
2003,TOR,27,20,16,40,0,0,0,103,POR,28,37,32,28,0,0,0,125,20030312
2003,BOS,18,19,21,17,0,0,0,75,NJN,20,27,25,18,0,0,0,90,20030313
2003,SAC,19,23,25,17,0,0,0,84,PHO,20,29,31,29,0,0,0,109,20030313
2003,DAL,26,29,23,22,0,0,0,100,SEA,24,35,19,29,0,0,0,107,20030313
2003,NYK,20,33,23,28,0,0,0,104,ATL,27,24,30,26,0,0,0,107,20030314
2003,WAS,17,18,21,24,0,0,0,80,DET,25,21,27,17,0,0,0,90,20030314
2003,DAL,30,23,36,27,0,0,0,116,GSW,33,26,25,30,0,0,0,114,20030314
2003,CHI,11,22,34,24,0,0,0,91,HOU,33,22,34,32,0,0,0,121,20030314
2003,UTA,11,18,24,28,0,0,0,81,IND,20,29,25,27,0,0,0,101,20030314
2003,NOH,19,21,23,24,0,0,0,87,MIA,22,26,14,21,0,0,0,83,20030314
2003,LAL,30,26,29,21,0,0,0,106,MIN,30,27,22,20,0,0,0,99,20030314
2003,POR,22,19,20,18,0,0,0,79,PHI,27,21,16,26,0,0,0,90,20030314
2003,TOR,16,23,29,16,0,0,0,84,SAC,30,30,32,27,0,0,0,119,20030314
2003,LAC,28,16,23,29,0,0,0,96,SAS,31,28,30,18,0,0,0,107,20030314
2003,BOS,24,24,13,20,0,0,0,81,DET,15,22,20,14,0,0,0,71,20030315
2003,LAL,29,20,23,26,0,0,0,98,MIL,29,35,8,22,0,0,0,94,20030315
2003,NOH,27,14,23,22,0,0,0,86,ORL,27,20,25,24,0,0,0,96,20030315
2003,GSW,26,21,21,26,0,0,0,94,SEA,29,19,18,22,0,0,0,88,20030315
2003,MIA,20,28,15,19,0,0,0,82,WAS,21,27,22,19,0,0,0,89,20030315
2003,UTA,28,18,23,26,0,0,0,95,CLE,27,30,30,35,0,0,0,122,20030316
2003,SEA,24,32,17,19,0,0,0,92,DEN,22,23,19,20,0,0,0,84,20030316
2003,PHO,19,12,24,20,0,0,0,75,HOU,25,30,9,21,0,0,0,85,20030316
2003,TOR,35,27,24,24,0,0,0,110,LAC,30,32,26,23,0,0,0,111,20030316
2003,ATL,21,20,29,22,0,0,0,92,MEM,39,31,28,26,0,0,0,124,20030316
2003,POR,26,18,23,28,0,0,0,95,MIN,23,25,26,37,0,0,0,111,20030316
2003,PHI,24,17,29,22,0,0,0,92,NJN,25,27,20,15,0,0,0,87,20030316
2003,MIL,28,35,24,24,0,0,0,111,NYK,28,41,21,30,0,0,0,120,20030316
2003,DAL,33,26,27,25,18,0,0,129,SAC,23,32,27,29,12,0,0,123,20030316
2003,CHI,28,19,26,24,0,0,0,97,SAS,26,33,17,32,0,0,0,108,20030316
2003,POR,25,28,14,28,0,0,0,95,IND,15,24,19,30,0,0,0,88,20030317
2003,LAL,23,12,35,32,0,0,0,102,LAC,29,14,25,17,0,0,0,85,20030317
2003,TOR,26,22,21,18,4,0,0,91,PHO,19,22,25,21,8,0,0,95,20030317
2003,NJN,22,33,23,9,0,0,0,87,BOS,23,20,15,16,0,0,0,74,20030318
2003,ATL,27,12,18,21,0,0,0,78,CHI,20,31,25,27,0,0,0,103,20030318
2003,CLE,26,26,21,20,0,0,0,93,DAL,28,25,33,28,0,0,0,114,20030318
2003,PHI,28,26,18,31,0,0,0,103,MIA,18,19,23,23,0,0,0,83,20030318
2003,MEM,21,16,24,19,0,0,0,80,MIN,25,18,27,26,0,0,0,96,20030318
2003,GSW,34,17,30,10,0,0,0,91,SAC,29,27,32,29,0,0,0,117,20030318
2003,NYK,23,19,27,36,0,0,0,105,SAS,27,28,23,19,0,0,0,97,20030318
2003,HOU,20,23,25,26,0,0,0,94,SEA,18,29,31,22,0,0,0,100,20030318
2003,DEN,16,22,21,22,0,0,0,81,UTA,27,25,28,19,0,0,0,99,20030318
2003,DET,15,22,20,27,10,0,0,94,WAS,22,17,22,23,6,0,0,90,20030318
2003,SEA,27,25,26,21,0,0,0,99,GSW,21,32,28,24,0,0,0,105,20030319
2003,BOS,13,14,26,19,0,0,0,72,IND,29,24,26,23,0,0,0,102,20030319
2003,DEN,22,12,20,24,0,0,0,78,LAC,18,23,25,25,0,0,0,91,20030319
2003,CLE,22,30,29,20,0,0,0,101,MEM,40,26,29,33,0,0,0,128,20030319
2003,MIL,24,30,19,31,0,0,0,104,NJN,27,20,26,12,0,0,0,85,20030319
2003,NYK,30,23,21,22,0,0,0,96,NOH,30,25,23,23,0,0,0,101,20030319
2003,MIA,29,21,26,17,0,0,0,93,ORL,32,27,29,21,0,0,0,109,20030319
2003,UTA,28,16,27,28,0,0,0,99,PHO,21,22,21,22,0,0,0,86,20030319
2003,HOU,14,23,29,17,0,0,0,83,POR,25,18,29,22,0,0,0,94,20030319
2003,ATL,20,26,25,15,0,0,0,86,TOR,22,21,20,24,0,0,0,87,20030319
2003,SAS,23,26,33,20,10,0,0,112,DAL,21,32,23,26,8,0,0,110,20030320
2003,PHI,18,20,18,29,0,0,0,85,DET,29,30,27,27,0,0,0,113,20030320
2003,LAL,17,25,26,31,0,0,0,99,SAC,25,20,21,41,0,0,0,107,20030320
2003,HOU,29,24,35,29,0,0,0,117,GSW,22,26,24,35,0,0,0,107,20030321
2003,MEM,26,29,21,16,0,0,0,92,IND,16,27,32,26,0,0,0,101,20030321
2003,BOS,26,26,17,27,0,0,0,96,LAL,23,18,34,29,0,0,0,104,20030321
2003,TOR,24,21,25,28,0,0,0,98,MIA,22,33,25,27,0,0,0,107,20030321
2003,MIL,26,18,27,27,0,0,0,98,NOH,32,38,20,23,0,0,0,113,20030321
2003,DET,32,22,14,25,0,0,0,93,NYK,26,24,25,22,0,0,0,97,20030321
2003,CLE,22,18,24,21,0,0,0,85,ORL,25,27,32,25,0,0,0,109,20030321
2003,ATL,24,30,29,31,0,0,0,114,PHI,29,26,24,26,0,0,0,105,20030321
2003,WAS,15,19,23,26,0,0,0,83,PHO,26,25,28,30,0,0,0,109,20030321
2003,MIN,23,19,23,24,12,0,0,101,SAS,30,24,17,18,5,0,0,94,20030321
2003,DEN,22,20,27,22,8,0,0,99,SEA,18,21,24,28,10,0,0,101,20030321
2003,IND,28,20,18,23,0,0,0,89,ATL,22,26,25,19,0,0,0,92,20030322
2003,NYK,21,28,21,28,0,0,0,98,CHI,29,27,20,24,0,0,0,100,20030322
2003,PHO,24,30,22,19,0,0,0,95,DAL,26,14,29,33,0,0,0,102,20030322
2003,BOS,26,12,19,23,0,0,0,80,DEN,18,23,30,19,0,0,0,90,20030322
2003,NOH,29,17,15,24,0,0,0,85,MIL,25,24,15,29,0,0,0,93,20030322
2003,MEM,29,14,32,24,0,0,0,99,NJN,35,29,21,22,0,0,0,107,20030322
2003,SAC,21,28,42,22,0,0,0,113,POR,31,22,22,29,0,0,0,104,20030322
2003,LAC,13,13,13,34,0,0,0,73,UTA,20,25,21,22,0,0,0,88,20030322
2003,NJN,36,17,19,16,0,0,0,88,CLE,25,26,20,22,0,0,0,93,20030323
2003,CHI,24,19,19,20,0,0,0,82,DET,21,28,33,23,0,0,0,105,20030323
2003,WAS,31,37,23,16,0,0,0,107,GSW,35,28,25,25,0,0,0,113,20030323
2003,ORL,32,23,29,12,0,0,0,96,MIA,23,19,21,11,0,0,0,74,20030323
2003,HOU,25,23,25,35,0,0,0,108,SAC,28,29,29,23,0,0,0,109,20030323
2003,LAL,16,20,17,36,0,0,0,89,SAS,22,17,30,29,0,0,0,98,20030323
2003,PHI,28,27,31,26,0,0,0,112,TOR,28,30,19,18,0,0,0,95,20030323
2003,DAL,33,32,18,25,0,0,0,108,DEN,30,20,22,24,0,0,0,96,20030324
2003,HOU,34,29,22,23,0,0,0,108,LAC,18,21,26,25,0,0,0,90,20030324
2003,TOR,28,21,15,26,0,0,0,90,NYK,22,28,21,29,0,0,0,100,20030324
2003,MEM,31,29,28,22,0,0,0,110,ORL,34,27,22,21,0,0,0,104,20030324
2003,SEA,23,12,26,21,0,0,0,82,PHO,20,17,16,20,0,0,0,73,20030324
2003,BOS,28,24,16,23,0,0,0,91,UTA,27,22,24,23,0,0,0,96,20030324
2003,LAL,30,18,31,29,0,0,0,108,ATL,28,23,21,19,0,0,0,91,20030325
2003,GSW,27,32,19,25,0,0,0,103,CLE,36,24,31,33,0,0,0,124,20030325
2003,MIA,23,23,24,21,0,0,0,91,MIN,30,26,31,21,0,0,0,108,20030325
2003,WAS,23,24,24,24,0,0,0,95,POR,15,24,23,29,0,0,0,91,20030325
2003,MIL,22,20,27,25,0,0,0,94,SAS,24,28,33,22,0,0,0,107,20030325
2003,GSW,29,26,26,26,0,0,0,107,BOS,28,27,19,21,0,0,0,95,20030326
2003,MIA,18,23,18,15,0,0,0,74,CHI,29,24,17,12,0,0,0,82,20030326
2003,MIL,20,19,23,41,0,0,0,103,DEN,24,26,31,27,0,0,0,108,20030326
2003,ATL,28,22,24,19,6,0,0,99,DET,18,20,25,30,9,0,0,102,20030326
2003,LAL,22,19,25,30,0,0,0,96,HOU,24,14,26,29,0,0,0,93,20030326
2003,PHI,20,18,20,33,0,0,0,91,IND,26,18,19,22,0,0,0,85,20030326
2003,DAL,20,36,22,36,0,0,0,114,LAC,23,29,23,32,0,0,0,107,20030326
2003,PHO,23,32,23,23,0,0,0,101,MEM,31,23,23,22,0,0,0,99,20030326
2003,NYK,24,20,30,21,0,0,0,95,NJN,23,29,22,27,0,0,0,101,20030326
2003,ORL,17,25,24,31,0,0,0,97,NOH,32,28,16,19,0,0,0,95,20030326
2003,WAS,28,14,20,18,0,0,0,80,SEA,19,25,13,17,0,0,0,74,20030326
2003,CLE,20,14,19,30,0,0,0,83,TOR,27,15,25,22,0,0,0,89,20030326
2003,POR,18,18,13,36,0,0,0,85,UTA,27,21,22,24,0,0,0,94,20030326
2003,MIN,33,27,26,21,0,0,0,107,ORL,25,26,30,29,0,0,0,110,20030327
2003,LAC,17,15,15,36,0,0,0,83,SAC,27,22,26,18,0,0,0,93,20030327
2003,HOU,22,15,24,24,0,0,0,85,SAS,23,25,31,19,0,0,0,98,20030327
2003,CLE,25,22,26,22,0,0,0,95,BOS,37,13,25,29,0,0,0,104,20030328
2003,PHO,31,25,16,22,0,0,0,94,DET,33,12,24,22,0,0,0,91,20030328
2003,CHI,28,18,22,21,0,0,0,89,IND,39,35,31,35,0,0,0,140,20030328
2003,WAS,28,20,21,25,0,0,0,94,LAL,27,32,28,21,0,0,0,108,20030328
2003,MIN,35,14,16,19,0,0,0,84,MIA,19,29,28,35,0,0,0,111,20030328
2003,NJN,38,36,23,25,0,0,0,122,NYK,28,29,23,21,0,0,0,101,20030328
2003,GSW,33,33,21,15,0,0,0,102,PHI,24,19,32,23,0,0,0,98,20030328
2003,DAL,21,23,27,24,0,0,0,95,POR,19,32,44,17,0,0,0,112,20030328
2003,MEM,13,19,17,22,0,0,0,71,SEA,26,24,23,22,0,0,0,95,20030328
2003,NOH,25,32,21,23,0,0,0,101,TOR,26,23,25,18,0,0,0,92,20030328
2003,MIL,19,24,22,25,0,0,0,90,UTA,23,19,35,26,0,0,0,103,20030328
2003,PHI,23,33,25,29,0,0,0,110,ATL,19,23,23,24,0,0,0,89,20030329
2003,SAC,22,31,36,18,0,0,0,107,CHI,32,18,26,16,0,0,0,92,20030329
2003,BOS,23,30,33,24,0,0,0,110,CLE,26,21,23,36,0,0,0,106,20030329
2003,DEN,25,21,22,21,0,0,0,89,HOU,27,24,30,21,0,0,0,102,20030329
2003,GSW,22,27,29,19,0,0,0,97,NJN,28,27,26,28,0,0,0,109,20030329
2003,UTA,23,18,17,23,0,0,0,81,SAS,28,22,28,23,0,0,0,101,20030329
2003,WAS,25,19,13,15,0,0,0,72,DEN,16,20,28,24,0,0,0,88,20030330
2003,SAC,33,24,20,11,0,0,0,88,DET,19,27,21,32,0,0,0,99,20030330
2003,PHO,26,18,19,18,0,0,0,81,IND,29,21,24,18,0,0,0,92,20030330
2003,MEM,20,30,24,26,0,0,0,100,LAC,27,25,21,29,0,0,0,102,20030330
2003,MIA,18,30,19,20,0,0,0,87,MIL,36,25,25,23,0,0,0,109,20030330
2003,DAL,33,29,38,19,0,0,0,119,MIN,27,20,24,24,0,0,0,95,20030330
2003,SAS,25,25,16,26,0,0,0,92,NOH,25,24,16,25,0,0,0,90,20030330
2003,LAL,22,14,35,27,0,0,0,98,SEA,23,34,36,26,0,0,0,119,20030330
2003,NYK,25,15,12,34,0,0,0,86,TOR,32,18,21,24,0,0,0,95,20030330
2003,MEM,20,20,28,26,0,0,0,94,LAL,30,24,25,31,0,0,0,110,20030331
2003,MIL,20,25,19,27,0,0,0,91,MIA,21,13,28,24,0,0,0,86,20030331
2003,HOU,20,27,21,18,0,0,0,86,NJN,27,27,30,26,0,0,0,110,20030331
2003,PHI,32,25,22,31,8,0,0,118,ORL,27,32,25,26,3,0,0,113,20030331
2003,SEA,13,32,22,20,14,0,0,101,CHI,24,16,21,26,7,0,0,94,20030401
2003,NOH,22,23,17,24,0,0,0,86,DAL,21,31,23,20,0,0,0,95,20030401
2003,SAC,17,26,23,37,0,0,0,103,IND,23,29,14,32,0,0,0,98,20030401
2003,UTA,26,20,21,27,0,0,0,94,LAC,14,23,29,23,0,0,0,89,20030401
2003,DEN,14,16,19,16,0,0,0,65,PHO,28,16,24,27,0,0,0,95,20030401
2003,GSW,34,12,18,22,0,0,0,86,POR,31,24,27,18,0,0,0,100,20030401
2003,ORL,34,22,19,30,0,0,0,105,SAS,34,31,28,25,0,0,0,118,20030401
2003,DET,20,27,27,18,0,0,0,92,TOR,15,19,22,29,0,0,0,85,20030401
2003,MIA,18,10,16,18,0,0,0,62,BOS,27,19,27,17,0,0,0,90,20030402
2003,IND,25,29,30,19,0,0,0,103,CLE,18,26,19,19,0,0,0,82,20030402
2003,NYK,20,23,13,27,0,0,0,83,DEN,22,18,22,13,0,0,0,75,20030402
2003,TOR,24,27,23,15,0,0,0,89,DET,19,17,20,22,0,0,0,78,20030402
2003,SAS,29,20,34,22,0,0,0,105,MEM,25,15,27,20,0,0,0,87,20030402
2003,HOU,30,22,21,26,0,0,0,99,MIL,20,32,24,30,0,0,0,106,20030402
2003,SEA,27,20,20,19,0,0,0,86,MIN,31,18,23,19,0,0,0,91,20030402
2003,NJN,22,19,20,36,0,0,0,97,NOH,19,30,30,27,0,0,0,106,20030402
2003,CHI,24,29,15,33,0,0,0,101,PHI,35,14,29,30,0,0,0,108,20030402
2003,SAC,34,23,27,21,0,0,0,105,WAS,29,15,26,29,0,0,0,99,20030402
2003,WAS,21,25,18,25,0,0,0,89,ATL,28,25,20,18,0,0,0,91,20030403
2003,LAL,27,22,25,26,0,0,0,100,DAL,21,28,18,22,0,0,0,89,20030403
2003,UTA,23,25,19,26,0,0,0,93,POR,16,20,28,24,0,0,0,88,20030403
2003,SAC,29,27,14,23,0,0,0,93,BOS,20,20,25,27,0,0,0,92,20030404
2003,IND,25,21,34,18,0,0,0,98,DET,31,23,24,14,0,0,0,92,20030404
2003,POR,31,29,37,25,0,0,0,122,GSW,31,22,24,23,0,0,0,100,20030404
2003,LAL,25,23,18,36,0,0,0,102,MEM,29,27,33,12,0,0,0,101,20030404
2003,CLE,21,22,24,26,0,0,0,93,MIL,22,23,22,28,0,0,0,95,20030404
2003,MIA,19,22,20,22,0,0,0,83,NJN,20,27,29,23,0,0,0,99,20030404
2003,HOU,23,13,27,25,0,0,0,88,PHI,22,25,17,15,0,0,0,79,20030404
2003,LAC,20,20,34,19,0,0,0,93,SEA,30,15,27,29,0,0,0,101,20030404
2003,SAS,30,36,30,28,0,0,0,124,TOR,17,20,30,31,0,0,0,98,20030404
2003,NYK,26,26,18,20,4,0,0,94,UTA,27,24,21,18,2,0,0,92,20030404
2003,MEM,21,21,22,27,0,0,0,91,ATL,24,27,32,14,0,0,0,97,20030405
2003,MIL,30,25,30,20,10,0,0,115,CHI,21,24,27,33,12,0,0,117,20030405
2003,NOH,25,14,17,20,0,0,0,76,CLE,21,22,17,19,0,0,0,79,20030405
2003,ORL,20,22,31,17,0,0,0,90,DAL,33,30,30,15,0,0,0,108,20030405
2003,NYK,32,17,31,18,0,0,0,98,LAC,27,27,29,26,0,0,0,109,20030405
2003,MIN,25,19,29,21,0,0,0,94,PHO,27,21,37,26,0,0,0,111,20030405
2003,WAS,23,26,20,22,8,0,0,99,BOS,26,19,26,20,7,0,0,98,20030406
2003,SAS,27,20,21,21,0,0,0,89,DET,19,22,12,30,0,0,0,83,20030406
2003,DEN,29,22,19,29,0,0,0,99,GSW,33,28,19,26,0,0,0,106,20030406
2003,ORL,25,23,17,28,0,0,0,93,HOU,32,26,27,29,0,0,0,114,20030406
2003,MIA,17,20,11,21,0,0,0,69,IND,26,18,29,17,0,0,0,90,20030406
2003,PHO,30,23,28,25,7,0,0,113,LAL,32,24,27,23,9,0,0,115,20030406
2003,SAC,22,22,28,25,0,0,0,97,PHI,16,23,19,23,0,0,0,81,20030406
2003,MIN,24,17,24,32,0,0,0,97,POR,16,20,24,18,0,0,0,78,20030406
2003,UTA,23,15,22,20,0,0,0,80,SEA,12,23,25,22,0,0,0,82,20030406
2003,NJN,28,21,29,18,0,0,0,96,TOR,27,19,19,22,0,0,0,87,20030406
2003,IND,28,28,29,18,0,0,0,103,CHI,34,20,31,30,0,0,0,115,20030408
2003,WAS,29,23,24,24,0,0,0,100,CLE,25,26,20,20,0,0,0,91,20030408
2003,PHO,24,25,18,31,0,0,0,98,DEN,24,16,22,16,0,0,0,78,20030408
2003,UTA,26,29,24,23,0,0,0,102,GSW,30,37,28,33,0,0,0,128,20030408
2003,POR,19,25,15,22,0,0,0,81,HOU,23,18,10,15,0,0,0,66,20030408
2003,DAL,22,28,25,24,0,0,0,99,LAL,22,25,29,32,0,0,0,108,20030408
2003,LAC,26,33,26,23,0,0,0,108,MEM,30,30,23,28,0,0,0,111,20030408
2003,TOR,25,27,18,13,0,0,0,83,MIA,19,26,27,17,0,0,0,89,20030408
2003,ATL,21,21,23,30,0,0,0,95,NYK,25,27,27,20,0,0,0,99,20030408
2003,DET,22,21,15,16,0,0,0,74,PHI,25,29,21,16,0,0,0,91,20030408
2003,SEA,25,14,24,22,0,0,0,85,SAC,23,28,27,29,0,0,0,107,20030408
2003,NJN,17,21,21,33,0,0,0,92,ATL,23,29,21,24,0,0,0,97,20030409
2003,CHI,25,22,20,28,7,0,0,102,DET,31,22,26,16,16,0,0,111,20030409
2003,LAC,21,20,28,23,0,0,0,92,MIL,28,34,25,25,0,0,0,112,20030409
2003,CLE,17,25,17,22,0,0,0,81,NOH,28,29,30,13,0,0,0,100,20030409
2003,TOR,23,20,15,24,0,0,0,82,ORL,28,21,30,9,0,0,0,88,20030409
2003,DAL,25,19,26,19,0,0,0,89,PHO,36,21,29,26,0,0,0,112,20030409
2003,POR,13,22,22,22,0,0,0,79,SAS,21,26,16,21,0,0,0,84,20030409
2003,MIN,24,22,24,22,0,0,0,92,SEA,19,25,24,32,0,0,0,100,20030409
2003,HOU,17,11,18,27,0,0,0,73,UTA,24,18,22,30,0,0,0,94,20030409
2003,BOS,28,26,19,14,0,0,0,87,WAS,22,24,22,15,0,0,0,83,20030409
2003,PHI,20,23,36,20,0,0,0,99,BOS,24,20,22,12,0,0,0,78,20030410
2003,SAC,27,26,26,25,0,0,0,104,LAL,25,29,35,28,0,0,0,117,20030410
2003,CLE,12,23,23,31,0,0,0,89,ATL,28,24,30,27,0,0,0,109,20030411
2003,NJN,23,18,29,16,0,0,0,86,CHI,26,24,16,29,0,0,0,95,20030411
2003,ORL,17,28,27,26,0,0,0,98,IND,27,19,19,21,0,0,0,86,20030411
2003,POR,34,20,21,18,0,0,0,93,MEM,20,27,32,17,0,0,0,96,20030411
2003,WAS,28,28,19,16,0,0,0,91,MIA,21,28,15,23,0,0,0,87,20030411
2003,LAC,20,20,25,25,0,0,0,90,MIN,26,23,36,21,0,0,0,106,20030411
2003,DET,23,23,17,26,0,0,0,89,NOH,27,23,20,23,0,0,0,93,20030411
2003,PHI,29,21,21,32,0,0,0,103,NYK,27,22,23,36,0,0,0,108,20030411
2003,GSW,36,23,23,19,0,0,0,101,PHO,33,31,21,32,0,0,0,117,20030411
2003,DEN,33,23,23,24,0,0,0,103,SAC,31,25,22,27,0,0,0,105,20030411
2003,SEA,20,19,25,22,0,0,0,86,SAS,31,22,18,23,0,0,0,94,20030411
2003,MIL,25,25,27,28,0,0,0,105,TOR,27,24,24,28,0,0,0,103,20030411
2003,DAL,19,26,21,26,0,0,0,92,UTA,24,21,23,27,0,0,0,95,20030411
2003,NYK,23,27,29,13,7,0,0,99,CLE,22,23,24,23,12,0,0,104,20030412
2003,GSW,26,32,22,28,0,0,0,108,DAL,33,29,27,28,0,0,0,117,20030412
2003,LAC,30,25,18,28,0,0,0,101,DEN,16,18,20,25,0,0,0,79,20030412
2003,SEA,23,25,16,22,0,0,0,86,HOU,27,23,33,18,0,0,0,101,20030412
2003,TOR,26,19,20,21,0,0,0,86,NJN,26,32,26,10,0,0,0,94,20030412
2003,BOS,28,12,23,23,0,0,0,86,ORL,24,22,19,24,0,0,0,89,20030412
2003,ATL,29,23,26,23,0,0,0,101,WAS,21,25,26,28,0,0,0,100,20030412
2003,DET,23,23,20,27,7,10,0,110,MEM,25,25,22,21,7,7,0,107,20030413
2003,BOS,25,29,23,17,0,0,0,94,MIA,17,26,23,20,0,0,0,86,20030413
2003,IND,24,25,21,28,0,0,0,98,MIL,28,21,29,29,0,0,0,107,20030413
2003,CHI,25,21,21,28,0,0,0,95,MIN,30,26,37,26,0,0,0,119,20030413
2003,NOH,19,22,26,27,0,0,0,94,PHI,28,25,18,18,0,0,0,89,20030413
2003,SAS,20,18,24,23,0,0,0,85,PHO,15,28,27,22,0,0,0,92,20030413
2003,LAL,23,20,25,31,0,0,0,99,POR,30,22,21,28,0,0,0,101,20030413
2003,ORL,20,23,16,25,0,0,0,84,ATL,25,21,28,26,0,0,0,100,20030414
2003,SEA,27,27,26,26,0,0,0,106,DAL,26,19,30,34,0,0,0,109,20030414
2003,CLE,28,24,16,20,0,0,0,88,DET,22,29,20,18,0,0,0,89,20030414
2003,LAC,33,35,31,23,0,0,0,122,GSW,28,30,32,23,0,0,0,113,20030414
2003,NOH,18,25,23,21,0,0,0,87,NJN,19,19,25,11,0,0,0,74,20030414
2003,SAS,20,24,25,22,0,0,0,91,UTA,23,14,17,29,0,0,0,83,20030414
2003,NYK,22,18,28,25,0,0,0,93,WAS,17,20,26,16,0,0,0,79,20030414
2003,PHI,18,30,30,28,0,0,0,106,CHI,35,24,33,23,0,0,0,115,20030415
2003,MEM,18,22,19,27,0,0,0,86,HOU,31,23,19,24,0,0,0,97,20030415
2003,DEN,24,17,32,31,0,0,0,104,LAL,42,27,34,23,0,0,0,126,20030415
2003,IND,23,33,23,30,0,0,0,109,NYK,26,28,14,25,0,0,0,93,20030415
2003,PHO,30,23,21,28,0,0,0,102,POR,28,38,36,18,0,0,0,120,20030415
2003,MIA,19,29,21,34,0,0,0,103,TOR,26,25,26,22,0,0,0,99,20030415
2003,DET,18,32,23,19,0,0,0,92,BOS,28,22,23,26,0,0,0,99,20030416
2003,TOR,21,22,22,21,0,0,0,86,CLE,21,29,22,24,0,0,0,96,20030416
2003,HOU,19,23,29,18,0,0,0,89,DEN,22,22,20,20,0,0,0,84,20030416
2003,LAL,28,32,31,26,0,0,0,117,GSW,26,30,31,24,0,0,0,111,20030416
2003,NJN,19,18,23,23,0,0,0,83,IND,19,17,27,27,0,0,0,90,20030416
2003,POR,17,30,25,21,0,0,0,93,LAC,24,28,25,30,0,0,0,107,20030416
2003,MIN,26,21,27,21,0,0,0,95,MEM,19,24,22,22,0,0,0,87,20030416
2003,ORL,22,21,27,17,0,0,0,87,MIL,32,16,27,18,0,0,0,93,20030416
2003,ATL,20,23,22,12,0,0,0,77,NOH,18,20,33,21,0,0,0,92,20030416
2003,WAS,20,26,18,23,0,0,0,87,PHI,31,25,33,18,0,0,0,107,20030416
2003,UTA,26,19,17,22,0,0,0,84,SAC,19,18,33,25,0,0,0,95,20030416
2003,DAL,30,15,27,21,0,0,0,93,SAS,20,21,19,12,0,0,0,72,20030416
2003,PHO,13,18,17,22,0,0,0,70,SEA,18,23,22,21,0,0,0,84,20030416
2003,POR,21,31,12,22,0,0,0,86,DAL,23,19,28,26,0,0,0,96,20030419
2003,BOS,26,26,17,34,0,0,0,103,IND,29,29,21,21,0,0,0,100,20030419
2003,MIL,20,15,25,36,0,0,0,96,NJN,29,26,34,20,0,0,0,109,20030419
2003,UTA,25,8,21,36,0,0,0,90,SAC,19,19,23,35,0,0,0,96,20030419
2003,PHO,16,19,25,27,9,0,0,96,SAS,23,17,23,24,8,0,0,95,20030419
2003,ORL,24,25,27,23,0,0,0,99,DET,19,21,32,22,0,0,0,94,20030420
2003,LAL,39,27,22,29,0,0,0,117,MIN,23,29,24,22,0,0,0,98,20030420
2003,NOH,20,24,24,22,0,0,0,90,PHI,27,22,21,28,0,0,0,98,20030420
2003,BOS,24,24,17,12,0,0,0,77,IND,33,21,16,19,0,0,0,89,20030421
2003,UTA,22,20,22,31,0,0,0,95,SAC,25,32,25,26,0,0,0,108,20030421
2003,PHO,23,18,21,14,0,0,0,76,SAS,16,31,16,21,0,0,0,84,20030421
2003,LAL,23,20,24,24,0,0,0,91,MIN,28,29,31,31,0,0,0,119,20030422
2003,MIL,26,23,22,17,0,0,0,88,NJN,26,23,20,16,0,0,0,85,20030422
2003,POR,19,23,29,28,0,0,0,99,DAL,23,25,24,31,0,0,0,103,20030423
2003,ORL,14,26,21,16,0,0,0,77,DET,31,23,16,19,0,0,0,89,20030423
2003,NOH,22,16,28,19,0,0,0,85,PHI,27,23,26,14,0,0,0,90,20030423
2003,IND,15,29,14,25,0,0,0,83,BOS,31,17,27,26,0,0,0,101,20030424
2003,MIN,29,23,28,21,13,0,0,114,LAL,24,22,25,30,9,0,0,110,20030424
2003,NJN,30,24,25,24,0,0,0,103,MIL,20,19,32,30,0,0,0,101,20030424
2003,DET,29,17,17,17,0,0,0,80,ORL,19,29,25,16,0,0,0,89,20030425
2003,SAS,25,28,16,30,0,0,0,99,PHO,18,18,20,30,0,0,0,86,20030425
2003,DAL,30,34,20,31,0,0,0,115,POR,22,39,24,18,0,0,0,103,20030425
2003,NJN,26,26,23,25,14,0,0,114,MIL,25,26,36,13,19,0,0,119,20030426
2003,PHI,27,19,19,20,0,0,0,85,NOH,27,20,21,31,0,0,0,99,20030426
2003,SAC,26,29,21,28,0,0,0,104,UTA,30,29,21,27,0,0,0,107,20030426
2003,IND,25,23,14,30,0,0,0,92,BOS,19,17,37,29,0,0,0,102,20030427
2003,MIN,26,19,29,23,0,0,0,97,LAL,25,18,28,31,0,0,0,102,20030427
2003,DET,29,21,17,25,0,0,0,92,ORL,19,35,27,19,0,0,0,100,20030427
2003,SAS,17,23,23,21,0,0,0,84,PHO,19,15,22,30,0,0,0,86,20030427
2003,DAL,23,29,10,17,0,0,0,79,POR,26,23,33,16,0,0,0,98,20030427
2003,PHI,25,27,22,22,0,0,0,96,NOH,20,25,21,21,0,0,0,87,20030428
2003,SAC,20,17,36,26,0,0,0,99,UTA,28,13,18,23,0,0,0,82,20030428
2003,BOS,24,26,21,17,0,0,0,88,IND,22,26,14,26,5,0,0,93,20030429
2003,LAL,28,30,36,26,0,0,0,120,MIN,25,23,25,17,0,0,0,90,20030429
2003,MIL,22,16,23,21,0,0,0,82,NJN,20,24,17,28,0,0,0,89,20030429
2003,PHO,14,16,23,29,0,0,0,82,SAS,27,27,18,22,0,0,0,94,20030429
2003,POR,15,28,28,32,0,0,0,103,DAL,21,29,27,22,0,0,0,99,20030430
2003,ORL,13,24,20,10,0,0,0,67,DET,26,24,23,25,0,0,0,98,20030430
2003,NOH,26,21,24,22,0,0,0,93,PHI,29,21,24,17,0,0,0,91,20030430
2003,UTA,15,26,27,23,0,0,0,91,SAC,29,24,32,26,0,0,0,111,20030430
2003,IND,15,19,24,32,0,0,0,90,BOS,33,17,29,31,0,0,0,110,20030501
2003,MIN,30,13,20,22,0,0,0,85,LAL,25,22,22,32,0,0,0,101,20030501
2003,NJN,30,26,32,25,0,0,0,113,MIL,18,26,26,31,0,0,0,101,20030501
2003,SAS,25,16,23,23,0,0,0,87,PHO,21,22,18,24,0,0,0,85,20030501
2003,PHI,25,27,31,24,0,0,0,107,NOH,31,24,32,16,0,0,0,103,20030502
2003,DET,30,24,23,26,0,0,0,103,ORL,21,24,21,22,0,0,0,88,20030502
2003,DAL,24,14,28,37,0,0,0,103,POR,27,37,33,28,0,0,0,125,20030502
2003,POR,22,23,28,22,0,0,0,95,DAL,19,26,26,36,0,0,0,107,20030504
2003,ORL,22,24,18,29,0,0,0,93,DET,27,31,27,23,0,0,0,108,20030504
2003,BOS,23,23,27,20,0,0,0,93,NJN,20,29,23,25,0,0,0,97,20030505
2003,LAL,16,19,17,30,0,0,0,82,SAS,20,18,22,27,0,0,0,87,20030505
2003,SAC,33,29,36,26,0,0,0,124,DAL,24,26,26,37,0,0,0,113,20030506
2003,PHI,21,19,26,21,0,0,0,87,DET,24,25,24,25,0,0,0,98,20030506
2003,BOS,25,20,21,29,0,0,0,95,NJN,19,32,31,22,0,0,0,104,20030507
2003,LAL,18,25,24,28,0,0,0,95,SAS,31,29,34,20,0,0,0,114,20030507
2003,SAC,40,21,24,25,0,0,0,110,DAL,44,39,30,19,0,0,0,132,20030508
2003,PHI,25,19,27,21,5,0,0,97,DET,30,22,19,21,12,0,0,104,20030508
2003,NJN,24,23,29,18,0,0,0,94,BOS,15,24,17,20,0,0,0,76,20030509
2003,SAS,17,19,31,28,0,0,0,95,LAL,29,21,31,29,0,0,0,110,20030509
2003,DET,19,18,15,31,0,0,0,83,PHI,23,25,21,24,0,0,0,93,20030510
2003,DAL,23,39,20,31,12,16,0,141,SAC,36,28,27,22,12,12,0,137,20030510
2003,SAS,24,22,21,28,0,0,0,95,LAL,19,20,32,28,0,0,0,99,20030511
2003,DET,18,14,21,29,0,0,0,82,PHI,21,22,18,34,0,0,0,95,20030511
2003,DAL,20,17,24,22,0,0,0,83,SAC,24,28,29,18,0,0,0,99,20030511
2003,NJN,21,29,21,19,7,13,0,110,BOS,23,26,20,21,7,4,0,101,20030512
2003,SAC,33,28,10,22,0,0,0,93,DAL,24,30,29,29,0,0,0,112,20030513
2003,LAL,18,20,26,30,0,0,0,94,SAS,29,27,24,16,0,0,0,96,20030513
2003,PHI,23,13,21,20,0,0,0,77,DET,30,15,18,15,0,0,0,78,20030514
2003,SAS,29,25,24,32,0,0,0,110,LAL,25,25,19,13,0,0,0,82,20030515
2003,DAL,24,28,35,22,0,0,0,109,SAC,21,36,32,26,0,0,0,115,20030515
2003,DET,15,21,27,18,12,0,0,93,PHI,24,20,20,17,8,0,0,89,20030516
2003,SAC,19,24,24,32,0,0,0,99,DAL,23,25,28,36,0,0,0,112,20030517
2003,NJN,22,21,12,21,0,0,0,76,DET,16,20,27,11,0,0,0,74,20030518
2003,DAL,23,34,26,30,0,0,0,113,SAS,36,30,25,19,0,0,0,110,20030519
2003,NJN,20,19,19,30,0,0,0,88,DET,19,23,25,19,0,0,0,86,20030520
2003,DAL,24,20,31,31,0,0,0,106,SAS,35,34,25,25,0,0,0,119,20030521
2003,DET,23,23,19,20,0,0,0,85,NJN,28,29,23,17,0,0,0,97,20030522
2003,SAS,18,20,31,27,0,0,0,96,DAL,18,28,20,17,0,0,0,83,20030523
2003,DET,23,18,23,18,0,0,0,82,NJN,28,22,23,29,0,0,0,102,20030524
2003,SAS,21,26,30,25,0,0,0,102,DAL,24,28,18,25,0,0,0,95,20030525
2003,DAL,23,24,27,29,0,0,0,103,SAS,30,28,23,10,0,0,0,91,20030527
2003,SAS,22,18,16,34,0,0,0,90,DAL,22,24,23,9,0,0,0,78,20030529
2003,NJN,21,21,17,30,0,0,0,89,SAS,18,24,32,27,0,0,0,101,20030604
2003,NJN,19,22,25,21,0,0,0,87,SAS,18,17,21,29,0,0,0,85,20030606
2003,SAS,15,18,21,30,0,0,0,84,NJN,21,9,27,22,0,0,0,79,20030608
2003,SAS,18,16,23,19,0,0,0,76,NJN,16,29,11,21,0,0,0,77,20030611
2003,SAS,19,23,24,27,0,0,0,93,NJN,18,16,23,26,0,0,0,83,20030613
2003,NJN,25,16,22,14,0,0,0,77,SAS,17,21,19,31,0,0,0,88,20030615
2004,DAL,15,30,22,26,0,0,0,93,LAL,29,26,31,23,0,0,0,109,20031028
2004,MIA,19,20,23,12,0,0,0,74,PHI,24,20,21,24,0,0,0,89,20031028
2004,PHO,28,14,26,14,0,0,0,82,SAS,19,19,29,16,0,0,0,83,20031028
2004,MIA,15,24,22,14,0,0,0,75,BOS,20,29,30,19,0,0,0,98,20031029
2004,WAS,20,23,26,30,0,0,0,99,CHI,15,16,26,17,0,0,0,74,20031029
2004,SAS,20,16,15,21,0,0,0,72,DEN,20,19,24,17,0,0,0,80,20031029
2004,IND,19,27,26,17,0,0,0,89,DET,20,24,22,21,0,0,0,87,20031029
2004,DAL,22,27,17,29,0,0,0,95,GSW,14,33,17,23,0,0,0,87,20031029
2004,MIL,16,25,25,23,0,0,0,89,MIN,27,27,17,24,0,0,0,95,20031029
2004,ATL,17,23,12,23,8,0,0,83,NOH,14,19,25,17,13,0,0,88,20031029
2004,ORL,17,17,17,22,12,0,0,85,NYK,19,15,25,14,10,0,0,83,20031029
2004,CLE,32,20,26,14,0,0,0,92,SAC,39,26,18,23,0,0,0,106,20031029
2004,NJN,21,26,20,20,0,0,0,87,TOR,17,21,26,26,0,0,0,90,20031029
2004,POR,23,28,19,22,0,0,0,92,UTA,18,25,23,33,0,0,0,99,20031029
2004,DEN,20,22,18,25,0,0,0,85,HOU,22,26,24,30,0,0,0,102,20031030
2004,NOH,27,23,34,16,0,0,0,100,ORL,27,24,27,20,0,0,0,98,20031030
2004,CLE,31,18,24,13,0,0,0,86,PHO,30,23,19,23,0,0,0,95,20031030
2004,LAC,17,25,27,31,0,0,0,100,SEA,20,24,39,26,0,0,0,109,20031030
2004,ATL,21,21,26,26,0,0,0,94,CHI,29,19,24,28,0,0,0,100,20031031
2004,MIL,17,32,25,19,0,0,0,93,IND,19,17,20,23,0,0,0,79,20031031
2004,SEA,35,31,27,31,0,0,0,124,LAC,30,28,22,25,0,0,0,105,20031031
2004,BOS,27,17,26,23,0,0,0,93,MEM,29,18,22,22,0,0,0,91,20031031
2004,DET,22,25,29,17,0,0,0,93,MIA,14,24,24,19,0,0,0,81,20031031
2004,MIN,10,20,22,9,0,0,0,61,NJN,24,20,17,23,0,0,0,84,20031031
2004,PHI,23,20,23,23,0,0,0,89,SAC,27,26,27,20,0,0,0,100,20031031
2004,WAS,21,16,23,19,0,0,0,79,TOR,11,16,26,29,0,0,0,82,20031031
2004,IND,15,20,32,23,13,0,0,103,ATL,26,23,18,23,9,0,0,99,20031101
2004,UTA,26,18,31,27,0,0,0,102,DAL,29,27,41,30,0,0,0,127,20031101
2004,SAC,25,30,23,10,0,0,0,88,DEN,34,32,21,22,0,0,0,109,20031101
2004,PHI,27,20,22,21,0,0,0,90,GSW,25,30,24,25,0,0,0,104,20031101
2004,MEM,22,12,17,28,0,0,0,79,HOU,13,20,23,15,0,0,0,71,20031101
2004,CHI,21,21,12,14,0,0,0,68,MIL,16,27,29,26,0,0,0,98,20031101
2004,TOR,12,20,10,14,0,0,0,56,MIN,20,21,18,14,0,0,0,73,20031101
2004,BOS,33,15,31,11,0,0,0,90,NOH,31,25,24,17,0,0,0,97,20031101
2004,DET,23,32,12,29,0,0,0,96,ORL,23,21,28,13,0,0,0,85,20031101
2004,LAL,32,24,23,24,0,0,0,103,PHO,19,28,27,25,0,0,0,99,20031101
2004,CLE,23,16,28,18,0,0,0,85,POR,23,31,22,28,0,0,0,104,20031101
2004,NYK,17,21,18,18,0,0,0,74,SAS,21,27,19,19,0,0,0,86,20031101
2004,NJN,22,23,24,29,0,0,0,98,WAS,15,21,29,20,0,0,0,85,20031101
2004,GSW,19,13,23,17,0,0,0,72,LAL,24,19,25,19,0,0,0,87,20031102
2004,NOH,21,20,19,20,0,0,0,80,ATL,32,18,19,21,0,0,0,90,20031103
2004,HOU,29,26,22,21,0,0,0,98,CHI,22,13,13,18,0,0,0,66,20031103
2004,MIA,26,24,14,29,0,0,0,93,DAL,25,23,26,29,0,0,0,103,20031103
2004,SAS,27,17,18,18,0,0,0,80,MEM,16,29,19,24,0,0,0,88,20031103
2004,NYK,17,24,15,19,0,0,0,75,ORL,19,12,21,16,0,0,0,68,20031103
2004,PHI,25,25,19,25,0,0,0,94,POR,26,15,19,23,0,0,0,83,20031103
2004,MIN,16,23,30,19,0,0,0,88,UTA,25,19,19,30,0,0,0,93,20031103
2004,DEN,10,24,7,19,0,0,0,60,IND,18,21,21,11,0,0,0,71,20031104
2004,LAL,27,30,26,30,0,0,0,113,MIL,18,36,32,21,0,0,0,107,20031104
2004,HOU,22,15,20,29,0,0,0,86,NJN,21,23,18,13,0,0,0,75,20031104
2004,MIA,12,29,18,14,0,0,0,73,SAS,18,24,19,19,0,0,0,80,20031104
2004,DEN,27,19,31,16,0,0,0,93,CLE,16,28,20,25,0,0,0,89,20031105
2004,BOS,30,24,16,18,0,0,0,88,DET,23,22,28,23,0,0,0,96,20031105
2004,ATL,21,24,19,8,0,0,0,72,GSW,29,22,27,21,0,0,0,99,20031105
2004,SAC,23,28,36,23,15,0,0,125,MIN,29,29,28,24,11,0,0,121,20031105
2004,MIL,21,23,33,29,0,0,0,106,NYK,34,16,23,17,0,0,0,90,20031105
2004,CHI,28,26,24,28,0,0,0,106,ORL,24,34,16,26,0,0,0,100,20031105
2004,NOH,17,26,23,23,17,0,0,106,PHI,20,22,25,22,10,0,0,99,20031105
2004,MEM,16,16,25,30,0,0,0,87,POR,28,22,23,20,0,0,0,93,20031105
2004,PHO,23,17,16,24,0,0,0,80,UTA,32,14,27,18,0,0,0,91,20031105
2004,DAL,25,18,22,25,0,0,0,90,WAS,30,29,22,19,0,0,0,100,20031105
2004,IND,22,26,16,23,0,0,0,87,NJN,23,12,19,27,0,0,0,81,20031106
2004,LAL,24,22,30,25,8,11,0,120,SAS,21,28,29,23,8,8,0,117,20031106
2004,DAL,22,18,17,14,0,0,0,71,TOR,20,22,16,19,0,0,0,77,20031106
2004,NJN,28,26,15,25,0,0,0,94,BOS,26,17,27,17,0,0,0,87,20031107
2004,PHI,32,21,28,25,0,0,0,106,CHI,24,20,19,22,0,0,0,85,20031107
2004,LAC,25,27,16,20,16,0,0,104,DEN,33,16,24,15,14,0,0,102,20031107
2004,MIL,23,22,33,21,0,0,0,99,DET,34,26,25,20,0,0,0,105,20031107
2004,UTA,13,18,31,27,0,0,0,89,GSW,34,20,20,21,0,0,0,95,20031107
2004,CLE,22,24,23,21,0,0,0,90,IND,31,20,23,17,0,0,0,91,20031107
2004,LAL,18,37,22,18,0,0,0,95,NOH,25,36,33,20,0,0,0,114,20031107
2004,SAC,24,27,36,24,0,0,0,111,NYK,25,18,37,34,0,0,0,114,20031107
2004,MIN,29,24,33,14,0,0,0,100,ORL,20,17,23,11,0,0,0,71,20031107
2004,MEM,18,23,23,24,0,0,0,88,PHO,27,19,28,22,0,0,0,96,20031107
2004,POR,24,24,18,16,0,0,0,82,SEA,23,27,32,18,0,0,0,100,20031107
2004,TOR,19,4,15,22,0,0,0,60,WAS,22,29,19,16,0,0,0,86,20031107
2004,WAS,23,24,26,25,0,0,0,98,CLE,25,21,29,36,0,0,0,111,20031108
2004,ORL,26,25,22,13,0,0,0,86,HOU,29,28,22,17,0,0,0,96,20031108
2004,MIN,21,19,28,20,0,0,0,88,MIA,24,17,16,22,0,0,0,79,20031108
2004,NYK,20,28,21,18,0,0,0,87,MIL,27,18,23,22,0,0,0,90,20031108
2004,CHI,24,30,31,24,0,0,0,109,NOH,26,27,27,26,0,0,0,106,20031108
2004,ATL,24,18,22,19,0,0,0,83,POR,31,20,17,22,0,0,0,90,20031108
2004,DAL,27,26,12,16,0,0,0,81,SAS,21,23,23,11,0,0,0,78,20031108
2004,MEM,21,29,20,19,0,0,0,89,UTA,26,20,28,22,0,0,0,96,20031108
2004,SAC,25,20,24,13,0,0,0,82,BOS,26,13,34,18,0,0,0,91,20031109
2004,NJN,26,21,23,14,0,0,0,84,DET,20,28,27,23,0,0,0,98,20031109
2004,IND,26,17,16,26,0,0,0,85,PHI,15,26,23,10,0,0,0,74,20031109
2004,ATL,28,24,23,16,0,0,0,91,SEA,20,17,24,20,0,0,0,81,20031109
2004,DEN,13,32,18,13,0,0,0,76,TOR,26,24,20,19,0,0,0,89,20031109
2004,DEN,29,22,15,39,0,0,0,105,CHI,22,23,27,25,0,0,0,97,20031110
2004,NYK,20,19,26,15,0,0,0,80,CLE,32,24,18,20,0,0,0,94,20031110
2004,PHO,23,25,29,22,0,0,0,99,GSW,23,27,20,26,0,0,0,96,20031110
2004,LAL,29,25,15,26,0,0,0,95,MEM,29,32,24,20,0,0,0,105,20031110
2004,UTA,24,9,18,27,0,0,0,78,SAS,17,24,24,22,0,0,0,87,20031110
2004,NOH,24,30,16,27,0,0,0,97,DAL,39,25,31,30,0,0,0,125,20031111
2004,MIA,16,20,20,14,0,0,0,70,HOU,16,27,22,25,0,0,0,90,20031111
2004,BOS,18,16,25,19,0,0,0,78,IND,26,22,14,14,0,0,0,76,20031111
2004,ATL,32,21,25,25,0,0,0,103,LAC,33,25,26,31,0,0,0,115,20031111
2004,SEA,25,25,11,28,0,0,0,89,MIN,26,22,20,19,0,0,0,87,20031111
2004,TOR,17,23,20,20,0,0,0,80,POR,16,30,24,13,0,0,0,83,20031111
2004,DET,17,26,27,21,0,0,0,91,SAC,22,28,25,22,0,0,0,97,20031111
2004,PHI,25,25,32,30,0,0,0,112,WAS,31,26,23,25,0,0,0,105,20031111
2004,CHI,23,24,18,24,0,0,0,89,BOS,21,23,19,19,0,0,0,82,20031112
2004,DET,23,23,22,10,7,0,0,85,GSW,24,18,20,16,9,0,0,87,20031112
2004,TOR,18,25,17,19,0,0,0,79,LAL,22,31,21,20,0,0,0,94,20031112
2004,CLE,26,20,19,18,0,0,0,83,MIA,27,21,24,16,0,0,0,88,20031112
2004,SEA,25,26,27,26,0,0,0,104,MIL,18,33,25,23,0,0,0,99,20031112
2004,SAS,21,28,14,22,0,0,0,85,NJN,20,13,23,15,0,0,0,71,20031112
2004,UTA,23,16,29,21,0,0,0,89,NOH,22,30,26,18,0,0,0,96,20031112
2004,MEM,24,31,25,27,0,0,0,107,ORL,26,23,29,19,0,0,0,97,20031112
2004,ATL,32,17,24,26,0,0,0,99,PHO,24,21,27,22,0,0,0,94,20031112
2004,MIN,17,22,27,16,10,0,0,92,CHI,21,26,18,17,7,0,0,89,20031113
2004,HOU,18,26,27,15,0,0,0,86,DAL,20,30,31,16,0,0,0,97,20031113
2004,SAC,34,29,21,21,5,0,0,110,POR,18,27,37,23,7,0,0,112,20031113
2004,CLE,20,22,22,18,0,0,0,82,BOS,23,29,22,17,0,0,0,91,20031114
2004,ORL,24,35,17,25,0,0,0,101,DEN,15,35,26,30,0,0,0,106,20031114
2004,LAC,27,33,27,17,0,0,0,104,GSW,19,28,27,24,0,0,0,98,20031114
2004,PHO,21,27,17,20,0,0,0,85,HOU,24,18,22,26,0,0,0,90,20031114
2004,SEA,29,13,18,18,0,0,0,78,IND,32,19,24,26,0,0,0,101,20031114
2004,DET,20,25,22,22,0,0,0,89,LAL,26,19,22,27,0,0,0,94,20031114
2004,WAS,23,27,16,27,8,0,0,101,MIA,25,22,24,22,12,0,0,105,20031114
2004,UTA,26,21,18,20,0,0,0,85,MIN,16,18,20,23,0,0,0,77,20031114
2004,NYK,18,13,28,21,0,0,0,80,NJN,22,15,22,26,0,0,0,85,20031114
2004,SAS,22,25,25,24,0,0,0,96,PHI,18,25,26,31,0,0,0,100,20031114
2004,TOR,20,16,10,18,0,0,0,64,SAC,30,12,25,27,0,0,0,94,20031114
2004,NJN,20,29,27,24,0,0,0,100,ATL,21,19,22,23,0,0,0,85,20031115
2004,SEA,24,28,26,20,0,0,0,98,CHI,27,24,19,20,0,0,0,90,20031115
2004,PHI,17,25,23,17,6,0,0,88,CLE,24,21,26,11,9,0,0,91,20031115
2004,ORL,30,25,18,19,0,0,0,92,LAC,19,31,25,20,0,0,0,95,20031115
2004,DAL,21,25,32,17,6,0,0,101,MEM,31,17,24,23,13,0,0,108,20031115
2004,UTA,22,21,22,30,0,0,0,95,MIL,24,25,24,27,0,0,0,100,20031115
2004,POR,23,26,16,14,0,0,0,79,NOH,25,25,23,28,0,0,0,101,20031115
2004,IND,34,22,13,26,0,0,0,95,NYK,19,29,27,19,0,0,0,94,20031115
2004,DET,24,28,17,31,0,0,0,100,PHO,21,21,28,21,0,0,0,91,20031115
2004,SAS,17,24,29,25,0,0,0,95,WAS,26,9,14,22,0,0,0,71,20031115
2004,MIA,21,15,22,19,0,0,0,77,LAL,31,22,23,23,0,0,0,99,20031116
2004,GSW,21,38,16,29,0,0,0,104,SAC,26,25,25,30,0,0,0,106,20031116
2004,HOU,16,21,24,22,6,8,0,97,TOR,24,16,19,24,6,12,0,101,20031116
2004,WAS,20,27,17,42,0,0,0,106,ATL,19,26,19,33,0,0,0,97,20031117
2004,POR,24,26,24,24,0,0,0,98,DAL,23,23,31,28,0,0,0,105,20031117
2004,BOS,28,26,18,14,0,0,0,86,NYK,18,20,28,23,0,0,0,89,20031117
2004,HOU,20,26,13,15,0,0,0,74,PHI,17,19,13,17,0,0,0,66,20031117
2004,ORL,25,25,21,17,0,0,0,88,UTA,25,20,24,21,0,0,0,90,20031117
2004,LAC,14,22,33,26,0,0,0,95,CLE,25,33,20,25,0,0,0,103,20031118
2004,LAL,23,26,25,22,0,0,0,96,DET,25,29,19,33,0,0,0,106,20031118
2004,ATL,29,27,25,20,0,0,0,101,MIL,25,22,20,26,0,0,0,93,20031118
2004,DEN,11,17,18,30,0,0,0,76,MIN,18,24,26,21,0,0,0,89,20031118
2004,NOH,30,19,23,16,0,0,0,88,NJN,21,33,19,12,0,0,0,85,20031118
2004,CHI,23,24,19,16,0,0,0,82,PHO,29,28,20,18,0,0,0,95,20031118
2004,GSW,24,16,21,20,0,0,0,81,SAS,25,25,20,24,0,0,0,94,20031118
2004,MIA,26,25,25,29,0,0,0,105,SEA,28,23,28,19,0,0,0,98,20031118
2004,NOH,20,19,18,24,0,0,0,81,BOS,16,15,21,21,0,0,0,73,20031119
2004,MIL,24,12,31,19,0,0,0,86,DEN,26,29,17,22,0,0,0,94,20031119
2004,GSW,16,24,25,18,0,0,0,83,HOU,19,25,20,21,0,0,0,85,20031119
2004,LAC,25,17,23,13,0,0,0,78,IND,26,21,22,22,0,0,0,91,20031119
2004,DET,20,29,28,22,0,0,0,99,MEM,27,25,15,25,0,0,0,92,20031119
2004,LAL,32,19,29,24,0,0,0,104,NYK,24,25,18,16,0,0,0,83,20031119
2004,MIA,18,31,26,18,0,0,0,93,POR,25,23,13,33,0,0,0,94,20031119
2004,PHI,20,24,18,19,0,0,0,81,TOR,21,24,13,17,0,0,0,75,20031119
2004,SAC,34,31,21,32,0,0,0,118,UTA,29,26,27,28,0,0,0,110,20031119
2004,CLE,21,28,21,25,0,0,0,95,WAS,35,19,21,31,0,0,0,106,20031119
2004,SAS,25,22,17,28,0,0,0,92,DAL,21,25,27,22,0,0,0,95,20031120
2004,ORL,29,20,15,25,0,0,0,89,PHO,27,21,27,21,0,0,0,96,20031120
2004,MIN,26,29,20,22,0,0,0,97,CLE,21,25,15,22,0,0,0,83,20031121
2004,WAS,21,25,17,24,0,0,0,87,DEN,21,32,30,25,0,0,0,108,20031121
2004,NYK,16,24,26,19,0,0,0,85,DET,29,22,23,20,0,0,0,94,20031121
2004,MIA,23,28,16,24,0,0,0,91,GSW,30,22,29,20,0,0,0,101,20031121
2004,CHI,21,34,19,20,0,0,0,94,LAL,27,23,23,28,0,0,0,101,20031121
2004,IND,15,27,21,13,0,0,0,76,NOH,23,15,26,11,0,0,0,75,20031121
2004,BOS,24,27,15,19,0,0,0,85,PHI,24,18,23,22,0,0,0,87,20031121
2004,HOU,27,12,18,21,0,0,0,78,POR,16,26,22,21,0,0,0,85,20031121
2004,ORL,24,20,28,20,0,0,0,92,SAC,34,26,35,27,0,0,0,122,20031121
2004,ATL,13,21,23,18,0,0,0,75,SAS,37,31,23,23,0,0,0,114,20031121
2004,MEM,29,20,22,27,0,0,0,98,SEA,27,29,23,18,0,0,0,97,20031121
2004,MIL,18,28,22,22,0,0,0,90,UTA,22,29,23,25,0,0,0,99,20031121
2004,CLE,24,23,19,17,0,0,0,83,ATL,28,24,21,19,0,0,0,92,20031122
2004,DEN,25,35,20,21,0,0,0,101,DAL,32,22,32,29,0,0,0,115,20031122
2004,LAC,19,22,29,21,0,0,0,91,MIN,34,20,26,23,0,0,0,103,20031122
2004,TOR,18,32,19,12,0,0,0,81,NJN,18,16,25,21,0,0,0,80,20031122
2004,PHI,21,21,22,24,0,0,0,88,NYK,24,23,33,19,0,0,0,99,20031122
2004,MIA,36,14,23,25,0,0,0,98,PHO,29,26,21,24,0,0,0,100,20031122
2004,NOH,17,25,18,21,0,0,0,81,DET,21,23,16,20,0,0,0,80,20031123
2004,POR,21,20,16,15,0,0,0,72,GSW,24,15,20,19,0,0,0,78,20031123
2004,MEM,28,20,19,22,0,0,0,89,LAL,29,30,31,31,0,0,0,121,20031123
2004,CHI,38,11,14,36,0,0,0,99,SAC,34,35,23,18,0,0,0,110,20031123
2004,WAS,12,12,28,33,0,0,0,85,SEA,21,15,24,28,0,0,0,88,20031123
2004,MIL,20,26,20,16,0,0,0,82,TOR,18,16,14,14,0,0,0,62,20031123
2004,DET,23,24,20,27,0,0,0,94,ATL,25,29,19,16,0,0,0,89,20031124
2004,NYK,15,26,34,19,0,0,0,94,BOS,24,27,12,25,0,0,0,88,20031124
2004,HOU,21,34,18,32,0,0,0,105,LAC,17,24,25,24,0,0,0,90,20031124
2004,IND,20,28,17,24,0,0,0,89,ORL,20,23,13,22,0,0,0,78,20031124
2004,CHI,29,23,20,26,0,0,0,98,DAL,36,25,41,22,0,0,0,124,20031125
2004,PHO,25,17,19,19,0,0,0,80,DEN,26,23,30,31,0,0,0,110,20031125
2004,MIN,13,19,29,14,0,0,0,75,IND,29,21,23,25,0,0,0,98,20031125
2004,NOH,22,17,27,21,0,0,0,87,MIA,23,27,23,18,0,0,0,91,20031125
2004,PHI,25,18,26,22,0,0,0,91,MIL,27,23,22,23,0,0,0,95,20031125
2004,WAS,23,20,16,22,0,0,0,81,POR,24,23,11,22,0,0,0,80,20031125
2004,MEM,35,22,14,18,0,0,0,89,SAC,24,32,31,22,0,0,0,109,20031125
2004,NJN,22,14,28,29,0,0,0,93,SEA,25,20,14,11,0,0,0,70,20031125
2004,TOR,16,23,23,27,10,0,0,99,ATL,24,24,22,19,8,0,0,97,20031126
2004,WAS,21,15,33,30,0,0,0,99,LAL,31,30,31,28,0,0,0,120,20031126
2004,NYK,21,27,19,30,0,0,0,97,MIN,19,20,30,23,0,0,0,92,20031126
2004,CLE,23,13,17,19,0,0,0,72,NOH,22,20,24,16,0,0,0,82,20031126
2004,BOS,28,21,20,25,0,0,0,94,ORL,26,23,20,23,0,0,0,92,20031126
2004,DET,24,24,23,15,0,0,0,86,PHI,25,31,13,21,0,0,0,90,20031126
2004,DAL,23,24,23,20,0,0,0,90,PHO,26,37,32,26,0,0,0,121,20031126
2004,CHI,22,22,19,35,0,0,0,98,SAS,22,27,26,34,0,0,0,109,20031126
2004,HOU,19,15,17,25,0,0,0,76,UTA,20,13,21,29,0,0,0,83,20031126
2004,NYK,19,21,19,11,0,0,0,70,IND,26,26,26,15,0,0,0,93,20031127
2004,NJN,19,26,27,30,0,0,0,102,LAC,25,12,29,30,0,0,0,96,20031127
2004,MIA,24,19,10,30,0,0,0,83,ATL,24,20,27,24,0,0,0,95,20031128
2004,MIL,24,21,24,27,0,0,0,96,BOS,28,30,26,22,0,0,0,106,20031128
2004,DAL,24,29,24,26,0,0,0,103,DEN,32,25,23,33,0,0,0,113,20031128
2004,CLE,24,21,24,19,0,0,0,88,DET,33,19,19,21,0,0,0,92,20031128
2004,PHI,14,24,22,17,0,0,0,77,IND,22,28,27,13,0,0,0,90,20031128
2004,SAS,16,18,21,32,0,0,0,87,LAL,25,22,37,19,0,0,0,103,20031128
2004,MIN,27,24,25,26,0,0,0,102,MEM,24,20,28,26,0,0,0,98,20031128
2004,TOR,17,24,27,19,0,0,0,87,ORL,21,19,18,28,0,0,0,86,20031128
2004,GSW,26,23,21,22,0,0,0,92,PHO,20,15,26,22,0,0,0,83,20031128
2004,NJN,25,24,24,20,0,0,0,93,POR,26,16,25,30,0,0,0,97,20031128
2004,HOU,14,14,29,17,0,0,0,74,SAC,25,29,25,24,0,0,0,103,20031128
2004,SEA,21,18,18,24,0,0,0,81,UTA,25,24,24,25,0,0,0,98,20031128
2004,MEM,14,27,23,35,10,13,0,122,CLE,35,22,23,19,10,6,0,115,20031129
2004,MIN,29,19,20,20,0,0,0,88,DAL,26,18,25,23,0,0,0,92,20031129
2004,SAS,20,21,26,22,0,0,0,89,GSW,17,29,22,23,0,0,0,91,20031129
2004,DEN,32,27,24,15,0,0,0,98,LAC,17,24,25,20,0,0,0,86,20031129
2004,TOR,16,10,18,22,0,0,0,66,MIA,18,21,19,20,0,0,0,78,20031129
2004,BOS,12,33,28,21,0,0,0,94,MIL,22,16,29,33,0,0,0,100,20031129
2004,NOH,23,14,21,16,0,0,0,74,NYK,21,21,19,18,0,0,0,79,20031129
2004,ATL,22,22,24,18,0,0,0,86,PHI,28,18,26,26,0,0,0,98,20031129
2004,HOU,29,27,15,17,0,0,0,88,SEA,26,26,18,25,0,0,0,95,20031129
2004,DET,22,19,16,23,0,0,0,80,WAS,28,18,9,14,0,0,0,69,20031129
2004,IND,17,20,14,26,0,0,0,77,LAL,23,23,22,31,0,0,0,99,20031130
2004,NJN,16,12,38,26,0,0,0,92,SAC,31,29,27,18,0,0,0,105,20031130
2004,MEM,19,25,27,25,0,0,0,96,BOS,23,20,27,19,0,0,0,89,20031201
2004,MIL,27,16,26,18,0,0,0,87,CHI,19,30,19,29,0,0,0,97,20031201
2004,SAS,18,14,19,32,0,0,0,83,LAC,18,28,16,29,0,0,0,91,20031201
2004,DET,16,21,12,21,9,0,0,79,NYK,27,20,9,14,8,0,0,78,20031201
2004,IND,22,22,17,28,0,0,0,89,PHO,25,19,18,20,0,0,0,82,20031201
2004,NJN,16,15,25,28,0,0,0,84,UTA,22,16,28,25,0,0,0,91,20031201
2004,MIL,26,25,26,29,0,0,0,106,ATL,24,19,25,26,0,0,0,94,20031202
2004,WAS,17,20,21,14,0,0,0,72,DAL,24,24,27,22,0,0,0,97,20031202
2004,CLE,26,34,16,27,0,0,0,103,DEN,32,24,26,33,0,0,0,115,20031202
2004,NOH,23,25,27,25,0,0,0,100,ORL,29,17,20,25,0,0,0,91,20031202
2004,TOR,23,28,22,22,0,0,0,95,PHI,19,22,26,21,0,0,0,88,20031202
2004,MIA,18,16,23,16,0,0,0,73,DET,32,20,16,19,0,0,0,87,20031203
2004,DEN,39,18,30,30,0,0,0,117,GSW,27,35,23,24,0,0,0,109,20031203
2004,UTA,28,15,28,23,7,0,0,101,HOU,15,29,23,27,13,0,0,107,20031203
2004,CLE,31,17,19,13,0,0,0,80,LAC,22,28,15,25,0,0,0,90,20031203
2004,MEM,19,27,27,23,0,0,0,96,NJN,17,23,29,24,0,0,0,93,20031203
2004,ORL,28,26,14,23,0,0,0,91,NOH,26,31,19,30,0,0,0,106,20031203
2004,MIN,26,21,14,31,0,0,0,92,PHO,22,24,14,19,0,0,0,79,20031203
2004,IND,27,17,21,23,7,0,0,95,POR,26,15,22,25,9,0,0,97,20031203
2004,LAL,21,20,21,28,0,0,0,90,SAS,24,23,24,15,0,0,0,86,20031203
2004,NYK,29,17,15,26,0,0,0,87,SEA,26,22,23,24,0,0,0,95,20031203
2004,BOS,27,16,26,26,0,0,0,95,TOR,23,28,28,26,0,0,0,105,20031203
2004,LAL,31,20,31,32,0,0,0,114,DAL,20,22,30,31,0,0,0,103,20031204
2004,CHI,26,18,16,22,0,0,0,82,PHI,15,21,26,21,0,0,0,83,20031204
2004,PHO,17,19,36,38,0,0,0,110,BOS,30,32,17,27,0,0,0,106,20031205
2004,GSW,18,17,30,26,0,0,0,91,DEN,28,22,21,27,0,0,0,98,20031205
2004,WAS,13,17,22,25,0,0,0,77,MEM,23,27,18,24,0,0,0,92,20031205
2004,PHI,27,25,25,16,0,0,0,93,MIA,17,21,28,24,0,0,0,90,20031205
2004,MIL,22,18,22,24,0,0,0,86,NJN,19,27,23,24,0,0,0,93,20031205
2004,HOU,23,16,26,18,0,0,0,83,NOH,14,29,12,19,0,0,0,74,20031205
2004,SAS,29,26,20,30,0,0,0,105,ORL,21,23,36,14,0,0,0,94,20031205
2004,NYK,28,17,18,18,0,0,0,81,POR,16,26,20,26,0,0,0,88,20031205
2004,MIN,28,27,25,22,10,0,0,112,SAC,36,20,15,31,7,0,0,109,20031205
2004,IND,25,19,36,21,0,0,0,101,SEA,22,23,15,34,0,0,0,94,20031205
2004,ATL,20,22,22,23,0,0,0,87,TOR,28,13,21,30,0,0,0,92,20031205
2004,LAC,16,19,14,18,0,0,0,67,UTA,21,26,20,19,0,0,0,86,20031205
2004,NOH,18,19,22,38,0,0,0,97,CHI,21,21,19,30,0,0,0,91,20031206
2004,ATL,22,20,24,19,0,0,0,85,CLE,15,29,27,24,0,0,0,95,20031206
2004,ORL,32,24,20,21,0,0,0,97,DAL,32,30,27,21,0,0,0,110,20031206
2004,NYK,24,24,25,19,0,0,0,92,GSW,20,29,34,21,0,0,0,104,20031206
2004,DET,22,19,17,22,0,0,0,80,HOU,28,20,24,14,0,0,0,86,20031206
2004,SAS,24,21,15,26,0,0,0,86,MIA,13,16,16,25,0,0,0,70,20031206
2004,WAS,25,26,18,29,16,0,0,114,MIL,18,23,23,34,11,0,0,109,20031206
2004,PHO,26,22,18,22,0,0,0,88,NJN,28,26,27,18,0,0,0,99,20031206
2004,BOS,32,30,25,29,0,0,0,116,DEN,21,32,30,28,0,0,0,111,20031207
2004,MIN,29,18,21,28,0,0,0,96,LAC,24,29,22,19,0,0,0,94,20031207
2004,UTA,18,14,28,32,0,0,0,92,LAL,23,24,27,20,0,0,0,94,20031207
2004,POR,26,24,18,11,0,0,0,79,MEM,18,25,26,24,0,0,0,93,20031207
2004,IND,22,24,27,15,0,0,0,88,SAC,26,31,17,17,0,0,0,91,20031207
2004,SEA,28,16,29,25,0,0,0,98,TOR,18,23,29,38,0,0,0,108,20031207
2004,SAS,12,19,30,35,0,0,0,96,CHI,17,21,18,26,0,0,0,82,20031208
2004,MIL,17,28,22,18,0,0,0,85,NOH,24,28,17,22,0,0,0,91,20031208
2004,PHO,41,18,21,18,0,0,0,98,ORL,23,26,32,24,0,0,0,105,20031208
2004,BOS,22,29,26,25,0,0,0,102,UTA,19,15,20,26,0,0,0,80,20031208
2004,DEN,24,31,19,24,0,0,0,98,ATL,26,32,29,25,0,0,0,112,20031209
2004,TOR,21,27,31,21,0,0,0,100,CLE,31,20,22,20,0,0,0,93,20031209
2004,PHI,16,16,22,24,0,0,0,78,DET,19,12,16,29,0,0,0,76,20031209
2004,POR,26,15,19,31,0,0,0,91,HOU,24,23,25,21,0,0,0,93,20031209
2004,WAS,19,17,20,23,0,0,0,79,IND,20,23,27,23,0,0,0,93,20031209
2004,NYK,25,16,25,24,0,0,0,90,LAL,18,35,23,22,0,0,0,98,20031209
2004,PHO,25,16,18,13,0,0,0,72,MIA,19,27,27,19,0,0,0,92,20031209
2004,GSW,32,25,23,18,0,0,0,98,MIN,28,22,31,14,0,0,0,95,20031209
2004,SEA,23,22,18,25,0,0,0,88,NJN,27,25,31,18,0,0,0,101,20031209
2004,LAC,20,23,33,19,0,0,0,95,SAC,29,28,25,23,0,0,0,105,20031209
2004,SEA,25,17,26,44,0,0,0,112,BOS,30,36,33,27,0,0,0,126,20031210
2004,DAL,39,21,22,17,0,0,0,99,LAC,19,37,21,23,0,0,0,100,20031210
2004,ATL,23,24,16,27,0,0,0,90,MEM,16,25,29,33,0,0,0,103,20031210
2004,GSW,19,31,17,20,2,0,0,89,MIL,27,23,19,18,7,0,0,94,20031210
2004,POR,18,18,23,18,0,0,0,77,SAS,29,18,24,31,0,0,0,102,20031210
2004,NYK,22,19,12,20,0,0,0,73,UTA,24,24,20,27,0,0,0,95,20031210
2004,ORL,25,26,27,17,0,0,0,95,WAS,19,30,23,19,0,0,0,91,20031210
2004,DET,23,23,15,25,0,0,0,86,CLE,26,23,21,25,0,0,0,95,20031211
2004,SAS,18,12,16,25,0,0,0,71,HOU,17,8,20,22,0,0,0,67,20031211
2004,NOH,26,30,23,32,0,0,0,111,PHO,30,16,25,30,0,0,0,101,20031211
2004,TOR,24,32,26,29,0,0,0,111,BOS,29,39,23,23,0,0,0,114,20031212
2004,SEA,25,26,21,21,0,0,0,93,DET,15,22,17,18,0,0,0,72,20031212
2004,NOH,24,20,26,26,0,0,0,96,GSW,22,22,20,21,0,0,0,85,20031212
2004,ATL,17,18,24,33,0,0,0,92,IND,25,27,19,32,0,0,0,103,20031212
2004,DAL,33,24,31,22,0,0,0,110,LAL,19,33,21,20,0,0,0,93,20031212
2004,MEM,19,17,28,24,0,0,0,88,MIA,29,23,21,18,0,0,0,91,20031212
2004,CHI,15,31,30,19,0,0,0,95,MIL,31,26,23,29,0,0,0,109,20031212
2004,NJN,20,17,29,33,0,0,0,99,ORL,19,26,17,33,0,0,0,95,20031212
2004,DEN,28,26,12,20,0,0,0,86,PHI,21,22,16,18,0,0,0,77,20031212
2004,SAC,22,23,27,28,0,0,0,100,UTA,23,19,21,30,0,0,0,93,20031212
2004,MIN,39,18,25,28,0,0,0,110,WAS,23,30,22,16,0,0,0,91,20031212
2004,ORL,26,24,23,32,0,0,0,105,ATL,29,21,19,33,0,0,0,102,20031213
2004,IND,29,17,14,15,0,0,0,75,CHI,24,16,31,15,0,0,0,86,20031213
2004,BOS,29,30,25,21,0,0,0,105,CLE,29,19,28,22,0,0,0,98,20031213
2004,PHO,27,20,26,18,0,0,0,91,LAC,26,35,29,16,0,0,0,106,20031213
2004,NJN,14,14,25,10,0,0,0,63,MEM,26,19,37,28,0,0,0,110,20031213
2004,DEN,27,15,27,19,0,0,0,88,NYK,23,23,18,31,0,0,0,95,20031213
2004,LAL,20,34,28,26,0,0,0,108,POR,26,28,30,28,0,0,0,112,20031213
2004,HOU,8,25,16,24,0,0,0,73,SAS,21,19,25,21,0,0,0,86,20031213
2004,WAS,20,17,25,25,0,0,0,87,NYK,19,17,25,28,0,0,0,89,20031214
2004,UTA,19,21,24,30,0,0,0,94,PHI,19,13,31,23,0,0,0,86,20031214
2004,PHO,35,25,32,10,0,0,0,102,SAC,30,22,27,28,0,0,0,107,20031214
2004,MIL,39,22,19,22,0,0,0,102,SEA,23,34,26,25,0,0,0,108,20031214
2004,MIA,22,22,25,21,0,0,0,90,TOR,20,29,19,21,0,0,0,89,20031214
2004,MIN,30,27,30,29,0,0,0,116,BOS,22,28,19,26,0,0,0,95,20031215
2004,TOR,29,25,22,18,0,0,0,94,DAL,28,18,31,34,0,0,0,111,20031215
2004,CLE,26,18,22,19,0,0,0,85,IND,33,16,21,25,0,0,0,95,20031215
2004,NOH,20,24,19,17,0,0,0,80,LAC,24,24,31,30,0,0,0,109,20031215
2004,MEM,18,22,17,10,0,0,0,67,SAS,20,23,20,15,0,0,0,78,20031215
2004,ORL,17,25,23,23,0,0,0,88,CHI,21,21,33,27,0,0,0,102,20031216
2004,NOH,14,28,28,24,0,0,0,94,DEN,30,34,28,24,0,0,0,116,20031216
2004,SAC,33,18,27,22,0,0,0,100,MEM,23,26,27,29,0,0,0,105,20031216
2004,ATL,21,25,18,15,0,0,0,79,MIA,26,24,31,16,0,0,0,97,20031216
2004,HOU,19,15,22,19,0,0,0,75,MIN,24,23,29,16,0,0,0,92,20031216
2004,GSW,27,30,26,21,0,0,0,104,NYK,31,17,16,22,0,0,0,86,20031216
2004,SEA,30,11,28,20,2,0,0,91,PHO,18,22,27,22,3,0,0,92,20031216
2004,MIL,23,29,32,22,0,0,0,106,POR,29,27,21,22,0,0,0,99,20031216
2004,UTA,19,20,28,20,0,0,0,87,WAS,28,18,17,28,0,0,0,91,20031216
2004,GSW,20,29,31,18,0,0,0,98,ATL,26,19,17,23,0,0,0,85,20031217
2004,DAL,29,33,23,18,0,0,0,103,BOS,24,32,21,28,0,0,0,105,20031217
2004,HOU,21,17,29,22,0,0,0,89,CLE,13,24,29,19,0,0,0,85,20031217
2004,CHI,14,11,24,24,0,0,0,73,DET,15,20,21,21,0,0,0,77,20031217
2004,ORL,25,20,23,26,0,0,0,94,IND,21,18,24,27,0,0,0,90,20031217
2004,MIL,21,17,19,26,0,0,0,83,LAC,19,31,19,24,0,0,0,93,20031217
2004,UTA,9,21,17,27,0,0,0,74,NJN,13,25,26,23,0,0,0,87,20031217
2004,MIA,26,16,16,18,0,0,0,76,PHI,20,16,25,26,0,0,0,87,20031217
2004,TOR,19,9,32,10,0,0,0,70,SAS,22,19,20,12,0,0,0,73,20031217
2004,DEN,35,26,22,16,0,0,0,99,SEA,25,29,30,14,0,0,0,98,20031217
2004,DAL,24,26,32,27,0,0,0,109,MIN,29,30,25,30,0,0,0,114,20031218
2004,SAC,29,21,25,26,0,0,0,101,NOH,17,18,26,29,0,0,0,90,20031218
2004,PHO,21,28,23,22,0,0,0,94,POR,27,24,19,31,0,0,0,101,20031218
2004,SAC,29,23,25,21,0,0,0,98,ATL,23,18,28,17,0,0,0,86,20031219
2004,UTA,31,21,29,18,0,0,0,99,BOS,29,21,22,24,0,0,0,96,20031219
2004,LAC,22,19,26,18,0,0,0,85,HOU,28,23,31,17,0,0,0,99,20031219
2004,DET,26,18,12,19,0,0,0,75,IND,19,14,14,33,0,0,0,80,20031219
2004,DEN,19,28,23,29,0,0,0,99,LAL,27,30,23,21,0,0,0,101,20031219
2004,MIA,24,21,13,25,0,0,0,83,MEM,35,24,22,16,0,0,0,97,20031219
2004,WAS,14,16,29,28,0,0,0,87,NJN,30,14,29,24,0,0,0,97,20031219
2004,GSW,20,30,23,20,0,0,0,93,ORL,28,34,28,29,0,0,0,119,20031219
2004,CLE,20,22,20,26,0,0,0,88,PHI,29,19,14,19,0,0,0,81,20031219
2004,SAS,25,26,20,16,0,0,0,87,SEA,9,20,29,15,0,0,0,73,20031219
2004,NYK,19,27,16,31,6,0,0,99,TOR,28,20,19,26,12,0,0,105,20031219
2004,CLE,26,23,21,25,0,0,0,95,CHI,24,20,29,14,0,0,0,87,20031220
2004,LAC,31,30,30,24,0,0,0,115,DAL,32,22,28,23,0,0,0,105,20031220
2004,SEA,27,28,31,29,0,0,0,115,DEN,24,25,26,31,0,0,0,106,20031220
2004,NJN,15,17,23,32,0,0,0,87,MIL,24,18,25,25,0,0,0,92,20031220
2004,IND,15,16,21,28,0,0,0,80,MIN,24,30,27,21,0,0,0,102,20031220
2004,MEM,24,17,24,24,0,0,0,89,NOH,26,26,15,27,0,0,0,94,20031220
2004,ATL,21,30,17,24,0,0,0,92,NYK,22,26,25,30,0,0,0,103,20031220
2004,HOU,17,27,17,26,0,0,0,87,PHO,24,20,20,38,0,0,0,102,20031220
2004,SAS,28,28,18,27,0,0,0,101,POR,17,23,25,26,0,0,0,91,20031220
2004,PHI,19,26,20,19,0,0,0,84,BOS,23,10,24,30,0,0,0,87,20031221
2004,UTA,19,17,19,20,0,0,0,75,DET,31,17,22,26,0,0,0,96,20031221
2004,PHO,30,18,27,26,0,0,0,101,LAL,33,28,21,25,0,0,0,107,20031221
2004,GSW,22,26,24,21,0,0,0,93,MIA,29,25,30,20,0,0,0,104,20031221
2004,POR,29,25,26,18,0,0,0,98,SAC,33,22,32,30,0,0,0,117,20031221
2004,ORL,21,28,29,26,0,0,0,104,TOR,22,27,22,22,0,0,0,93,20031221
2004,UTA,27,25,19,21,0,0,0,92,CHI,14,21,23,22,0,0,0,80,20031222
2004,MEM,22,30,28,19,0,0,0,99,DEN,29,23,29,25,0,0,0,106,20031222
2004,ORL,18,22,24,9,0,0,0,73,PHI,24,23,23,25,0,0,0,95,20031222
2004,BOS,26,24,17,21,0,0,0,88,ATL,16,22,28,27,0,0,0,93,20031223
2004,NOH,27,25,18,16,0,0,0,86,CLE,21,19,26,31,0,0,0,97,20031223
2004,LAL,31,15,22,30,0,0,0,98,GSW,23,38,19,27,0,0,0,107,20031223
2004,IND,19,20,18,22,0,0,0,79,HOU,14,14,21,22,0,0,0,71,20031223
2004,WAS,14,16,22,20,0,0,0,72,MIA,24,10,16,29,0,0,0,79,20031223
2004,DET,15,16,24,23,0,0,0,78,MIL,25,18,21,19,0,0,0,83,20031223
2004,CHI,20,18,22,18,0,0,0,78,NJN,20,26,26,23,0,0,0,95,20031223
2004,MIN,24,22,19,33,0,0,0,98,NYK,24,18,22,28,0,0,0,92,20031223
2004,DAL,24,23,20,21,0,0,0,88,POR,26,28,22,21,0,0,0,97,20031223
2004,MEM,32,22,16,27,0,0,0,97,SAC,20,32,23,39,0,0,0,114,20031223
2004,LAC,22,21,30,17,0,0,0,90,SAS,35,29,25,22,0,0,0,111,20031223
2004,PHO,20,28,20,22,0,0,0,90,SEA,28,25,34,29,0,0,0,116,20031223
2004,HOU,33,24,16,26,0,0,0,99,LAL,19,25,27,16,0,0,0,87,20031225
2004,CLE,30,28,23,16,4,0,0,101,ORL,28,32,21,16,16,0,0,113,20031225
2004,DAL,30,14,34,33,0,0,0,111,SAC,36,24,24,19,0,0,0,103,20031225
2004,CHI,19,27,25,16,0,0,0,87,CLE,20,25,23,12,0,0,0,80,20031226
2004,HOU,27,24,21,22,0,0,0,94,DEN,19,18,33,25,0,0,0,95,20031226
2004,NJN,22,12,20,28,0,0,0,82,DET,12,15,31,21,0,0,0,79,20031226
2004,SAC,30,25,18,18,0,0,0,91,GSW,32,24,28,14,0,0,0,98,20031226
2004,PHI,21,33,23,21,0,0,0,98,LAC,27,31,22,21,0,0,0,101,20031226
2004,NYK,24,30,22,22,0,0,0,98,MEM,18,25,24,27,0,0,0,94,20031226
2004,IND,23,27,27,19,0,0,0,96,MIL,21,28,18,34,0,0,0,101,20031226
2004,ATL,18,19,22,20,0,0,0,79,NOH,32,21,29,27,0,0,0,109,20031226
2004,BOS,24,21,30,29,0,0,0,104,PHO,26,30,19,27,0,0,0,102,20031226
2004,MIN,26,17,31,18,0,0,0,92,POR,24,37,19,21,0,0,0,101,20031226
2004,ORL,20,20,30,13,0,0,0,83,SAS,28,22,24,24,0,0,0,98,20031226
2004,TOR,27,23,20,18,6,0,0,94,UTA,23,22,21,22,9,0,0,97,20031226
2004,MIA,27,20,20,25,0,0,0,92,WAS,28,16,23,17,0,0,0,84,20031226
2004,DET,23,32,9,23,0,0,0,87,ATL,26,19,22,17,0,0,0,84,20031227
2004,WAS,22,23,18,23,0,0,0,86,CHI,29,18,24,29,0,0,0,100,20031227
2004,MEM,25,28,22,23,0,0,0,98,DAL,34,24,30,16,0,0,0,104,20031227
2004,NJN,23,19,21,19,0,0,0,82,IND,19,17,19,20,0,0,0,75,20031227
2004,NYK,29,23,31,17,0,0,0,100,MIA,17,25,17,21,0,0,0,80,20031227
2004,MIN,15,26,31,32,0,0,0,104,SEA,19,19,27,21,0,0,0,86,20031227
2004,POR,23,23,20,8,0,0,0,74,CLE,20,22,22,22,0,0,0,86,20031228
2004,GSW,26,21,18,14,0,0,0,79,DEN,12,38,33,20,0,0,0,103,20031228
2004,TOR,21,24,19,30,0,0,0,94,LAC,24,17,24,23,0,0,0,88,20031228
2004,BOS,26,23,15,18,0,0,0,82,LAL,30,27,22,26,0,0,0,105,20031228
2004,PHI,19,29,16,28,0,0,0,92,PHO,35,20,18,27,0,0,0,100,20031228
2004,UTA,19,13,33,24,0,0,0,89,SAC,20,20,24,34,0,0,0,98,20031228
2004,MIL,22,15,22,15,0,0,0,74,SAS,26,27,13,23,0,0,0,89,20031228
2004,MIA,17,16,30,27,0,0,0,90,CHI,22,23,17,21,0,0,0,83,20031229
2004,NOH,21,27,23,28,0,0,0,99,DET,31,21,31,25,0,0,0,108,20031229
2004,BOS,30,28,25,17,0,0,0,100,GSW,29,22,16,24,0,0,0,91,20031229
2004,SEA,19,23,18,27,0,0,0,87,HOU,24,22,17,23,0,0,0,86,20031229
2004,MEM,29,24,15,18,0,0,0,86,IND,28,25,22,19,0,0,0,94,20031229
2004,PHO,29,29,32,23,0,0,0,113,LAC,27,24,27,27,0,0,0,105,20031229
2004,POR,22,20,28,21,0,0,0,91,NJN,24,26,22,15,0,0,0,87,20031229
2004,NYK,34,26,32,22,0,0,0,114,ORL,20,24,20,22,0,0,0,86,20031229
2004,PHI,19,25,27,26,0,0,0,97,UTA,24,32,25,25,0,0,0,106,20031229
2004,IND,22,21,33,16,0,0,0,92,CLE,28,19,18,24,0,0,0,89,20031230
2004,MIL,19,18,34,21,0,0,0,92,DAL,25,32,19,25,0,0,0,101,20031230
2004,TOR,15,24,28,14,0,0,0,81,DEN,19,21,23,11,0,0,0,74,20031230
2004,SEA,26,24,22,33,0,0,0,105,MEM,21,23,30,25,0,0,0,99,20031230
2004,CHI,15,32,25,21,0,0,0,93,MIN,31,20,26,21,0,0,0,98,20031230
2004,MIA,14,17,23,19,0,0,0,73,NYK,28,29,22,23,0,0,0,102,20031230
2004,ATL,35,19,11,18,0,0,0,83,WAS,19,24,17,13,0,0,0,73,20031230
2004,NOH,18,22,29,27,0,0,0,96,BOS,23,13,34,24,0,0,0,94,20031231
2004,POR,24,12,19,16,0,0,0,71,DET,23,14,20,21,0,0,0,78,20031231
2004,PHI,13,19,24,16,0,0,0,72,HOU,22,16,20,22,0,0,0,80,20031231
2004,DEN,23,33,25,23,0,0,0,104,LAC,27,25,32,36,0,0,0,120,20031231
2004,GSW,23,18,15,14,0,0,0,70,NJN,16,27,28,17,0,0,0,88,20031231
2004,IND,25,23,25,30,0,0,0,103,BOS,30,24,18,18,0,0,0,90,20040102
2004,PHO,22,26,17,16,0,0,0,81,DET,26,25,25,17,0,0,0,93,20040102
2004,UTA,26,26,21,15,0,0,0,88,MEM,25,30,25,20,0,0,0,100,20040102
2004,ORL,24,23,30,24,0,0,0,101,MIA,40,25,23,24,0,0,0,112,20040102
2004,DAL,29,27,25,20,0,0,0,101,MIL,29,30,26,24,0,0,0,109,20040102
2004,ATL,18,20,19,18,0,0,0,75,MIN,22,28,21,22,0,0,0,93,20040102
2004,CLE,19,24,20,19,0,0,0,82,NJN,20,19,32,26,0,0,0,97,20040102
2004,CHI,23,29,24,28,0,0,0,104,NYK,27,26,23,23,0,0,0,99,20040102
2004,DEN,30,29,18,29,0,0,0,106,POR,25,25,29,17,0,0,0,96,20040102
2004,LAL,25,30,27,27,0,0,0,109,SEA,25,31,30,25,0,0,0,111,20040102
2004,NOH,24,35,11,16,0,0,0,86,TOR,14,21,19,20,0,0,0,74,20040102
2004,GSW,20,24,18,17,0,0,0,79,WAS,22,21,29,25,0,0,0,97,20040102
2004,BOS,22,9,27,30,0,0,0,88,CHI,21,23,15,18,0,0,0,77,20040103
2004,MIN,30,24,26,32,0,0,0,112,DAL,25,31,30,33,0,0,0,119,20040103
2004,ATL,20,25,24,15,0,0,0,84,DEN,16,26,26,8,0,0,0,76,20040103
2004,GSW,28,21,22,22,0,0,0,93,DET,24,24,27,24,0,0,0,99,20040103
2004,UTA,17,16,23,7,0,0,0,63,HOU,18,24,24,18,0,0,0,84,20040103
2004,NOH,10,29,16,29,0,0,0,84,IND,29,21,25,16,0,0,0,91,20040103
2004,SAC,35,24,29,28,0,0,0,116,LAC,27,31,26,25,0,0,0,109,20040103
2004,ORL,23,26,23,31,0,0,0,103,MEM,29,31,32,20,0,0,0,112,20040103
2004,PHI,19,16,21,27,0,0,0,83,SAS,26,12,19,20,0,0,0,77,20040103
2004,LAL,32,20,24,22,0,0,0,98,LAC,27,29,28,17,0,0,0,101,20040104
2004,NJN,18,16,24,37,0,0,0,95,NYK,19,15,24,27,0,0,0,85,20040104
2004,SEA,20,23,22,34,0,0,0,99,SAC,27,36,36,31,0,0,0,130,20040104
2004,PHO,15,18,22,18,0,0,0,73,TOR,20,17,21,25,0,0,0,83,20040104
2004,MIL,28,27,27,18,0,0,0,100,WAS,33,22,19,20,0,0,0,94,20040104
2004,DET,22,20,20,16,0,0,0,78,BOS,23,15,14,16,0,0,0,68,20040105
2004,PHO,12,25,18,27,0,0,0,82,CHI,25,17,20,25,0,0,0,87,20040105
2004,SAS,32,24,23,19,0,0,0,98,DEN,22,15,21,16,0,0,0,74,20040105
2004,GSW,14,18,21,12,0,0,0,65,HOU,16,26,24,17,0,0,0,83,20040105
2004,IND,25,20,18,24,0,0,0,87,MIA,20,21,11,13,0,0,0,65,20040105
2004,MIL,25,32,12,19,0,0,0,88,PHI,18,22,15,21,0,0,0,76,20040105
2004,POR,32,32,23,17,4,0,0,108,SEA,21,24,24,35,15,0,0,119,20040105
2004,DAL,24,24,18,28,0,0,0,94,UTA,28,22,28,30,0,0,0,108,20040105
2004,NYK,23,22,25,26,0,0,0,96,CLE,18,38,27,24,0,0,0,107,20040106
2004,ORL,18,35,28,26,0,0,0,107,IND,33,36,25,20,0,0,0,114,20040106
2004,LAL,18,30,16,26,0,0,0,90,MIN,33,29,22,22,0,0,0,106,20040106
2004,LAC,15,13,24,23,0,0,0,75,NJN,24,27,22,19,0,0,0,92,20040106
2004,ATL,23,23,21,22,0,0,0,89,SAC,38,21,24,22,0,0,0,105,20040106
2004,WAS,19,11,22,20,0,0,0,72,SAS,22,26,24,22,0,0,0,94,20040106
2004,ORL,29,21,22,21,0,0,0,93,BOS,36,24,20,21,0,0,0,101,20040107
2004,GSW,24,30,24,21,0,0,0,99,DAL,23,34,26,22,0,0,0,105,20040107
2004,LAL,27,21,27,16,0,0,0,91,DEN,31,32,34,16,0,0,0,113,20040107
2004,HOU,18,12,21,15,0,0,0,66,DET,20,24,30,11,0,0,0,85,20040107
2004,CHI,20,28,22,25,0,0,0,95,MIA,25,21,30,26,0,0,0,102,20040107
2004,PHO,18,28,21,20,0,0,0,87,MIL,22,26,24,23,0,0,0,95,20040107
2004,WAS,14,18,28,27,0,0,0,87,NOH,21,28,24,24,0,0,0,97,20040107
2004,LAC,15,31,13,21,0,0,0,80,PHI,26,21,27,26,0,0,0,100,20040107
2004,SAC,32,22,17,22,0,0,0,93,SEA,27,34,21,22,0,0,0,104,20040107
2004,CLE,22,17,17,13,0,0,0,69,TOR,25,17,12,21,0,0,0,75,20040107
2004,POR,15,18,25,17,0,0,0,75,MIN,27,28,20,21,0,0,0,96,20040108
2004,HOU,31,23,32,25,0,0,0,111,NYK,14,23,23,19,0,0,0,79,20040108
2004,CLE,21,22,24,15,0,0,0,82,BOS,33,19,30,25,0,0,0,107,20040109
2004,POR,18,19,19,31,0,0,0,87,CHI,20,21,17,20,0,0,0,78,20040109
2004,IND,23,21,25,23,0,0,0,92,DAL,26,20,17,17,0,0,0,80,20040109
2004,UTA,14,21,34,27,0,0,0,96,DEN,28,26,25,27,0,0,0,106,20040109
2004,ATL,7,21,22,17,0,0,0,67,LAL,34,23,32,24,0,0,0,113,20040109
2004,MIA,21,15,27,31,0,0,0,94,MIL,22,33,23,25,0,0,0,103,20040109
2004,SAS,25,24,27,18,0,0,0,94,NOH,17,21,23,23,0,0,0,84,20040109
2004,WAS,11,14,37,30,0,0,0,92,ORL,26,19,29,29,0,0,0,103,20040109
2004,NJN,17,21,24,19,0,0,0,81,PHI,26,29,24,18,0,0,0,97,20040109
2004,SAC,34,25,29,25,0,0,0,113,PHO,30,22,19,22,0,0,0,93,20040109
2004,MEM,38,27,25,26,0,0,0,116,SEA,23,37,34,28,0,0,0,122,20040109
2004,LAC,25,15,19,19,0,0,0,78,TOR,23,15,11,19,0,0,0,68,20040109
2004,NOH,16,22,19,27,0,0,0,84,CHI,20,38,17,14,0,0,0,89,20040110
2004,SEA,25,24,25,25,11,0,0,110,GSW,22,28,20,29,14,0,0,113,20040110
2004,MIA,16,21,24,16,0,0,0,77,MIN,17,20,26,20,0,0,0,83,20040110
2004,MIL,22,22,25,19,0,0,0,88,NYK,32,22,20,20,0,0,0,94,20040110
2004,IND,19,18,21,23,7,0,0,88,SAS,27,14,23,17,8,0,0,89,20040110
2004,ATL,22,15,13,21,0,0,0,71,UTA,23,26,28,15,0,0,0,92,20040110
2004,PHI,19,24,12,32,0,0,0,87,WAS,21,25,19,29,0,0,0,94,20040110
2004,DAL,30,25,22,25,0,0,0,102,DET,23,32,35,25,0,0,0,115,20040111
2004,BOS,24,22,19,32,0,0,0,97,HOU,20,18,22,33,0,0,0,93,20040111
2004,MEM,25,29,19,27,8,0,0,108,LAC,24,25,21,30,7,0,0,107,20040111
2004,DEN,27,23,34,22,0,0,0,106,SAC,29,28,32,28,0,0,0,117,20040111
2004,POR,21,12,17,22,0,0,0,72,TOR,22,21,20,20,0,0,0,83,20040111
2004,MEM,28,21,24,21,8,13,0,115,GSW,25,22,34,13,8,11,0,113,20040112
2004,CLE,21,17,27,14,0,0,0,79,LAL,19,21,20,29,0,0,0,89,20040112
2004,DAL,34,34,33,14,12,0,0,127,NYK,25,29,32,29,6,0,0,121,20040112
2004,PHI,32,16,25,14,0,0,0,87,ORL,25,25,16,16,0,0,0,82,20040112
2004,SAS,14,18,20,25,0,0,0,77,ATL,23,26,16,21,0,0,0,86,20040113
2004,DET,28,20,25,32,0,0,0,105,CHI,17,25,21,26,0,0,0,89,20040113
2004,POR,19,29,18,26,4,0,0,96,LAC,20,27,21,24,11,0,0,103,20040113
2004,BOS,27,17,26,33,0,0,0,103,MIL,20,30,33,28,0,0,0,111,20040113
2004,MIN,18,27,18,31,0,0,0,94,NOH,30,17,26,16,0,0,0,89,20040113
2004,DEN,32,25,30,18,0,0,0,105,PHO,15,21,29,27,0,0,0,92,20040113
2004,MIA,19,22,25,20,0,0,0,86,SAC,31,21,20,18,0,0,0,90,20040113
2004,CLE,29,29,20,26,0,0,0,104,SEA,30,21,28,17,0,0,0,96,20040113
2004,GSW,10,35,21,14,0,0,0,80,UTA,23,29,24,21,0,0,0,97,20040113
2004,HOU,22,21,30,20,0,0,0,93,WAS,17,24,24,15,0,0,0,80,20040113
2004,HOU,23,24,22,26,0,0,0,95,BOS,18,24,14,24,0,0,0,80,20040114
2004,PHI,21,27,22,37,8,7,0,122,DAL,25,30,29,23,8,10,0,125,20040114
2004,TOR,24,25,23,19,0,0,0,91,DET,21,17,28,29,0,0,0,95,20040114
2004,ATL,19,18,14,27,0,0,0,78,IND,19,20,19,27,0,0,0,85,20040114
2004,DEN,16,19,24,12,0,0,0,71,LAL,26,29,23,19,0,0,0,97,20040114
2004,WAS,22,25,20,36,0,0,0,103,NJN,31,20,36,28,0,0,0,115,20040114
2004,ORL,27,30,29,24,0,0,0,110,NYK,32,32,24,32,0,0,0,120,20040114
2004,MIN,17,19,29,35,0,0,0,100,SAS,19,21,28,25,0,0,0,93,20040114
2004,CLE,29,26,19,28,0,0,0,102,GSW,31,29,21,38,0,0,0,119,20040115
2004,CHI,24,18,26,25,0,0,0,93,MEM,29,27,23,29,0,0,0,108,20040115
2004,NJN,14,23,21,25,0,0,0,83,MIL,19,13,26,28,0,0,0,86,20040115
2004,TOR,17,28,10,15,8,0,0,78,NOH,16,19,19,16,4,0,0,74,20040115
2004,PHO,35,21,26,23,0,0,0,105,POR,24,23,23,26,0,0,0,96,20040115
2004,MIA,24,16,24,21,0,0,0,85,UTA,22,22,20,33,0,0,0,97,20040115
2004,DAL,28,19,24,20,0,0,0,91,DEN,27,20,20,21,0,0,0,88,20040116
2004,WAS,20,15,19,23,0,0,0,77,DET,18,31,31,18,0,0,0,98,20040116
2004,SAS,17,29,17,16,0,0,0,79,IND,25,14,24,26,0,0,0,89,20040116
2004,MIA,20,19,25,23,0,0,0,87,LAC,18,22,20,25,0,0,0,85,20040116
2004,SEA,26,16,19,27,0,0,0,88,NYK,34,26,26,22,0,0,0,108,20040116
2004,BOS,28,31,27,25,7,0,0,118,ORL,30,29,20,32,13,0,0,124,20040116
2004,GSW,24,20,28,21,0,0,0,93,PHO,30,32,22,20,0,0,0,104,20040116
2004,LAL,19,19,17,28,0,0,0,83,SAC,26,21,35,21,0,0,0,103,20040116
2004,TOR,8,23,21,18,0,0,0,70,ATL,16,21,14,24,0,0,0,75,20040117
2004,NYK,27,29,12,33,0,0,0,101,CHI,30,25,20,21,0,0,0,96,20040117
2004,MIN,13,13,19,31,0,0,0,76,HOU,23,22,23,27,0,0,0,95,20040117
2004,LAC,30,14,16,29,0,0,0,89,LAL,17,26,23,25,0,0,0,91,20040117
2004,DET,22,25,25,27,0,0,0,99,MIL,17,25,29,23,0,0,0,94,20040117
2004,IND,20,25,18,27,0,0,0,90,NJN,23,32,19,10,0,0,0,84,20040117
2004,ORL,27,20,28,15,0,0,0,90,NOH,26,19,21,25,0,0,0,91,20040117
2004,MEM,33,16,23,19,0,0,0,91,PHI,29,26,18,14,0,0,0,87,20040117
2004,DAL,27,32,26,23,0,0,0,108,POR,34,34,18,18,0,0,0,104,20040117
2004,CLE,19,14,24,28,17,0,0,102,UTA,17,34,20,14,11,0,0,96,20040117
2004,SEA,18,27,18,21,0,0,0,84,WAS,25,20,30,24,0,0,0,99,20040117
2004,SAS,32,20,19,38,0,0,0,109,BOS,25,15,18,34,0,0,0,92,20040118
2004,MIA,12,28,19,21,0,0,0,80,DEN,24,27,15,22,0,0,0,88,20040118
2004,POR,21,30,23,18,0,0,0,92,PHO,26,22,23,25,0,0,0,96,20040118
2004,IND,27,24,26,23,0,0,0,100,ATL,33,23,18,23,0,0,0,97,20040119
2004,SAS,17,19,20,21,0,0,0,77,DET,16,22,20,27,0,0,0,85,20040119
2004,UTA,19,18,26,22,0,0,0,85,GSW,26,16,29,30,0,0,0,101,20040119
2004,SAC,37,34,32,22,0,0,0,125,LAC,23,31,24,22,0,0,0,100,20040119
2004,PHO,24,17,22,25,0,0,0,88,LAL,22,24,15,24,0,0,0,85,20040119
2004,HOU,17,28,26,12,0,0,0,83,MEM,22,23,22,21,0,0,0,88,20040119
2004,NOH,27,27,20,16,0,0,0,90,MIN,27,29,17,24,0,0,0,97,20040119
2004,TOR,24,12,25,18,0,0,0,79,NYK,18,22,26,24,0,0,0,90,20040119
2004,MIL,23,19,26,31,0,0,0,99,ORL,26,31,21,28,0,0,0,106,20040119
2004,SEA,18,21,23,28,0,0,0,90,PHI,30,18,17,16,0,0,0,81,20040119
2004,CHI,32,26,12,13,0,0,0,83,WAS,27,16,24,26,0,0,0,93,20040119
2004,SEA,27,25,19,23,0,0,0,94,CLE,26,24,21,28,0,0,0,99,20040120
2004,NJN,24,17,30,22,0,0,0,93,DAL,27,27,28,24,0,0,0,106,20040120
2004,DET,9,31,17,12,0,0,0,69,IND,20,24,22,15,0,0,0,81,20040120
2004,BOS,14,25,21,26,0,0,0,86,MIA,19,21,23,21,0,0,0,84,20040120
2004,POR,25,27,23,22,12,0,0,109,SAC,24,19,25,29,7,0,0,104,20040120
2004,DEN,24,26,20,26,0,0,0,96,UTA,12,24,21,18,0,0,0,75,20040120
2004,CHI,24,23,26,14,0,0,0,87,ATL,24,28,27,18,0,0,0,97,20040121
2004,PHO,24,26,23,19,0,0,0,92,DEN,20,25,30,22,0,0,0,97,20040121
2004,NYK,26,9,22,14,0,0,0,71,HOU,16,31,23,16,0,0,0,86,20040121
2004,GSW,36,29,20,17,0,0,0,102,LAC,30,24,28,24,0,0,0,106,20040121
2004,LAL,26,20,16,20,0,0,0,82,MEM,25,15,29,19,0,0,0,88,20040121
2004,ORL,25,26,23,28,0,0,0,102,MIL,20,26,30,37,0,0,0,113,20040121
2004,PHI,20,24,29,19,0,0,0,92,NOH,24,27,14,21,0,0,0,86,20040121
2004,NJN,19,28,17,12,0,0,0,76,SAS,20,26,25,28,0,0,0,99,20040121
2004,MIN,27,19,28,34,0,0,0,108,TOR,19,30,19,29,0,0,0,97,20040121
2004,SAC,23,18,36,18,0,0,0,95,CLE,25,16,28,20,0,0,0,89,20040122
2004,LAL,22,24,23,18,0,0,0,87,DAL,31,28,30,17,0,0,0,106,20040122
2004,GSW,14,21,20,32,0,0,0,87,SEA,29,22,23,29,0,0,0,103,20040122
2004,NYK,29,25,21,21,0,0,0,96,ATL,24,29,21,20,0,0,0,94,20040123
2004,WAS,18,19,22,30,0,0,0,89,BOS,23,23,32,22,0,0,0,100,20040123
2004,DAL,28,26,30,22,0,0,0,106,CHI,32,14,26,21,0,0,0,93,20040123
2004,HOU,23,20,20,15,0,0,0,78,IND,25,16,19,14,0,0,0,74,20040123
2004,UTA,25,18,22,17,0,0,0,82,LAC,32,13,28,20,0,0,0,93,20040123
2004,SAC,28,19,19,29,0,0,0,95,MEM,32,30,25,22,0,0,0,109,20040123
2004,NJN,16,14,22,12,0,0,0,64,MIA,20,21,17,27,0,0,0,85,20040123
2004,TOR,20,21,18,27,0,0,0,86,MIL,23,26,21,28,0,0,0,98,20040123
2004,DET,13,25,22,19,0,0,0,79,MIN,18,25,20,17,0,0,0,80,20040123
2004,DEN,24,24,23,20,0,0,0,91,NOH,24,29,23,21,0,0,0,97,20040123
2004,ORL,19,29,21,29,0,0,0,98,PHI,18,20,20,35,0,0,0,93,20040123
2004,SAS,23,28,18,17,0,0,0,86,PHO,19,25,18,22,0,0,0,84,20040123
2004,PHI,18,21,29,19,0,0,0,87,CLE,30,25,22,18,0,0,0,95,20040124
2004,MIA,25,21,17,22,0,0,0,85,NYK,20,25,19,13,0,0,0,77,20040124
2004,GSW,30,28,18,29,0,0,0,105,POR,21,31,20,15,0,0,0,87,20040124
2004,NOH,18,23,23,34,0,0,0,98,SAS,22,30,23,21,0,0,0,96,20040124
2004,LAC,31,23,14,29,0,0,0,97,SEA,25,28,21,28,0,0,0,102,20040124
2004,LAL,16,27,26,24,0,0,0,93,UTA,21,17,24,24,0,0,0,86,20040124
2004,IND,24,26,16,30,0,0,0,96,WAS,26,31,16,34,0,0,0,107,20040124
2004,TOR,22,21,20,26,0,0,0,89,CHI,21,25,19,31,0,0,0,96,20040125
2004,SAC,21,26,28,24,0,0,0,99,DAL,25,25,26,32,0,0,0,108,20040125
2004,ATL,28,22,22,19,0,0,0,91,DET,21,24,16,21,0,0,0,82,20040125
2004,DEN,26,23,18,21,0,0,0,88,MEM,22,20,34,30,0,0,0,106,20040125
2004,PHO,20,25,25,25,0,0,0,95,MIN,16,35,19,29,0,0,0,99,20040125
2004,BOS,14,25,25,27,0,0,0,91,NJN,20,36,27,27,0,0,0,110,20040125
2004,HOU,21,22,32,24,0,0,0,99,ORL,17,23,28,19,0,0,0,87,20040125
2004,ORL,27,35,17,19,0,0,0,98,CLE,27,32,14,26,0,0,0,99,20040126
2004,MIN,28,21,21,27,0,0,0,97,DEN,19,29,27,20,0,0,0,95,20040126
2004,HOU,24,24,15,18,0,0,0,81,MIA,25,20,29,21,0,0,0,95,20040126
2004,SAS,21,23,23,25,0,0,0,92,MIL,21,31,23,18,0,0,0,93,20040126
2004,LAC,25,17,21,30,0,0,0,93,UTA,22,22,25,29,0,0,0,98,20040126
2004,POR,31,26,17,20,0,0,0,94,WAS,26,15,21,21,0,0,0,83,20040126
2004,PHO,14,22,30,23,0,0,0,89,ATL,22,20,17,26,0,0,0,85,20040127
2004,CHI,23,20,19,30,0,0,0,92,LAC,33,18,30,21,0,0,0,102,20040127
2004,SAS,12,26,17,22,0,0,0,77,NYK,17,18,14,18,0,0,0,67,20040127
2004,NJN,26,30,27,11,0,0,0,94,PHI,12,23,23,18,0,0,0,76,20040127
2004,DAL,33,25,34,26,0,0,0,118,SEA,26,35,27,28,0,0,0,116,20040127
2004,DET,22,27,26,31,0,0,0,106,BOS,28,19,23,33,0,0,0,103,20040128
2004,MIA,21,28,30,14,0,0,0,93,CLE,33,15,22,24,0,0,0,94,20040128
2004,CHI,26,26,16,31,0,0,0,99,DEN,37,23,23,32,0,0,0,115,20040128
2004,MIN,18,24,28,20,0,0,0,90,GSW,23,22,21,31,0,0,0,97,20040128
2004,SAC,29,20,22,28,0,0,0,99,HOU,29,24,23,18,0,0,0,94,20040128
2004,PHO,22,22,15,20,0,0,0,79,IND,30,22,30,19,0,0,0,101,20040128
2004,SEA,26,20,24,12,0,0,0,82,LAL,24,30,17,25,0,0,0,96,20040128
2004,POR,18,22,24,24,0,0,0,88,MEM,14,20,26,16,0,0,0,76,20040128
2004,MIL,24,34,20,22,0,0,0,100,NOH,21,32,28,20,0,0,0,101,20040128
2004,PHI,18,24,25,17,0,0,0,84,TOR,25,23,25,21,0,0,0,94,20040128
2004,DAL,24,14,22,28,0,0,0,88,UTA,24,25,13,29,0,0,0,91,20040128
2004,ORL,29,31,19,25,0,0,0,104,WAS,26,20,23,31,0,0,0,100,20040128
2004,POR,17,20,29,27,0,0,0,93,ATL,22,20,15,28,0,0,0,85,20040129
2004,NJN,19,24,24,22,0,0,0,89,ORL,22,17,20,20,0,0,0,79,20040129
2004,SAC,27,25,21,23,0,0,0,96,SAS,22,20,23,26,0,0,0,91,20040129
2004,NYK,23,27,28,14,0,0,0,92,BOS,16,26,15,17,0,0,0,74,20040130
2004,CHI,16,18,24,23,0,0,0,81,GSW,24,29,28,20,0,0,0,101,20040130
2004,MIN,15,20,29,33,0,0,0,97,LAL,20,24,22,18,0,0,0,84,20040130
2004,UTA,16,23,28,18,0,0,0,85,MEM,24,8,27,20,0,0,0,79,20040130
2004,LAC,22,28,16,22,0,0,0,88,MIA,23,21,24,29,0,0,0,97,20040130
2004,CLE,24,29,24,18,0,0,0,95,MIL,25,32,24,20,0,0,0,101,20040130
2004,NOH,30,14,21,17,0,0,0,82,PHI,33,22,16,14,0,0,0,85,20040130
2004,DET,21,16,26,19,8,0,0,90,TOR,32,14,17,19,7,0,0,89,20040130
2004,PHO,18,25,33,24,0,0,0,100,WAS,29,20,20,36,0,0,0,105,20040130
2004,MIL,13,21,21,28,0,0,0,83,ATL,26,27,19,21,0,0,0,93,20040131
2004,DEN,21,16,36,34,0,0,0,107,DAL,22,31,27,22,0,0,0,102,20040131
2004,MEM,27,11,16,24,0,0,0,78,DET,20,22,17,21,0,0,0,80,20040131
2004,NJN,17,20,29,22,0,0,0,88,HOU,25,21,14,17,0,0,0,77,20040131
2004,BOS,32,21,22,23,0,0,0,98,IND,43,16,15,25,0,0,0,99,20040131
2004,MIA,24,17,24,29,0,0,0,94,NOH,14,18,20,18,0,0,0,70,20040131
2004,PHO,25,28,31,21,0,0,0,105,NYK,24,34,28,24,0,0,0,110,20040131
2004,LAC,30,30,24,31,0,0,0,115,ORL,24,30,22,30,0,0,0,106,20040131
2004,CHI,25,30,22,14,4,0,0,95,POR,24,21,30,16,11,0,0,102,20040131
2004,UTA,17,21,11,32,0,0,0,81,SAS,19,21,17,28,0,0,0,85,20040131
2004,SAC,24,30,26,30,0,0,0,110,SEA,15,26,34,28,0,0,0,103,20040131
2004,PHI,36,27,17,21,0,0,0,101,MIN,23,29,27,27,0,0,0,106,20040201
2004,LAL,23,31,17,13,0,0,0,84,TOR,23,15,23,22,0,0,0,83,20040201
2004,CLE,24,18,36,26,0,0,0,104,WAS,18,29,17,36,0,0,0,100,20040201
2004,LAC,27,22,29,23,0,0,0,101,ATL,24,26,22,23,0,0,0,95,20040202
2004,POR,21,36,21,19,0,0,0,97,DEN,36,23,28,29,0,0,0,116,20040202
2004,LAL,10,16,26,20,0,0,0,72,IND,20,21,25,19,0,0,0,85,20040202
2004,GSW,29,27,26,19,0,0,0,101,MEM,26,35,17,28,0,0,0,106,20040202
2004,DET,30,22,23,21,6,0,0,102,MIA,19,26,24,27,4,0,0,100,20040202
2004,NJN,19,12,35,25,0,0,0,91,NOH,24,13,17,16,0,0,0,70,20040202
2004,HOU,11,25,22,21,0,0,0,79,PHO,28,13,32,26,0,0,0,99,20040202
2004,CHI,26,28,18,25,0,0,0,97,SEA,33,21,28,27,0,0,0,109,20040202
2004,SAS,21,20,23,19,0,0,0,83,UTA,15,19,14,17,0,0,0,65,20040202
2004,GSW,24,22,20,27,0,0,0,93,DAL,17,32,29,29,0,0,0,107,20040203
2004,CLE,32,18,17,18,0,0,0,85,DET,20,24,27,11,0,0,0,82,20040203
2004,ORL,26,22,24,28,0,0,0,100,MIN,24,27,33,29,0,0,0,113,20040203
2004,IND,20,23,26,21,0,0,0,90,NYK,23,24,20,30,0,0,0,97,20040203
2004,TOR,21,23,23,26,0,0,0,93,PHI,24,13,25,18,0,0,0,80,20040203
2004,SEA,34,27,20,20,0,0,0,101,SAC,26,30,33,28,0,0,0,117,20040203
2004,MIN,22,24,27,16,0,0,0,89,ATL,20,23,27,27,0,0,0,97,20040204
2004,LAC,25,21,24,25,0,0,0,95,BOS,24,23,27,12,0,0,0,86,20040204
2004,LAL,24,22,19,27,19,0,0,111,CLE,22,19,28,23,14,0,0,106,20040204
2004,MIL,25,22,15,27,0,0,0,89,HOU,22,28,25,28,0,0,0,103,20040204
2004,MIA,18,21,26,23,0,0,0,88,NJN,23,23,28,25,0,0,0,99,20040204
2004,DAL,21,27,33,32,0,0,0,113,NOH,26,25,23,30,0,0,0,104,20040204
2004,POR,31,37,19,14,0,0,0,101,PHO,17,33,22,25,0,0,0,97,20040204
2004,ORL,28,15,24,23,0,0,0,90,TOR,26,37,28,19,0,0,0,110,20040204
2004,CHI,23,24,29,19,0,0,0,95,UTA,20,12,22,25,0,0,0,79,20040204
2004,MEM,26,24,21,32,0,0,0,103,WAS,29,25,30,17,0,0,0,101,20040204
2004,LAL,10,19,21,23,0,0,0,73,PHI,25,19,33,19,0,0,0,96,20040205
2004,SAS,28,26,23,19,0,0,0,96,SEA,20,20,31,19,0,0,0,90,20040205
2004,ATL,28,30,17,25,0,0,0,100,BOS,28,15,27,26,0,0,0,96,20040206
2004,DEN,12,22,26,27,0,0,0,87,GSW,23,16,24,33,0,0,0,96,20040206
2004,CHI,23,14,11,32,0,0,0,80,HOU,26,15,21,20,0,0,0,82,20040206
2004,MIL,24,24,20,17,0,0,0,85,MEM,31,26,28,20,0,0,0,105,20040206
2004,CLE,22,34,21,15,0,0,0,92,MIN,26,25,27,25,0,0,0,103,20040206
2004,ORL,27,22,25,25,0,0,0,99,NJN,30,33,39,18,0,0,0,120,20040206
2004,DET,18,26,14,23,0,0,0,81,NOH,26,24,22,20,0,0,0,92,20040206
2004,SEA,26,33,29,19,0,0,0,107,PHO,25,29,23,28,0,0,0,105,20040206
2004,SAS,32,13,28,29,0,0,0,102,SAC,21,22,22,29,0,0,0,94,20040206
2004,IND,23,19,25,16,0,0,0,83,TOR,18,19,19,21,0,0,0,77,20040206
2004,POR,14,25,25,23,0,0,0,87,UTA,22,19,13,19,0,0,0,73,20040206
2004,LAC,24,27,29,20,0,0,0,100,WAS,35,29,19,29,0,0,0,112,20040206
2004,HOU,26,12,13,35,0,0,0,86,ATL,20,21,21,15,0,0,0,77,20040207
2004,WAS,27,18,33,28,0,0,0,106,CLE,31,17,15,25,0,0,0,88,20040207
2004,DET,32,26,19,31,0,0,0,108,DAL,26,29,23,33,0,0,0,111,20040207
2004,NYK,19,24,20,13,0,0,0,76,MIA,17,19,18,10,0,0,0,64,20040207
2004,NOH,20,26,17,34,0,0,0,97,MIL,30,22,31,24,0,0,0,107,20040207
2004,BOS,31,28,26,25,0,0,0,110,PHI,23,16,18,23,0,0,0,80,20040207
2004,UTA,21,20,29,26,0,0,0,96,PHO,16,19,26,31,0,0,0,92,20040207
2004,TOR,23,16,18,18,9,0,0,84,GSW,17,29,27,2,6,0,0,81,20040208
2004,MIA,23,23,18,27,0,0,0,91,IND,27,23,20,27,0,0,0,97,20040208
2004,MEM,30,21,25,23,0,0,0,99,MIN,16,33,25,24,0,0,0,98,20040208
2004,PHI,25,24,24,14,0,0,0,87,NJN,28,20,29,22,0,0,0,99,20040208
2004,LAC,25,26,28,25,0,0,0,104,NYK,31,27,22,30,0,0,0,110,20040208
2004,LAL,29,19,19,31,0,0,0,98,ORL,21,32,28,15,0,0,0,96,20040208
2004,SEA,23,19,17,26,0,0,0,85,POR,23,21,29,22,0,0,0,95,20040208
2004,DEN,26,25,23,18,0,0,0,92,SAC,27,27,27,34,0,0,0,115,20040208
2004,DAL,29,21,22,24,0,0,0,96,ATL,36,18,15,33,0,0,0,102,20040209
2004,BOS,14,34,28,13,0,0,0,89,CLE,24,29,25,19,0,0,0,97,20040209
2004,MEM,23,26,19,15,0,0,0,83,DEN,25,24,21,16,0,0,0,86,20040209
2004,SAS,22,16,25,22,0,0,0,85,HOU,16,19,17,30,0,0,0,82,20040209
2004,IND,21,29,30,23,0,0,0,103,CHI,21,17,24,22,0,0,0,84,20040210
2004,NYK,27,17,25,21,0,0,0,90,DAL,21,28,27,29,0,0,0,105,20040210
2004,LAL,19,29,21,29,0,0,0,98,MIA,23,19,20,21,0,0,0,83,20040210
2004,SAC,37,28,26,33,0,0,0,124,MIL,24,38,26,29,0,0,0,117,20040210
2004,LAC,16,25,26,17,0,0,0,84,MIN,29,22,27,18,0,0,0,96,20040210
2004,DET,29,13,20,16,0,0,0,78,NJN,16,30,25,18,0,0,0,89,20040210
2004,TOR,26,18,32,25,0,0,0,101,PHO,26,23,23,22,0,0,0,94,20040210
2004,UTA,16,19,23,28,0,0,0,86,POR,21,17,19,24,0,0,0,81,20040210
2004,GSW,27,16,36,27,0,0,0,106,SEA,23,22,26,26,0,0,0,97,20040210
2004,NJN,16,24,37,28,0,0,0,105,CLE,22,18,24,21,0,0,0,85,20040211
2004,SAC,32,17,28,19,0,0,0,96,DET,20,30,23,21,0,0,0,94,20040211
2004,PHO,14,25,31,29,0,0,0,99,GSW,32,26,25,27,0,0,0,110,20040211
2004,LAL,23,22,20,22,0,0,0,87,HOU,26,20,27,29,0,0,0,102,20040211
2004,LAC,19,28,29,26,0,0,0,102,MEM,30,34,25,21,0,0,0,110,20040211
2004,NYK,27,27,19,25,0,0,0,98,NOH,25,24,34,23,0,0,0,106,20040211
2004,MIA,27,37,23,24,0,0,0,111,ORL,20,27,25,26,0,0,0,98,20040211
2004,WAS,19,22,24,23,0,0,0,88,PHI,27,29,29,28,0,0,0,113,20040211
2004,MIN,14,17,25,21,0,0,0,77,UTA,15,17,19,15,0,0,0,66,20040211
2004,BOS,25,21,19,22,0,0,0,87,CHI,29,32,31,15,0,0,0,107,20040212
2004,DEN,27,27,25,28,0,0,0,107,POR,22,27,17,32,0,0,0,98,20040212
2004,TOR,19,15,21,19,0,0,0,74,SEA,23,26,21,24,0,0,0,94,20040212
2004,TOR,17,16,23,17,0,0,0,73,CHI,24,22,20,9,0,0,0,75,20040217
2004,PHI,19,35,18,13,0,0,0,85,DEN,32,25,26,23,0,0,0,106,20040217
2004,WAS,18,19,16,28,0,0,0,81,HOU,30,27,27,23,0,0,0,107,20040217
2004,NOH,27,26,22,14,0,0,0,89,IND,22,23,14,16,0,0,0,75,20040217
2004,POR,24,16,22,24,0,0,0,86,LAL,25,18,27,19,0,0,0,89,20040217
2004,DAL,20,27,27,18,0,0,0,92,MEM,21,33,27,28,0,0,0,109,20040217
2004,UTA,16,21,26,22,0,0,0,85,MIA,23,27,21,26,0,0,0,97,20040217
2004,ORL,20,26,27,31,0,0,0,104,MIL,37,34,26,30,0,0,0,127,20040217
2004,PHO,23,27,24,21,0,0,0,95,MIN,31,28,19,32,0,0,0,110,20040217
2004,DET,21,19,18,30,0,0,0,88,NYK,29,20,16,27,0,0,0,92,20040217
2004,BOS,20,27,35,29,0,0,0,111,SAC,32,29,38,28,0,0,0,127,20040217
2004,DAL,27,36,32,19,0,0,0,114,CLE,29,24,24,21,0,0,0,98,20040218
2004,MIL,33,14,14,37,0,0,0,98,DET,20,30,26,26,0,0,0,102,20040218
2004,LAL,24,28,28,20,0,0,0,100,GSW,25,26,25,23,0,0,0,99,20040218
2004,ATL,20,19,29,24,0,0,0,92,NJN,20,23,25,30,0,0,0,98,20040218
2004,WAS,29,22,18,29,0,0,0,98,NOH,26,28,37,29,0,0,0,120,20040218
2004,UTA,17,12,24,24,0,0,0,77,ORL,22,12,34,22,0,0,0,90,20040218
2004,LAC,24,17,21,24,0,0,0,86,POR,14,34,25,28,0,0,0,101,20040218
2004,SAS,15,19,18,34,0,0,0,86,TOR,24,15,19,24,0,0,0,82,20040218
2004,BOS,36,22,17,25,0,0,0,100,LAC,31,28,26,17,0,0,0,102,20040219
2004,SAC,16,18,26,15,0,0,0,75,MIN,23,20,20,29,0,0,0,92,20040219
2004,PHI,32,27,24,29,0,0,0,112,SEA,25,24,25,27,0,0,0,101,20040219
2004,SAC,24,25,23,19,0,0,0,91,CHI,25,19,26,13,0,0,0,83,20040220
2004,SAS,13,22,29,23,0,0,0,87,CLE,14,25,23,27,0,0,0,89,20040220
2004,MIN,25,22,20,21,0,0,0,88,DET,20,21,21,25,0,0,0,87,20040220
2004,POR,25,25,26,18,0,0,0,94,GSW,21,24,30,18,0,0,0,93,20040220
2004,PHI,21,30,19,18,0,0,0,88,LAL,27,32,28,29,0,0,0,116,20040220
2004,PHO,26,25,26,15,0,0,0,92,MEM,36,20,21,20,0,0,0,97,20040220
2004,ATL,20,22,21,29,0,0,0,92,MIA,36,37,28,24,0,0,0,125,20040220
2004,UTA,17,26,24,25,0,0,0,92,NYK,11,17,22,28,0,0,0,78,20040220
2004,DEN,32,26,22,18,0,0,0,98,ORL,22,33,24,23,0,0,0,102,20040220
2004,NJN,25,25,19,22,0,0,0,91,TOR,16,22,21,13,0,0,0,72,20040220
2004,IND,26,24,18,28,0,0,0,96,WAS,18,21,32,16,0,0,0,87,20040220
2004,MEM,29,29,18,29,0,0,0,105,CHI,20,24,28,26,0,0,0,98,20040221
2004,HOU,30,21,15,22,0,0,0,88,DAL,16,31,31,19,0,0,0,97,20040221
2004,SEA,23,23,20,26,0,0,0,92,GSW,22,22,21,29,0,0,0,94,20040221
2004,DEN,24,21,21,15,0,0,0,81,MIA,17,23,35,22,0,0,0,97,20040221
2004,LAC,29,18,30,28,0,0,0,105,MIL,22,21,33,27,0,0,0,103,20040221
2004,NOH,24,20,24,16,0,0,0,84,NJN,25,26,23,23,0,0,0,97,20040221
2004,BOS,16,20,18,30,0,0,0,84,POR,32,22,33,18,0,0,0,105,20040221
2004,ORL,22,19,17,29,0,0,0,87,DET,28,20,17,21,0,0,0,86,20040222
2004,ATL,31,20,20,23,13,7,7,121,HOU,30,19,20,25,13,7,9,123,20040222
2004,UTA,19,25,22,14,0,0,0,80,IND,17,26,24,27,0,0,0,94,20040222
2004,SAS,30,20,20,24,0,0,0,94,MIN,23,18,23,28,0,0,0,92,20040222
2004,CLE,24,20,26,22,0,0,0,92,NYK,24,16,15,31,0,0,0,86,20040222
2004,LAL,29,17,28,30,0,0,0,104,PHO,20,27,22,23,0,0,0,92,20040222
2004,BOS,25,16,26,20,0,0,0,87,SEA,27,24,25,32,0,0,0,108,20040222
2004,SAC,22,17,30,27,0,0,0,96,TOR,25,22,20,14,0,0,0,81,20040222
2004,MIL,26,30,31,26,0,0,0,113,WAS,24,24,14,23,0,0,0,85,20040222
2004,NOH,37,22,18,23,0,0,0,100,CLE,16,29,28,31,0,0,0,104,20040223
2004,DEN,24,25,30,27,0,0,0,106,MEM,26,31,23,29,0,0,0,109,20040223
2004,POR,22,16,21,30,0,0,0,89,MIA,18,26,20,17,0,0,0,81,20040223
2004,DET,25,18,18,15,0,0,0,76,PHI,16,19,15,16,0,0,0,66,20040223
2004,PHI,17,21,15,22,0,0,0,75,ATL,26,22,24,14,0,0,0,86,20040224
2004,LAC,18,25,23,25,0,0,0,91,DAL,36,29,27,24,0,0,0,116,20040224
2004,GSW,25,26,23,22,0,0,0,96,IND,23,29,28,27,0,0,0,107,20040224
2004,MIN,30,27,29,22,0,0,0,108,MIL,23,24,18,37,0,0,0,102,20040224
2004,TOR,15,17,25,17,0,0,0,74,NJN,19,28,26,13,0,0,0,86,20040224
2004,POR,19,24,17,23,11,0,0,94,ORL,20,20,19,24,8,0,0,91,20040224
2004,NYK,30,22,26,21,0,0,0,99,SAC,35,20,23,29,0,0,0,107,20040224
2004,HOU,21,23,17,16,0,0,0,77,SAS,28,16,23,19,0,0,0,86,20040224
2004,SEA,26,20,30,10,0,0,0,86,UTA,31,23,19,26,0,0,0,99,20040224
2004,MIL,28,32,24,22,0,0,0,106,BOS,40,20,24,20,0,0,0,104,20040225
2004,DET,17,34,33,23,0,0,0,107,CHI,22,21,28,17,0,0,0,88,20040225
2004,LAL,25,25,27,35,0,0,0,112,DEN,28,34,26,23,0,0,0,111,20040225
2004,CLE,16,17,28,23,0,0,0,84,HOU,18,21,21,30,0,0,0,90,20040225
2004,GSW,30,16,25,28,0,0,0,99,MEM,21,27,21,23,0,0,0,92,20040225
2004,NJN,20,12,22,14,0,0,0,68,MIN,12,20,23,26,0,0,0,81,20040225
2004,LAC,26,23,22,22,0,0,0,93,NOH,27,23,23,26,0,0,0,99,20040225
2004,NYK,17,21,30,27,0,0,0,95,PHO,31,25,24,33,0,0,0,113,20040225
2004,UTA,16,24,23,21,9,0,0,93,SEA,17,19,33,15,8,0,0,92,20040225
2004,WAS,19,20,17,20,0,0,0,76,TOR,18,10,22,24,0,0,0,74,20040225
2004,SAS,23,21,32,15,0,0,0,91,DAL,23,25,46,21,0,0,0,115,20040226
2004,SAC,28,21,31,23,0,0,0,103,LAL,29,28,24,20,0,0,0,101,20040226
2004,CHI,18,31,23,15,0,0,0,87,WAS,24,23,28,20,0,0,0,95,20040226
2004,TOR,20,17,23,15,0,0,0,75,BOS,30,27,16,15,0,0,0,88,20040227
2004,ATL,21,17,23,22,0,0,0,83,DET,38,28,23,16,0,0,0,105,20040227
2004,POR,24,26,14,21,0,0,0,85,HOU,27,22,18,22,0,0,0,89,20040227
2004,NYK,27,28,22,17,0,0,0,94,LAC,35,27,21,13,0,0,0,96,20040227
2004,MEM,29,22,29,24,0,0,0,104,MIL,28,29,21,28,0,0,0,106,20040227
2004,GSW,25,20,17,19,0,0,0,81,MIN,27,15,26,23,0,0,0,91,20040227
2004,IND,17,17,21,22,0,0,0,77,NOH,22,24,24,19,0,0,0,89,20040227
2004,CLE,30,23,27,20,12,0,0,112,ORL,25,19,22,34,7,0,0,107,20040227
2004,UTA,14,26,28,34,0,0,0,102,SAC,22,20,29,26,0,0,0,97,20040227
2004,PHO,29,28,24,23,0,0,0,104,SEA,20,27,24,28,0,0,0,99,20040227
2004,ORL,23,35,18,28,0,0,0,104,ATL,28,21,23,27,0,0,0,99,20040228
2004,GSW,17,17,21,22,4,0,0,81,CHI,26,15,20,16,10,0,0,87,20040228
2004,POR,21,27,22,21,0,0,0,91,DAL,27,39,14,31,0,0,0,111,20040228
2004,PHI,14,22,11,27,0,0,0,74,IND,23,18,20,20,0,0,0,81,20040228
2004,NOH,29,16,13,34,0,0,0,92,MEM,23,26,24,24,0,0,0,97,20040228
2004,MIA,22,26,14,24,0,0,0,86,NJN,20,18,23,31,0,0,0,92,20040228
2004,DEN,23,24,23,22,0,0,0,92,SAS,30,23,29,35,0,0,0,117,20040228
2004,LAL,30,28,30,34,0,0,0,122,WAS,28,21,34,27,0,0,0,110,20040228
2004,NYK,21,22,29,24,0,0,0,96,DEN,31,21,32,23,0,0,0,107,20040229
2004,SEA,18,23,27,29,0,0,0,97,HOU,17,18,22,23,0,0,0,80,20040229
2004,DET,24,27,18,31,0,0,0,100,LAC,33,22,17,16,0,0,0,88,20040229
2004,MIA,24,21,22,37,0,0,0,104,MIL,21,34,31,22,0,0,0,108,20040229
2004,LAL,26,23,26,25,0,0,0,100,NJN,17,18,16,32,0,0,0,83,20040229
2004,MIN,23,19,19,13,0,0,0,74,PHI,25,20,15,21,0,0,0,81,20040229
2004,PHO,18,29,26,21,0,0,0,94,SAC,25,29,28,26,0,0,0,108,20040229
2004,BOS,16,23,23,29,0,0,0,91,TOR,22,13,26,21,0,0,0,82,20040229
2004,ORL,26,31,25,14,0,0,0,96,BOS,27,29,31,30,0,0,0,117,20040301
2004,CLE,23,14,19,25,0,0,0,81,CHI,21,30,23,18,0,0,0,92,20040301
2004,MEM,21,22,14,24,0,0,0,81,SAS,26,21,21,12,0,0,0,80,20040301
2004,DET,20,27,19,20,0,0,0,86,UTA,25,17,21,31,0,0,0,94,20040301
2004,NOH,26,14,32,24,10,0,0,106,WAS,30,28,28,10,15,0,0,111,20040301
2004,LAL,22,17,32,22,0,0,0,93,ATL,22,20,27,25,0,0,0,94,20040302
2004,SEA,25,20,26,25,0,0,0,96,DAL,20,27,22,38,0,0,0,107,20040302
2004,NJN,22,20,31,22,0,0,0,95,DEN,30,18,21,22,0,0,0,91,20040302
2004,IND,28,24,19,25,0,0,0,96,GSW,17,19,27,25,0,0,0,88,20040302
2004,TOR,15,37,26,11,0,0,0,89,MIA,30,24,24,8,0,0,0,86,20040302
2004,LAC,33,21,24,28,0,0,0,106,SAC,33,27,22,31,0,0,0,113,20040302
2004,ATL,19,22,19,20,0,0,0,80,CLE,36,27,22,27,0,0,0,112,20040303
2004,LAL,29,14,19,34,0,0,0,96,HOU,25,28,18,22,0,0,0,93,20040303
2004,IND,27,24,15,21,14,0,0,101,LAC,21,31,16,19,7,0,0,94,20040303
2004,DAL,23,39,16,19,0,0,0,97,MIN,34,33,30,24,0,0,0,121,20040303
2004,CHI,24,22,24,21,6,0,0,97,NOH,20,20,31,20,9,0,0,100,20040303
2004,PHI,23,14,17,23,0,0,0,77,NYK,28,21,17,22,0,0,0,88,20040303
2004,MIL,35,16,25,29,0,0,0,105,ORL,29,23,13,32,0,0,0,97,20040303
2004,NJN,18,15,22,19,0,0,0,74,PHO,18,19,33,17,0,0,0,87,20040303
2004,MEM,21,24,30,22,0,0,0,97,POR,19,26,21,22,0,0,0,88,20040303
2004,SEA,13,23,18,30,0,0,0,84,SAS,22,15,30,21,0,0,0,88,20040303
2004,TOR,18,24,15,13,0,0,0,70,WAS,22,20,23,19,0,0,0,84,20040303
2004,MIL,23,26,29,20,0,0,0,98,MIA,39,21,22,22,0,0,0,104,20040304
2004,SAC,31,30,23,30,0,0,0,114,PHI,28,19,33,25,0,0,0,105,20040304
2004,DET,27,19,18,19,0,0,0,83,POR,16,13,14,25,0,0,0,68,20040304
2004,WAS,24,25,16,25,0,0,0,90,BOS,17,22,21,34,0,0,0,94,20040305
2004,NJN,13,17,28,20,0,0,0,78,GSW,18,21,19,16,0,0,0,74,20040305
2004,SEA,22,25,28,16,0,0,0,91,LAL,28,28,23,20,0,0,0,99,20040305
2004,HOU,36,28,20,28,0,0,0,112,MIN,28,37,24,20,0,0,0,109,20040305
2004,CLE,21,18,29,20,0,0,0,88,NOH,23,20,19,23,0,0,0,85,20040305
2004,ATL,22,23,26,25,0,0,0,96,ORL,22,31,18,30,0,0,0,101,20040305
2004,DAL,18,15,27,40,0,0,0,100,SAS,29,30,27,27,0,0,0,113,20040305
2004,NYK,28,28,32,21,0,0,0,109,TOR,35,25,29,14,0,0,0,103,20040305
2004,IND,35,22,15,24,0,0,0,96,UTA,23,21,22,22,0,0,0,88,20040305
2004,MIL,28,24,24,21,0,0,0,97,CLE,39,22,20,25,0,0,0,106,20040306
2004,DET,21,35,19,22,0,0,0,97,DEN,21,16,10,19,0,0,0,66,20040306
2004,MEM,23,26,24,25,0,0,0,98,LAC,23,29,19,21,0,0,0,92,20040306
2004,SAC,23,16,30,27,0,0,0,96,MIA,23,25,21,33,0,0,0,102,20040306
2004,CHI,26,23,24,15,0,0,0,88,PHI,28,18,21,30,0,0,0,97,20040306
2004,SAS,25,31,22,29,0,0,0,107,PHO,18,23,19,26,0,0,0,86,20040306
2004,UTA,18,19,19,14,0,0,0,70,POR,30,15,26,20,0,0,0,91,20040306
2004,IND,29,24,26,24,0,0,0,103,DEN,22,19,27,26,0,0,0,94,20040307
2004,MEM,26,20,32,17,0,0,0,95,GSW,29,25,15,16,0,0,0,85,20040307
2004,DAL,26,21,21,30,0,0,0,98,HOU,26,24,20,31,0,0,0,101,20040307
2004,POR,20,21,12,18,0,0,0,71,LAC,24,26,23,18,0,0,0,91,20040307
2004,NJN,24,24,22,18,0,0,0,88,LAL,23,23,25,23,0,0,0,94,20040307
2004,BOS,11,24,18,27,0,0,0,80,MIN,14,23,21,19,0,0,0,77,20040307
2004,SAC,25,28,31,23,0,0,0,107,ORL,26,28,18,18,0,0,0,90,20040307
2004,DET,25,26,20,15,0,0,0,86,SEA,13,20,15,17,0,0,0,65,20040307
2004,NOH,20,23,11,22,0,0,0,76,TOR,21,23,25,15,0,0,0,84,20040307
2004,NYK,24,28,23,24,0,0,0,99,WAS,22,24,16,24,0,0,0,86,20040307
2004,CLE,34,16,30,28,0,0,0,108,ATL,15,36,25,26,0,0,0,102,20040308
2004,PHO,23,18,25,24,0,0,0,90,DAL,27,29,23,24,0,0,0,103,20040308
2004,MIL,27,30,17,18,0,0,0,92,PHI,13,31,25,28,0,0,0,97,20040308
2004,LAL,22,16,17,28,0,0,0,83,UTA,14,25,18,31,0,0,0,88,20040308
2004,PHI,23,13,24,29,0,0,0,89,CHI,22,18,21,20,0,0,0,81,20040309
2004,LAC,20,19,27,19,0,0,0,85,HOU,18,18,29,25,0,0,0,90,20040309
2004,TOR,26,24,13,18,3,0,0,84,IND,25,21,18,17,13,0,0,94,20040309
2004,SAS,18,18,31,21,0,0,0,88,MEM,24,22,17,31,0,0,0,94,20040309
2004,ORL,24,23,25,17,0,0,0,89,MIA,29,25,20,26,0,0,0,100,20040309
2004,BOS,18,28,16,25,0,0,0,87,NYK,16,23,21,24,0,0,0,84,20040309
2004,GSW,22,22,18,30,0,0,0,92,SAC,23,22,23,28,0,0,0,96,20040309
2004,MIN,25,23,27,30,0,0,0,105,SEA,25,27,19,21,0,0,0,92,20040309
2004,DEN,21,25,32,39,0,0,0,117,WAS,23,16,20,28,0,0,0,87,20040309
2004,LAL,32,36,21,28,0,0,0,117,BOS,28,32,21,28,0,0,0,109,20040310
2004,CHI,16,20,14,15,0,0,0,65,DET,23,29,21,25,0,0,0,98,20040310
2004,ATL,28,12,21,19,0,0,0,80,MIL,23,23,24,24,0,0,0,94,20040310
2004,DEN,27,14,27,29,0,0,0,97,NJN,25,27,25,21,0,0,0,98,20040310
2004,MIA,21,30,20,13,0,0,0,84,NOH,26,22,24,23,0,0,0,95,20040310
2004,WAS,14,26,32,27,0,0,0,99,ORL,15,34,32,27,0,0,0,108,20040310
2004,MIN,19,14,21,25,0,0,0,79,POR,16,27,23,26,0,0,0,92,20040310
2004,LAC,18,24,24,24,0,0,0,90,SAS,37,32,21,18,0,0,0,108,20040310
2004,CLE,30,30,22,24,0,0,0,106,TOR,21,26,24,21,0,0,0,92,20040310
2004,GSW,14,16,26,21,0,0,0,77,UTA,25,31,19,16,0,0,0,91,20040310
2004,NOH,21,13,22,30,0,0,0,86,HOU,21,28,24,24,0,0,0,97,20040311
2004,DAL,27,25,24,26,0,0,0,102,SAC,37,27,24,32,0,0,0,120,20040311
2004,WAS,32,30,26,36,0,0,0,124,ATL,26,29,45,38,0,0,0,138,20040312
2004,IND,22,26,24,27,0,0,0,99,BOS,20,19,14,28,0,0,0,81,20040312
2004,LAC,22,17,24,26,0,0,0,89,MEM,27,20,25,26,0,0,0,98,20040312
2004,SEA,8,17,24,25,0,0,0,74,MIA,20,16,18,28,0,0,0,82,20040312
2004,DEN,30,22,36,29,0,0,0,117,MIL,26,21,34,30,0,0,0,111,20040312
2004,LAL,21,20,28,17,0,0,0,86,MIN,23,22,29,22,0,0,0,96,20040312
2004,CHI,10,22,26,18,0,0,0,76,NJN,26,16,17,29,0,0,0,88,20040312
2004,NYK,21,26,19,21,5,2,0,94,PHI,23,12,25,27,5,7,0,99,20040312
2004,UTA,28,21,22,28,0,0,0,99,PHO,21,18,23,28,0,0,0,90,20040312
2004,SAC,26,15,17,23,0,0,0,81,POR,22,23,24,14,0,0,0,83,20040312
2004,GSW,13,21,25,15,0,0,0,74,SAS,17,31,21,30,0,0,0,99,20040312
2004,LAL,20,21,27,20,0,0,0,88,CHI,22,18,24,17,0,0,0,81,20040313
2004,MEM,21,20,21,18,0,0,0,80,HOU,23,29,20,16,0,0,0,88,20040313
2004,GSW,22,26,18,18,0,0,0,84,NOH,35,23,22,22,0,0,0,102,20040313
2004,SEA,25,26,31,33,0,0,0,115,ORL,25,20,33,23,0,0,0,101,20040313
2004,DAL,38,32,24,19,0,0,0,113,PHO,21,21,34,14,0,0,0,90,20040313
2004,BOS,27,27,25,32,0,0,0,111,WAS,30,30,23,19,0,0,0,102,20040313
2004,IND,26,32,28,18,0,0,0,104,CLE,26,36,26,19,0,0,0,107,20040314
2004,UTA,17,16,24,18,0,0,0,75,DEN,28,19,30,25,0,0,0,102,20040314
2004,PHI,18,20,17,14,0,0,0,69,DET,22,24,22,17,0,0,0,85,20040314
2004,DAL,29,23,23,26,0,0,0,101,LAC,24,19,22,23,0,0,0,88,20040314
2004,NJN,24,20,25,26,0,0,0,95,MIA,24,27,29,24,0,0,0,104,20040314
2004,NYK,19,20,35,29,0,0,0,103,MIL,31,30,19,20,0,0,0,100,20040314
2004,POR,33,20,25,14,0,0,0,92,MIN,21,23,21,18,0,0,0,83,20040314
2004,SAS,27,20,21,19,0,0,0,87,SAC,25,21,22,33,0,0,0,101,20040314
2004,ATL,22,22,20,20,0,0,0,84,TOR,32,22,19,28,0,0,0,101,20040314
2004,SAS,13,20,23,24,0,0,0,80,GSW,22,23,23,29,0,0,0,97,20040315
2004,PHO,15,20,32,21,11,0,0,99,HOU,33,15,18,22,9,0,0,97,20040315
2004,ORL,34,27,27,14,8,0,0,110,LAL,27,23,23,29,11,0,0,113,20040315
2004,SEA,20,43,21,34,0,0,0,118,ATL,34,17,30,29,0,0,0,110,20040316
2004,CHI,29,20,16,22,0,0,0,87,CLE,34,22,29,26,0,0,0,111,20040316
2004,PHI,22,23,21,13,0,0,0,79,MEM,16,18,23,25,0,0,0,82,20040316
2004,NOH,13,30,22,18,0,0,0,83,MIA,23,26,21,26,0,0,0,96,20040316
2004,POR,31,27,24,18,0,0,0,100,MIL,22,25,28,24,0,0,0,99,20040316
2004,SAC,9,26,20,22,0,0,0,77,NJN,26,28,21,19,0,0,0,94,20040316
2004,WAS,27,22,22,25,14,0,0,110,NYK,19,28,27,22,18,0,0,114,20040316
2004,LAC,24,37,26,23,0,0,0,110,PHO,28,26,18,26,0,0,0,98,20040316
2004,DEN,27,29,22,22,0,0,0,100,BOS,26,23,33,22,0,0,0,104,20040317
2004,ATL,40,29,21,21,0,0,0,111,DAL,25,19,32,34,0,0,0,110,20040317
2004,ORL,25,24,16,20,0,0,0,85,GSW,29,31,16,34,0,0,0,110,20040317
2004,POR,18,24,21,8,0,0,0,71,IND,31,12,17,20,0,0,0,80,20040317
2004,LAL,36,29,21,20,0,0,0,106,LAC,25,25,27,26,0,0,0,103,20040317
2004,PHI,24,29,11,16,0,0,0,80,NOH,26,25,22,31,0,0,0,104,20040317
2004,UTA,24,16,27,14,0,0,0,81,TOR,14,21,24,26,0,0,0,85,20040317
2004,SAC,31,24,20,33,0,0,0,108,WAS,31,19,34,30,0,0,0,114,20040317
2004,SEA,30,26,13,28,0,0,0,97,MEM,23,21,20,30,0,0,0,94,20040318
2004,DET,20,34,14,21,0,0,0,89,NJN,19,16,21,15,0,0,0,71,20040318
2004,MIN,16,22,20,28,0,0,0,86,SAS,21,22,29,34,0,0,0,106,20040318
2004,UTA,25,22,21,29,0,0,0,97,CLE,17,22,26,23,0,0,0,88,20040319
2004,BOS,14,32,28,30,0,0,0,104,DAL,32,27,26,35,0,0,0,120,20040319
2004,DEN,21,20,24,10,0,0,0,75,DET,28,24,18,24,0,0,0,94,20040319
2004,HOU,19,18,17,30,0,0,0,84,GSW,20,21,12,37,0,0,0,90,20040319
2004,SAC,22,25,24,23,0,0,0,94,IND,35,23,14,20,0,0,0,92,20040319
2004,LAC,27,22,17,34,0,0,0,100,LAL,20,32,22,32,0,0,0,106,20040319
2004,SEA,17,21,26,27,0,0,0,91,NOH,27,14,18,21,0,0,0,80,20040319
2004,NJN,20,19,12,14,0,0,0,65,NYK,28,17,22,12,0,0,0,79,20040319
2004,MIN,16,19,29,29,0,0,0,93,PHO,17,20,23,20,0,0,0,80,20040319
2004,CHI,27,17,22,30,0,0,0,96,TOR,23,22,15,31,0,0,0,91,20040319
2004,ATL,19,29,16,20,0,0,0,84,WAS,22,23,30,19,0,0,0,94,20040319
2004,UTA,22,25,17,23,0,0,0,87,ATL,20,24,23,14,0,0,0,81,20040320
2004,NYK,18,22,24,17,0,0,0,81,CHI,27,23,17,20,0,0,0,87,20040320
2004,IND,36,20,23,16,0,0,0,95,MEM,25,27,29,18,0,0,0,99,20040320
2004,PHI,16,14,29,10,0,0,0,69,MIA,19,24,28,30,0,0,0,101,20040320
2004,MIL,29,27,23,32,0,0,0,111,PHO,33,35,28,27,0,0,0,123,20040320
2004,ORL,25,17,14,17,0,0,0,73,POR,32,15,24,21,0,0,0,92,20040320
2004,BOS,27,26,18,16,0,0,0,87,SAS,30,27,25,21,0,0,0,103,20040320
2004,DET,27,26,24,19,0,0,0,96,CLE,18,13,25,20,0,0,0,76,20040321
2004,GSW,27,29,19,21,0,0,0,96,LAC,14,28,16,27,0,0,0,85,20040321
2004,MIL,19,24,29,20,11,0,0,103,LAL,20,35,23,14,12,0,0,104,20040321
2004,DEN,15,10,22,30,0,0,0,77,MIN,24,23,26,25,0,0,0,98,20040321
2004,DAL,18,26,26,31,0,0,0,101,NJN,25,20,29,24,0,0,0,98,20040321
2004,TOR,27,26,27,29,12,0,0,121,NOH,20,37,29,23,11,0,0,120,20040321
2004,HOU,26,28,22,19,0,0,0,95,SAC,18,26,27,29,0,0,0,100,20040321
2004,ORL,12,27,17,11,0,0,0,67,SEA,26,24,16,18,0,0,0,84,20040321
2004,MIA,17,32,34,18,0,0,0,101,WAS,25,15,20,21,0,0,0,81,20040321
2004,LAC,15,30,20,15,0,0,0,80,DEN,31,22,22,27,0,0,0,102,20040322
2004,CHI,18,14,21,24,0,0,0,77,IND,29,20,28,24,0,0,0,101,20040322
2004,ATL,29,15,24,16,0,0,0,84,NYK,25,25,25,21,0,0,0,96,20040322
2004,DAL,23,34,17,24,0,0,0,98,PHI,26,35,23,23,0,0,0,107,20040322
2004,HOU,22,26,16,19,10,0,0,93,POR,11,27,19,26,2,0,0,85,20040322
2004,NJN,23,15,23,23,0,0,0,84,CHI,17,23,24,17,0,0,0,81,20040323
2004,PHO,34,26,19,24,0,0,0,103,CLE,24,17,26,19,0,0,0,86,20040323
2004,TOR,25,15,21,25,0,0,0,86,MEM,23,31,19,22,0,0,0,95,20040323
2004,SAS,22,25,15,19,0,0,0,81,MIN,35,12,21,18,0,0,0,86,20040323
2004,DET,33,12,17,19,0,0,0,81,NOH,21,23,13,25,0,0,0,82,20040323
2004,MIL,32,21,25,34,0,0,0,112,SAC,26,24,23,28,0,0,0,101,20040323
2004,WAS,21,19,22,15,0,0,0,77,UTA,23,29,13,20,0,0,0,85,20040323
2004,MIN,19,28,22,23,0,0,0,92,DEN,26,27,20,28,0,0,0,101,20040324
2004,MIL,18,20,28,23,0,0,0,89,GSW,26,21,25,26,0,0,0,98,20040324
2004,TOR,20,19,20,23,7,0,0,89,HOU,21,22,21,18,8,0,0,90,20040324
2004,DAL,30,25,19,25,0,0,0,99,IND,28,20,31,24,0,0,0,103,20040324
2004,SAC,14,33,25,19,0,0,0,91,LAL,33,32,29,21,0,0,0,115,20040324
2004,MEM,31,34,26,20,0,0,0,111,NYK,16,29,21,31,0,0,0,97,20040324
2004,MIA,27,29,31,18,0,0,0,105,ORL,23,22,24,21,0,0,0,90,20040324
2004,PHO,24,29,23,18,0,0,0,94,PHI,18,27,22,32,0,0,0,99,20040324
2004,LAC,25,24,16,20,0,0,0,85,POR,22,22,19,28,0,0,0,91,20040324
2004,UTA,13,15,24,25,0,0,0,77,SEA,14,27,22,21,0,0,0,84,20040324
2004,NOH,26,20,16,14,0,0,0,76,ATL,17,21,25,21,0,0,0,84,20040325
2004,WAS,25,28,22,28,0,0,0,103,LAC,16,30,22,26,0,0,0,94,20040325
2004,DET,19,23,18,15,0,0,0,75,SAS,18,20,24,22,0,0,0,84,20040325
2004,NJN,23,23,24,23,0,0,0,93,BOS,25,28,29,20,0,0,0,102,20040326
2004,MIL,34,27,27,27,0,0,0,115,CHI,24,28,24,29,0,0,0,105,20040326
2004,WAS,19,21,15,23,0,0,0,78,GSW,27,30,17,25,0,0,0,99,20040326
2004,MIN,21,21,12,19,0,0,0,73,LAL,25,25,28,12,0,0,0,90,20040326
2004,HOU,19,23,23,21,0,0,0,86,MEM,39,20,27,23,0,0,0,109,20040326
2004,DAL,29,25,30,22,12,0,0,118,MIA,28,29,24,25,13,0,0,119,20040326
2004,PHO,21,25,34,19,0,0,0,99,NOH,20,21,30,23,0,0,0,94,20040326
2004,TOR,29,26,22,24,0,0,0,101,NYK,26,25,22,35,0,0,0,108,20040326
2004,IND,21,29,28,29,0,0,0,107,ORL,21,21,25,25,0,0,0,92,20040326
2004,CLE,16,18,17,20,0,0,0,71,PHI,25,19,25,17,0,0,0,86,20040326
2004,DEN,25,22,18,21,0,0,0,86,SEA,19,26,29,28,0,0,0,102,20040326
2004,CHI,18,20,21,29,0,0,0,88,ATL,15,29,27,26,0,0,0,97,20040327
2004,NJN,28,24,26,26,0,0,0,104,CLE,24,20,31,32,0,0,0,107,20040327
2004,NYK,21,28,18,18,0,0,0,85,DET,32,35,23,10,0,0,0,100,20040327
2004,MIN,26,26,27,19,0,0,0,98,LAC,16,26,21,19,0,0,0,82,20040327
2004,SEA,22,23,27,28,8,0,0,108,POR,24,24,29,23,15,0,0,115,20040327
2004,PHO,13,22,18,23,0,0,0,76,SAS,31,29,27,18,0,0,0,105,20040327
2004,DEN,23,21,21,18,0,0,0,83,UTA,22,21,26,16,0,0,0,85,20040327
2004,PHI,14,9,18,24,0,0,0,65,BOS,20,22,18,29,0,0,0,89,20040328
2004,LAC,22,20,19,16,0,0,0,77,GSW,31,23,24,27,0,0,0,105,20040328
2004,MIA,19,21,25,15,0,0,0,80,IND,25,25,20,17,0,0,0,87,20040328
2004,UTA,20,18,17,29,0,0,0,84,LAL,22,21,26,22,0,0,0,91,20040328
2004,HOU,20,32,17,23,19,0,0,111,MIL,23,22,26,21,15,0,0,107,20040328
2004,DAL,28,34,26,30,0,0,0,118,ORL,23,20,26,19,0,0,0,88,20040328
2004,WAS,18,28,28,18,0,0,0,92,SAC,26,22,27,25,0,0,0,100,20040328
2004,MEM,23,29,18,24,0,0,0,94,TOR,24,21,19,24,0,0,0,88,20040328
2004,MEM,31,28,14,34,15,14,0,136,ATL,25,28,29,25,15,11,0,133,20040329
2004,MIN,28,14,26,26,0,0,0,94,HOU,20,23,25,20,0,0,0,88,20040329
2004,CHI,24,24,27,21,0,0,0,96,MIA,18,26,28,33,0,0,0,105,20040329
2004,BOS,20,23,14,27,0,0,0,84,NJN,23,19,15,23,0,0,0,80,20040329
2004,POR,20,27,19,25,0,0,0,91,NYK,20,24,20,28,0,0,0,92,20040329
2004,WAS,20,19,20,36,0,0,0,95,PHO,24,28,19,30,0,0,0,101,20040329
2004,CLE,25,22,18,28,0,0,0,93,SAS,26,33,27,15,0,0,0,101,20040329
2004,CLE,32,28,25,24,0,0,0,109,DAL,28,36,28,34,0,0,0,126,20040330
2004,SEA,37,30,25,27,0,0,0,119,DEN,37,32,28,27,0,0,0,124,20040330
2004,NOH,31,22,14,21,0,0,0,88,LAL,29,31,27,20,0,0,0,107,20040330
2004,IND,21,25,18,22,0,0,0,86,MIL,22,32,18,23,0,0,0,95,20040330
2004,GSW,18,22,6,25,0,0,0,71,PHI,18,24,30,23,0,0,0,95,20040330
2004,MIA,24,25,27,24,0,0,0,100,ATL,18,24,33,22,0,0,0,97,20040331
2004,POR,24,24,30,27,0,0,0,105,BOS,28,23,19,28,0,0,0,98,20040331
2004,LAC,23,29,25,22,0,0,0,99,DET,24,28,25,31,0,0,0,108,20040331
2004,MIL,13,24,18,23,0,0,0,78,IND,30,20,31,30,0,0,0,111,20040331
2004,SEA,20,16,20,27,0,0,0,83,MIN,23,17,25,25,0,0,0,90,20040331
2004,CHI,28,21,24,36,0,0,0,109,ORL,32,21,11,27,0,0,0,91,20040331
2004,SAC,24,18,25,22,0,0,0,89,SAS,26,28,25,28,0,0,0,107,20040331
2004,GSW,23,22,16,24,0,0,0,85,TOR,23,14,18,23,0,0,0,78,20040331
2004,NOH,11,24,17,24,0,0,0,76,UTA,20,22,19,28,0,0,0,89,20040331
2004,NJN,24,17,25,27,10,0,0,103,WAS,27,23,23,20,6,0,0,99,20040331
2004,SAC,30,20,31,36,0,0,0,117,DAL,30,37,34,26,0,0,0,127,20040401
2004,HOU,23,17,26,19,0,0,0,85,LAL,18,29,20,26,0,0,0,93,20040401
2004,POR,24,24,18,22,0,0,0,88,PHI,15,25,20,22,0,0,0,82,20040401
2004,GSW,19,29,34,24,0,0,0,106,BOS,31,31,22,27,0,0,0,111,20040402
2004,LAC,23,27,37,17,6,0,0,110,CHI,31,27,23,23,10,0,0,114,20040402
2004,HOU,23,29,23,25,0,0,0,100,DEN,30,27,28,25,0,0,0,110,20040402
2004,MIA,21,24,20,19,0,0,0,84,DET,20,17,23,32,0,0,0,92,20040402
2004,TOR,23,10,21,10,0,0,0,64,IND,28,17,20,19,0,0,0,84,20040402
2004,PHO,33,20,26,20,0,0,0,99,MEM,29,30,26,24,0,0,0,109,20040402
2004,CLE,29,25,24,11,0,0,0,89,MIL,31,24,34,18,0,0,0,107,20040402
2004,WAS,20,13,18,22,0,0,0,73,MIN,20,23,21,27,0,0,0,91,20040402
2004,NYK,22,21,27,13,0,0,0,83,NJN,28,27,32,21,0,0,0,108,20040402
2004,ATL,13,24,31,27,0,0,0,95,ORL,30,26,20,11,0,0,0,87,20040402
2004,LAL,17,30,30,20,0,0,0,97,SEA,25,26,19,16,0,0,0,86,20040402
2004,SAS,21,28,21,24,0,0,0,94,UTA,26,15,21,19,0,0,0,81,20040402
2004,MIA,19,22,28,28,0,0,0,97,CHI,15,16,19,33,0,0,0,83,20040403
2004,GSW,29,27,18,29,0,0,0,103,CLE,22,26,21,31,0,0,0,100,20040403
2004,PHO,32,21,22,28,0,0,0,103,DAL,31,34,25,34,0,0,0,124,20040403
2004,NYK,25,27,18,16,0,0,0,86,PHI,18,20,23,14,0,0,0,75,20040403
2004,NOH,22,28,28,16,0,0,0,94,POR,25,22,16,18,0,0,0,81,20040403
2004,IND,18,15,17,11,0,0,0,61,DET,15,24,17,23,0,0,0,79,20040404
2004,SAC,23,23,32,21,0,0,0,99,HOU,24,29,15,26,0,0,0,94,20040404
2004,UTA,19,15,32,31,0,0,0,97,LAC,21,19,22,30,0,0,0,92,20040404
2004,SAS,21,32,20,22,0,0,0,95,LAL,22,20,24,23,0,0,0,89,20040404
2004,MEM,25,22,20,15,0,0,0,82,MIN,19,27,23,21,0,0,0,90,20040404
2004,ATL,17,21,24,27,0,0,0,89,NJN,28,21,28,29,0,0,0,106,20040404
2004,NOH,16,24,17,31,0,0,0,88,SEA,28,24,28,16,0,0,0,96,20040404
2004,MIL,23,16,25,26,0,0,0,90,TOR,19,24,16,24,0,0,0,83,20040404
2004,BOS,26,32,22,22,0,0,0,102,WAS,26,27,29,30,0,0,0,112,20040404
2004,MEM,27,20,14,20,0,0,0,81,UTA,30,17,23,22,0,0,0,92,20040405
2004,PHI,21,24,19,28,11,0,0,103,ATL,23,12,28,29,8,0,0,100,20040406
2004,TOR,29,24,8,26,0,0,0,87,CLE,20,24,19,23,0,0,0,86,20040406
2004,SEA,21,30,28,29,0,0,0,108,DAL,34,24,31,29,0,0,0,118,20040406
2004,ORL,22,23,20,21,0,0,0,86,DET,25,34,25,18,0,0,0,102,20040406
2004,HOU,22,22,24,22,0,0,0,90,GSW,27,32,22,16,0,0,0,97,20040406
2004,NYK,24,13,28,21,0,0,0,86,IND,27,20,31,29,0,0,0,107,20040406
2004,POR,37,14,20,20,0,0,0,91,LAL,21,19,22,18,0,0,0,80,20040406
2004,MIL,22,26,24,31,0,0,0,103,NJN,27,30,23,18,0,0,0,98,20040406
2004,NOH,22,19,19,31,0,0,0,91,SAC,27,33,16,29,0,0,0,105,20040406
2004,HOU,27,30,21,24,0,0,0,102,LAC,15,21,24,19,0,0,0,79,20040407
2004,CLE,17,22,23,12,0,0,0,74,MEM,28,27,21,16,0,0,0,92,20040407
2004,BOS,22,27,31,21,0,0,0,101,MIA,24,37,19,24,0,0,0,104,20040407
2004,WAS,27,33,21,26,0,0,0,107,MIL,19,29,35,33,0,0,0,116,20040407
2004,CHI,20,17,21,24,0,0,0,82,NYK,26,28,22,20,0,0,0,96,20040407
2004,DEN,22,30,24,35,0,0,0,111,PHO,14,23,33,26,0,0,0,96,20040407
2004,GSW,18,14,27,22,0,0,0,81,POR,18,26,20,23,0,0,0,87,20040407
2004,SEA,19,17,13,26,0,0,0,75,SAS,29,17,31,19,0,0,0,96,20040407
2004,IND,30,23,20,21,0,0,0,94,TOR,20,17,28,25,0,0,0,90,20040407
2004,UTA,18,29,26,21,0,0,0,94,DAL,35,27,30,25,0,0,0,117,20040408
2004,ORL,26,22,19,14,0,0,0,81,NJN,24,26,18,33,0,0,0,101,20040408
2004,MIN,19,20,22,33,0,0,0,94,SAC,22,25,22,17,0,0,0,86,20040408
2004,ATL,37,24,27,28,0,0,0,116,CHI,24,24,19,34,0,0,0,101,20040409
2004,TOR,16,17,21,12,0,0,0,66,DET,19,19,20,16,0,0,0,74,20040409
2004,MIN,28,21,16,27,0,0,0,92,GSW,18,32,11,13,0,0,0,74,20040409
2004,DEN,26,26,21,30,0,0,0,103,HOU,21,21,36,28,0,0,0,106,20040409
2004,NJN,18,22,21,19,0,0,0,80,IND,23,26,19,22,0,0,0,90,20040409
2004,MEM,31,24,17,23,0,0,0,95,LAL,19,29,26,29,0,0,0,103,20040409
2004,CLE,29,17,33,12,0,0,0,91,MIA,27,23,26,30,0,0,0,106,20040409
2004,BOS,17,26,12,25,0,0,0,80,NOH,24,17,20,28,0,0,0,89,20040409
2004,WAS,21,22,22,18,0,0,0,83,PHI,17,20,22,21,0,0,0,80,20040409
2004,SAC,23,22,29,22,0,0,0,96,PHO,28,27,24,22,0,0,0,101,20040409
2004,POR,17,16,18,23,0,0,0,74,SAS,31,21,14,18,0,0,0,84,20040409
2004,BOS,23,23,28,25,0,0,0,99,ATL,35,28,23,24,0,0,0,110,20040410
2004,MIA,21,18,15,26,0,0,0,80,CLE,22,30,21,18,0,0,0,91,20040410
2004,POR,25,23,19,27,6,0,0,100,DEN,28,18,23,25,16,0,0,110,20040410
2004,NOH,23,21,18,30,0,0,0,92,MIL,24,16,24,23,0,0,0,87,20040410
2004,DET,27,29,25,20,0,0,0,101,ORL,17,20,24,28,0,0,0,89,20040410
2004,DAL,21,25,27,26,0,0,0,99,SEA,28,38,25,28,0,0,0,119,20040410
2004,HOU,16,24,11,18,0,0,0,69,UTA,23,23,16,20,0,0,0,82,20040410
2004,NYK,19,24,23,21,15,0,0,102,WAS,25,22,19,21,11,0,0,98,20040410
2004,DAL,33,23,30,21,0,0,0,107,GSW,28,21,30,29,0,0,0,108,20040411
2004,SAS,28,18,18,24,0,0,0,88,LAC,19,23,21,16,0,0,0,79,20040411
2004,PHI,25,16,13,21,0,0,0,75,NJN,17,21,28,23,0,0,0,89,20040411
2004,MEM,20,19,19,25,0,0,0,83,PHO,26,23,16,24,0,0,0,89,20040411
2004,LAL,15,20,24,26,0,0,0,85,SAC,31,23,19,29,0,0,0,102,20040411
2004,CHI,25,21,18,37,13,0,0,114,TOR,27,21,20,33,7,0,0,108,20040411
2004,NJN,21,21,33,32,0,0,0,107,ATL,35,30,33,31,0,0,0,129,20040412
2004,MIA,19,17,25,23,0,0,0,84,BOS,16,17,24,20,0,0,0,77,20040412
2004,ORL,25,28,17,23,0,0,0,93,CHI,24,21,10,29,0,0,0,84,20040412
2004,MIL,19,31,23,16,0,0,0,89,CLE,27,18,24,24,0,0,0,93,20040412
2004,SAC,20,26,23,20,0,0,0,89,DEN,19,33,26,19,0,0,0,97,20040412
2004,WAS,25,22,15,17,0,0,0,79,DET,23,20,29,29,0,0,0,101,20040412
2004,UTA,19,13,26,32,0,0,0,90,MIN,23,27,23,31,0,0,0,104,20040412
2004,NYK,25,22,24,30,0,0,0,101,NOH,23,31,27,16,0,0,0,97,20040412
2004,IND,21,25,28,33,0,0,0,107,PHI,22,27,24,20,0,0,0,93,20040412
2004,SAS,22,15,22,19,0,0,0,78,POR,15,10,16,25,0,0,0,66,20040412
2004,HOU,34,22,33,22,0,0,0,111,SEA,25,28,19,35,0,0,0,107,20040412
2004,MEM,18,28,28,29,0,0,0,103,DAL,31,31,26,22,0,0,0,110,20040413
2004,GSW,29,30,19,26,0,0,0,104,LAL,27,22,24,36,0,0,0,109,20040413
2004,LAC,27,28,23,20,0,0,0,98,PHO,27,17,26,26,0,0,0,96,20040413
2004,DET,19,18,22,19,0,0,0,78,TOR,22,20,28,17,0,0,0,87,20040413
2004,ATL,28,43,29,32,0,0,0,132,BOS,38,29,38,32,0,0,0,137,20040414
2004,SAC,21,18,27,25,0,0,0,91,GSW,14,32,26,25,0,0,0,97,20040414
2004,DAL,26,21,21,24,0,0,0,92,HOU,25,14,20,30,0,0,0,89,20040414
2004,CHI,35,24,22,15,0,0,0,96,IND,28,23,28,22,0,0,0,101,20040414
2004,SEA,29,36,21,32,0,0,0,118,LAC,15,26,25,21,0,0,0,87,20040414
2004,MIN,28,27,35,17,0,0,0,107,MEM,16,18,29,27,0,0,0,90,20040414
2004,NJN,26,14,16,28,0,0,0,84,MIA,23,23,31,19,0,0,0,96,20040414
2004,TOR,28,25,14,22,0,0,0,89,MIL,29,24,22,12,0,0,0,87,20040414
2004,CLE,19,25,28,28,0,0,0,100,NYK,24,15,28,23,0,0,0,90,20040414
2004,PHI,25,20,24,20,0,0,0,89,ORL,19,22,31,23,0,0,0,95,20040414
2004,LAL,22,23,14,28,8,10,0,105,POR,28,22,16,21,8,9,0,104,20040414
2004,DEN,21,12,16,18,0,0,0,67,SAS,13,19,32,29,0,0,0,93,20040414
2004,PHO,25,25,21,18,0,0,0,89,UTA,21,26,19,18,0,0,0,84,20040414
2004,NOH,24,33,15,22,0,0,0,94,WAS,20,19,20,19,0,0,0,78,20040414
2004,BOS,29,14,21,24,0,0,0,88,IND,30,35,23,16,0,0,0,104,20040417
2004,HOU,18,16,17,20,0,0,0,71,LAL,20,20,9,23,0,0,0,72,20040417
2004,NYK,24,31,13,15,0,0,0,83,NJN,30,32,24,21,0,0,0,107,20040417
2004,MEM,19,15,18,22,0,0,0,74,SAS,28,21,22,27,0,0,0,98,20040417
2004,MIL,21,22,15,24,0,0,0,82,DET,27,25,28,28,0,0,0,108,20040418
2004,NOH,22,22,15,20,0,0,0,79,MIA,23,18,25,15,0,0,0,81,20040418
2004,DEN,22,20,26,24,0,0,0,92,MIN,31,20,28,27,0,0,0,106,20040418
2004,DAL,31,34,20,20,0,0,0,105,SAC,34,29,23,30,0,0,0,116,20040418
2004,HOU,22,24,18,20,0,0,0,84,LAL,23,21,30,24,0,0,0,98,20040419
2004,MEM,21,14,24,11,0,0,0,70,SAS,26,20,22,19,0,0,0,87,20040419
2004,BOS,22,24,23,21,0,0,0,90,IND,17,24,24,38,0,0,0,103,20040420
2004,NYK,24,15,20,22,0,0,0,81,NJN,26,26,20,27,0,0,0,99,20040420
2004,DAL,19,23,18,19,0,0,0,79,SAC,21,23,17,22,0,0,0,83,20040420
2004,MIL,25,23,22,22,0,0,0,92,DET,25,16,19,28,0,0,0,88,20040421
2004,NOH,17,17,10,19,0,0,0,63,MIA,28,15,23,27,0,0,0,93,20040421
2004,DEN,27,9,18,27,0,0,0,81,MIN,28,22,16,29,0,0,0,95,20040421
2004,SAS,29,21,24,21,0,0,0,95,MEM,28,29,17,19,0,0,0,93,20040422
2004,NJN,25,15,25,16,0,0,0,81,NYK,15,25,15,23,0,0,0,78,20040422
2004,IND,23,30,26,29,0,0,0,108,BOS,20,20,23,22,0,0,0,85,20040423
2004,LAL,23,20,19,29,0,0,0,91,HOU,29,27,18,28,0,0,0,102,20040423
2004,SAC,25,17,17,20,0,0,0,79,DAL,33,16,34,21,0,0,0,104,20040424
2004,MIN,18,23,25,20,0,0,0,86,DEN,30,24,31,22,0,0,0,107,20040424
2004,DET,22,20,32,21,0,0,0,95,MIL,30,19,19,17,0,0,0,85,20040424
2004,MIA,14,15,21,21,0,0,0,71,NOH,19,22,16,20,0,0,0,77,20040424
2004,IND,21,25,24,20,0,0,0,90,BOS,25,13,14,23,0,0,0,75,20040425
2004,LAL,21,24,24,12,11,0,0,92,HOU,24,17,18,22,7,0,0,88,20040425
2004,SAS,32,25,30,23,0,0,0,110,MEM,21,24,27,25,0,0,0,97,20040425
2004,NJN,21,23,25,31,0,0,0,100,NYK,21,25,22,26,0,0,0,94,20040425
2004,SAC,21,18,31,24,0,0,0,94,DAL,18,26,21,27,0,0,0,92,20040426
2004,DET,28,24,22,35,0,0,0,109,MIL,27,22,19,24,0,0,0,92,20040426
2004,MIN,20,16,30,18,0,0,0,84,DEN,20,16,27,19,0,0,0,82,20040427
2004,MIA,17,27,27,14,0,0,0,85,NOH,22,28,18,28,0,0,0,96,20040427
2004,HOU,27,21,9,21,0,0,0,78,LAL,24,23,25,25,0,0,0,97,20040428
2004,MIL,22,10,22,23,0,0,0,77,DET,24,15,30,22,0,0,0,91,20040429
2004,DAL,37,29,30,22,0,0,0,118,SAC,24,39,33,23,0,0,0,119,20040429
2004,NOH,24,22,17,20,0,0,0,83,MIA,14,28,16,29,0,0,0,87,20040430
2004,DEN,19,26,21,25,0,0,0,91,MIN,28,29,17,28,0,0,0,102,20040430
2004,MIA,14,19,22,28,0,0,0,83,NOH,21,22,26,20,0,0,0,89,20040502
2004,LAL,14,19,32,13,0,0,0,78,SAS,21,20,21,26,0,0,0,88,20040502
2004,NJN,14,11,14,17,0,0,0,56,DET,18,19,20,21,0,0,0,78,20040503
2004,NOH,18,13,22,24,0,0,0,77,MIA,25,16,22,22,0,0,0,85,20040504
2004,SAC,34,14,25,31,0,0,0,104,MIN,27,20,26,25,0,0,0,98,20040504
2004,LAL,17,28,23,17,0,0,0,85,SAS,33,28,12,22,0,0,0,95,20040505
2004,MIA,15,21,21,24,0,0,0,81,IND,23,23,23,25,0,0,0,94,20040506
2004,NJN,19,27,11,23,0,0,0,80,DET,18,16,27,34,0,0,0,95,20040507
2004,MIA,19,17,18,26,0,0,0,80,IND,21,23,25,22,0,0,0,91,20040508
2004,SAC,12,27,31,19,0,0,0,89,MIN,17,32,24,21,0,0,0,94,20040508
2004,SAS,16,16,26,23,0,0,0,81,LAL,28,14,33,30,0,0,0,105,20040509
2004,DET,13,25,14,12,0,0,0,64,NJN,31,16,19,16,0,0,0,82,20040509
2004,IND,20,15,25,27,0,0,0,87,MIA,14,25,25,30,0,0,0,94,20040510
2004,MIN,22,24,33,25,10,0,0,114,SAC,18,28,23,35,9,0,0,113,20040510
2004,SAS,27,26,16,21,0,0,0,90,LAL,21,22,31,24,0,0,0,98,20040511
2004,DET,18,22,16,23,0,0,0,79,NJN,21,26,30,17,0,0,0,94,20040511
2004,IND,33,23,13,19,0,0,0,88,MIA,26,27,23,24,0,0,0,100,20040512
2004,MIN,15,16,26,24,0,0,0,81,SAC,21,21,17,28,0,0,0,87,20040512
2004,LAL,24,18,20,12,0,0,0,74,SAS,18,17,18,20,0,0,0,73,20040513
2004,NJN,25,18,20,25,11,12,16,127,DET,19,25,18,26,11,12,9,120,20040514
2004,SAC,18,16,23,17,0,0,0,74,MIN,18,20,26,22,0,0,0,86,20040514
2004,MIA,21,18,16,28,0,0,0,83,IND,19,25,29,21,0,0,0,94,20040515
2004,SAS,21,18,13,24,0,0,0,76,LAL,23,16,17,32,0,0,0,88,20040515
2004,DET,23,27,10,21,0,0,0,81,NJN,25,11,21,18,0,0,0,75,20040516
2004,MIN,30,14,19,24,0,0,0,87,SAC,24,33,21,26,0,0,0,104,20040516
2004,IND,16,20,23,14,0,0,0,73,MIA,20,13,19,18,0,0,0,70,20040518
2004,SAC,16,15,29,20,0,0,0,80,MIN,22,19,21,21,0,0,0,83,20040519
2004,NJN,14,17,19,19,0,0,0,69,DET,21,22,30,17,0,0,0,90,20040520
2004,LAL,23,23,32,19,0,0,0,97,MIN,24,20,23,21,0,0,0,88,20040521
2004,DET,26,15,17,16,0,0,0,74,IND,22,26,13,17,0,0,0,78,20040522
2004,LAL,24,13,19,15,0,0,0,71,MIN,32,19,17,21,0,0,0,89,20040523
2004,DET,12,25,18,17,0,0,0,72,IND,17,26,11,13,0,0,0,67,20040524
2004,MIN,17,18,30,24,0,0,0,89,LAL,24,20,26,30,0,0,0,100,20040525
2004,IND,14,16,15,33,0,0,0,78,DET,27,9,20,29,0,0,0,85,20040526
2004,MIN,24,16,20,25,0,0,0,85,LAL,23,22,30,17,0,0,0,92,20040527
2004,IND,29,20,21,13,0,0,0,83,DET,17,22,11,18,0,0,0,68,20040528
2004,LAL,21,19,23,33,0,0,0,96,MIN,14,32,27,25,0,0,0,98,20040529
2004,DET,25,16,21,21,0,0,0,83,IND,17,19,17,12,0,0,0,65,20040530
2004,MIN,17,29,22,22,0,0,0,90,LAL,28,20,19,29,0,0,0,96,20040531
2004,IND,23,10,17,15,0,0,0,65,DET,11,16,19,23,0,0,0,69,20040601
2004,DET,22,18,24,23,0,0,0,87,LAL,19,22,17,17,0,0,0,75,20040606
2004,DET,16,20,30,23,2,0,0,91,LAL,18,26,24,21,10,0,0,99,20040608
2004,LAL,16,16,19,17,0,0,0,68,DET,24,15,24,25,0,0,0,88,20040610
2004,LAL,22,17,17,24,0,0,0,80,DET,21,20,15,32,0,0,0,88,20040613
2004,LAL,24,21,14,28,0,0,0,87,DET,25,30,27,18,0,0,0,100,20040615
2005,SAC,23,17,26,32,0,0,0,98,DAL,30,24,25,28,0,0,0,107,20041102
2005,HOU,18,20,21,20,0,0,0,79,DET,19,18,22,28,0,0,0,87,20041102
2005,DEN,14,17,26,21,0,0,0,78,LAL,24,26,22,17,0,0,0,89,20041102
2005,PHI,27,24,20,27,0,0,0,98,BOS,22,31,30,12,0,0,0,95,20041103
2005,IND,26,20,17,22,9,15,0,109,CLE,21,19,27,18,9,10,0,104,20041103
2005,POR,18,19,16,25,0,0,0,78,GSW,16,23,20,16,0,0,0,75,20041103
2005,SEA,17,24,20,23,0,0,0,84,LAC,30,30,25,29,0,0,0,114,20041103
2005,WAS,16,28,32,27,0,0,0,103,MEM,27,25,11,28,0,0,0,91,20041103
2005,NYK,30,21,25,17,0,0,0,93,MIN,25,33,23,18,0,0,0,99,20041103
2005,MIA,29,17,28,26,0,0,0,100,NJN,15,26,15,21,0,0,0,77,20041103
2005,DAL,27,27,29,23,0,0,0,106,NOH,19,26,24,22,0,0,0,91,20041103
2005,MIL,25,22,20,25,0,0,0,92,ORL,21,29,24,19,0,0,0,93,20041103
2005,ATL,23,12,18,29,0,0,0,82,PHO,28,36,24,24,0,0,0,112,20041103
2005,SAC,23,22,22,18,0,0,0,85,SAS,25,27,24,25,0,0,0,101,20041103
2005,HOU,18,21,29,20,0,0,0,88,TOR,19,33,19,24,0,0,0,95,20041103
2005,LAL,13,15,26,24,0,0,0,78,UTA,25,20,24,35,0,0,0,104,20041103
2005,WAS,22,27,25,29,0,0,0,103,CHA,23,22,30,21,0,0,0,96,20041104
2005,MIN,23,24,19,22,4,0,0,92,DEN,23,19,25,21,6,0,0,94,20041104
2005,CLE,23,26,17,20,0,0,0,86,MIA,27,25,21,19,0,0,0,92,20041104
2005,IND,26,25,17,32,0,0,0,100,BOS,28,24,16,26,0,0,0,94,20041105
2005,NJN,25,30,18,21,5,12,0,111,CHI,15,20,31,28,5,7,0,106,20041105
2005,UTA,27,19,34,22,0,0,0,102,GSW,14,26,21,19,0,0,0,80,20041105
2005,SAS,29,30,25,21,0,0,0,105,LAL,27,20,26,23,0,0,0,96,20041105
2005,HOU,23,18,26,22,0,0,0,89,MEM,19,19,22,21,0,0,0,81,20041105
2005,ORL,18,27,23,22,0,0,0,90,NOH,17,20,25,27,0,0,0,89,20041105
2005,PHO,31,37,17,23,0,0,0,108,PHI,18,31,24,25,0,0,0,98,20041105
2005,LAC,20,28,17,16,0,0,0,81,POR,29,29,21,15,0,0,0,94,20041105
2005,ATL,23,23,18,21,0,0,0,85,SEA,26,27,26,27,0,0,0,106,20041105
2005,DET,31,16,20,22,0,0,0,89,TOR,21,28,27,25,0,0,0,101,20041105
2005,ORL,22,20,21,37,0,0,0,100,CHA,20,29,30,32,0,0,0,111,20041106
2005,MEM,35,18,15,20,0,0,0,88,DAL,24,33,28,27,0,0,0,112,20041106
2005,UTA,33,27,24,22,0,0,0,106,DEN,20,14,25,23,0,0,0,82,20041106
2005,PHI,26,20,21,24,0,0,0,91,DET,25,28,30,16,0,0,0,99,20041106
2005,LAC,31,20,17,26,0,0,0,94,GSW,15,22,22,27,0,0,0,86,20041106
2005,SAC,21,25,27,20,8,0,0,101,HOU,21,17,28,27,11,0,0,104,20041106
2005,CHI,24,25,18,23,0,0,0,90,IND,27,27,28,18,0,0,0,100,20041106
2005,CLE,24,27,19,18,0,0,0,88,MIL,24,23,30,25,0,0,0,102,20041106
2005,NOH,27,13,31,21,0,0,0,92,MIN,23,31,16,29,0,0,0,99,20041106
2005,PHO,25,32,23,32,0,0,0,112,NJN,21,20,26,13,0,0,0,80,20041106
2005,BOS,28,27,32,20,0,0,0,107,NYK,20,16,20,17,0,0,0,73,20041106
2005,MIA,27,31,24,36,0,0,0,118,WAS,17,31,27,31,0,0,0,106,20041106
2005,ATL,25,20,21,24,0,0,0,90,LAL,29,30,28,19,0,0,0,106,20041107
2005,SAS,19,20,23,32,0,0,0,94,SEA,25,21,26,41,0,0,0,113,20041107
2005,POR,24,18,28,27,0,0,0,97,TOR,20,31,23,27,0,0,0,101,20041107
2005,GSW,33,24,10,21,10,0,0,98,DAL,19,25,24,20,13,0,0,101,20041108
2005,DET,18,24,23,18,6,10,0,99,LAC,21,22,16,24,6,7,0,96,20041108
2005,DEN,29,12,20,30,0,0,0,91,UTA,27,29,24,22,0,0,0,102,20041108
2005,CLE,29,23,20,21,0,0,0,93,ATL,31,23,14,11,0,0,0,79,20041109
2005,PHO,21,28,24,21,0,0,0,94,CHI,9,25,17,23,0,0,0,74,20041109
2005,SEA,29,26,25,28,0,0,0,108,DEN,21,27,19,21,0,0,0,88,20041109
2005,MEM,26,25,21,15,0,0,0,87,HOU,21,26,23,20,0,0,0,90,20041109
2005,WAS,16,21,26,30,0,0,0,93,MIA,22,28,37,16,0,0,0,103,20041109
2005,IND,32,22,26,22,0,0,0,102,MIN,26,19,23,33,0,0,0,101,20041109
2005,POR,10,22,14,14,0,0,0,60,NJN,16,14,15,19,0,0,0,64,20041109
2005,LAL,24,28,35,19,0,0,0,106,NOH,22,13,21,42,0,0,0,98,20041109
2005,PHI,18,24,25,21,0,0,0,88,NYK,27,28,21,20,0,0,0,96,20041109
2005,DAL,22,18,22,22,0,0,0,84,ORL,19,31,19,25,0,0,0,94,20041109
2005,TOR,20,25,21,26,0,0,0,92,SAC,27,25,35,21,0,0,0,108,20041109
2005,POR,22,17,25,24,0,0,0,88,BOS,27,26,18,19,0,0,0,90,20041110
2005,PHO,23,27,35,14,10,0,0,109,CLE,24,25,17,33,15,0,0,114,20041110
2005,LAC,24,31,26,21,0,0,0,102,IND,20,7,23,18,0,0,0,68,20041110
2005,LAL,24,20,23,20,0,0,0,87,MEM,28,35,27,20,0,0,0,110,20041110
2005,CHA,30,32,18,20,0,0,0,100,MIL,21,33,20,28,0,0,0,102,20041110
2005,NJN,27,26,21,22,4,0,0,100,PHI,24,20,30,22,12,0,0,108,20041110
2005,GSW,12,21,24,14,0,0,0,71,SAS,23,23,18,27,0,0,0,91,20041110
2005,SAC,20,19,21,18,0,0,0,78,SEA,33,20,23,32,0,0,0,108,20041110
2005,TOR,28,26,22,28,0,0,0,104,UTA,29,23,27,16,0,0,0,95,20041110
2005,ORL,26,19,32,19,0,0,0,96,WAS,24,25,27,30,0,0,0,106,20041110
2005,DET,19,28,26,36,0,0,0,109,DEN,25,30,33,29,0,0,0,117,20041111
2005,MIN,36,16,19,25,0,0,0,96,HOU,25,22,21,23,0,0,0,91,20041111
2005,DAL,34,37,24,18,0,0,0,113,MIA,19,38,25,11,0,0,0,93,20041111
2005,CHA,22,19,16,17,0,0,0,74,BOS,19,22,27,23,0,0,0,91,20041112
2005,GSW,15,17,19,16,0,0,0,67,MEM,19,32,21,24,0,0,0,96,20041112
2005,ATL,20,30,28,18,0,0,0,96,NOH,26,25,20,24,0,0,0,95,20041112
2005,LAC,26,22,24,24,0,0,0,96,NYK,35,25,28,22,0,0,0,110,20041112
2005,LAL,37,18,25,33,0,0,0,113,ORL,21,36,36,29,0,0,0,122,20041112
2005,IND,30,27,21,22,4,0,0,104,PHI,23,26,19,32,6,0,0,106,20041112
2005,MIA,22,23,15,24,0,0,0,84,SAS,25,26,21,21,0,0,0,93,20041112
2005,TOR,24,10,28,25,0,0,0,87,SEA,31,17,18,22,0,0,0,88,20041112
2005,SAS,24,20,33,26,0,0,0,103,ATL,18,17,25,28,0,0,0,88,20041113
2005,GSW,26,25,21,31,0,0,0,103,CHA,18,16,29,24,0,0,0,87,20041113
2005,LAC,21,27,28,21,0,0,0,97,CHI,34,20,22,20,0,0,0,96,20041113
2005,WAS,11,24,26,13,0,0,0,74,CLE,28,24,24,29,0,0,0,105,20041113
2005,LAL,26,21,19,18,0,0,0,84,HOU,21,14,25,19,0,0,0,79,20041113
2005,NYK,32,17,18,30,0,0,0,97,IND,37,26,20,20,0,0,0,103,20041113
2005,NOH,21,19,23,28,0,0,0,91,MIL,19,32,20,23,0,0,0,94,20041113
2005,DAL,16,28,27,23,0,0,0,94,NJN,22,20,20,16,0,0,0,78,20041113
2005,SAC,33,24,31,25,0,0,0,113,PHO,33,25,24,29,0,0,0,111,20041113
2005,TOR,23,22,20,37,0,0,0,102,POR,20,28,35,22,0,0,0,105,20041113
2005,DET,23,19,27,24,0,0,0,93,UTA,28,34,28,18,0,0,0,108,20041113
2005,MIL,23,25,23,22,12,5,0,110,MIA,21,30,21,21,12,7,0,112,20041114
2005,ORL,19,22,19,27,0,0,0,87,PHI,23,17,28,28,0,0,0,96,20041114
2005,DEN,15,24,24,26,0,0,0,89,SAC,22,23,32,24,0,0,0,101,20041114
2005,MEM,29,42,29,13,0,0,0,113,SEA,27,34,23,34,0,0,0,118,20041114
2005,DAL,28,35,26,33,0,0,0,122,WAS,30,24,35,24,0,0,0,113,20041114
2005,GSW,29,18,24,17,0,0,0,88,CLE,24,25,26,24,0,0,0,99,20041115
2005,HOU,20,27,14,19,0,0,0,80,NJN,17,13,19,20,0,0,0,69,20041115
2005,HOU,23,22,24,15,0,0,0,84,ATL,17,20,25,26,0,0,0,88,20041116
2005,UTA,17,23,34,33,0,0,0,107,CHA,35,19,25,26,0,0,0,105,20041116
2005,PHO,22,32,23,30,0,0,0,107,DAL,24,19,33,25,0,0,0,101,20041116
2005,TOR,27,20,12,30,0,0,0,89,LAC,33,20,29,19,0,0,0,101,20041116
2005,MIA,17,30,19,31,0,0,0,97,MIN,27,30,24,27,0,0,0,108,20041116
2005,SEA,34,19,24,26,0,0,0,103,PHI,25,30,17,23,0,0,0,95,20041116
2005,CHI,30,23,14,39,0,0,0,106,SAC,31,21,30,31,0,0,0,113,20041116
2005,NYK,25,19,19,18,0,0,0,81,SAS,23,27,24,25,0,0,0,99,20041116
2005,TOR,29,32,25,20,0,0,0,106,DEN,26,30,30,26,0,0,0,112,20041117
2005,MIN,25,20,18,22,0,0,0,85,DET,20,21,33,19,0,0,0,93,20041117
2005,CHI,22,22,20,21,0,0,0,85,GSW,27,29,24,18,0,0,0,98,20041117
2005,ATL,31,18,13,24,0,0,0,86,IND,16,26,22,29,0,0,0,93,20041117
2005,LAC,24,22,25,18,0,0,0,89,LAL,29,24,22,28,0,0,0,103,20041117
2005,MIA,24,16,36,37,0,0,0,113,MIL,23,20,22,41,0,0,0,106,20041117
2005,SEA,13,23,17,26,0,0,0,79,NJN,11,18,17,22,0,0,0,68,20041117
2005,PHO,18,24,27,26,0,0,0,95,NOH,22,17,23,22,0,0,0,84,20041117
2005,UTA,28,18,29,17,0,0,0,92,ORL,21,24,26,36,0,0,0,107,20041117
2005,MEM,23,30,29,19,0,0,0,101,POR,20,20,15,27,0,0,0,82,20041117
2005,BOS,24,18,42,16,5,0,0,105,WAS,32,23,17,28,10,0,0,110,20041117
2005,CLE,32,25,25,24,0,0,0,106,CHA,25,24,15,25,0,0,0,89,20041118
2005,NYK,20,20,21,32,0,0,0,93,HOU,22,25,25,20,0,0,0,92,20041118
2005,SAS,20,20,15,33,0,0,0,88,PHI,6,27,26,21,0,0,0,80,20041118
2005,SAS,17,20,22,33,0,0,0,92,BOS,21,22,23,18,0,0,0,84,20041119
2005,NYK,28,19,22,32,0,0,0,101,DAL,25,25,25,28,0,0,0,103,20041119
2005,CHI,26,25,19,11,0,0,0,81,DEN,27,25,27,20,0,0,0,99,20041119
2005,IND,34,25,21,17,0,0,0,97,DET,27,16,23,16,0,0,0,82,20041119
2005,UTA,15,25,26,24,15,0,0,105,MIA,15,24,20,31,17,0,0,107,20041119
2005,LAL,27,20,27,28,0,0,0,102,PHO,15,31,28,33,0,0,0,107,20041119
2005,MIL,23,23,23,29,0,0,0,98,POR,28,19,28,35,0,0,0,110,20041119
2005,MEM,27,26,34,18,0,0,0,105,SAC,35,27,17,28,0,0,0,107,20041119
2005,SEA,19,23,31,28,0,0,0,101,TOR,24,23,24,23,0,0,0,94,20041119
2005,UTA,21,28,20,23,0,0,0,92,ATL,19,27,17,16,0,0,0,79,20041120
2005,CHA,28,19,15,22,0,0,0,84,CLE,23,25,32,20,0,0,0,100,20041120
2005,MEM,24,23,32,21,0,0,0,100,GSW,20,22,24,21,0,0,0,87,20041120
2005,ORL,26,20,19,21,0,0,0,86,IND,20,24,21,18,0,0,0,83,20041120
2005,HOU,25,20,20,17,9,0,0,91,LAC,17,23,28,14,4,0,0,86,20041120
2005,WAS,25,27,15,30,0,0,0,97,NJN,23,20,26,17,0,0,0,86,20041120
2005,MIN,19,27,24,29,0,0,0,99,NOH,16,21,23,34,0,0,0,94,20041120
2005,SEA,14,27,17,25,0,0,0,83,BOS,24,27,24,27,0,0,0,102,20041121
2005,DAL,33,16,21,12,0,0,0,82,DEN,18,37,31,24,0,0,0,110,20041121
2005,CHA,31,25,21,26,5,8,0,116,DET,26,24,23,30,5,9,0,117,20041121
2005,PHO,24,39,33,26,0,0,0,122,LAC,29,21,31,30,0,0,0,111,20041121
2005,CHI,26,23,20,24,0,0,0,93,LAL,30,20,23,29,0,0,0,102,20041121
2005,PHI,19,28,15,21,0,0,0,83,MIA,24,21,22,26,0,0,0,93,20041121
2005,CLE,22,16,33,17,0,0,0,88,NYK,22,29,22,25,0,0,0,98,20041121
2005,HOU,27,26,24,20,0,0,0,97,POR,25,25,17,26,0,0,0,93,20041121
2005,MIL,15,22,15,27,0,0,0,79,SAC,19,15,15,39,0,0,0,88,20041121
2005,SAS,23,29,30,9,0,0,0,91,TOR,27,17,19,33,0,0,0,96,20041121
2005,MIN,20,20,22,21,0,0,0,83,DAL,29,14,19,20,0,0,0,82,20041122
2005,SAS,25,25,18,22,0,0,0,90,MEM,23,25,23,22,0,0,0,93,20041122
2005,CHI,24,26,14,18,0,0,0,82,PHO,32,33,12,23,0,0,0,100,20041122
2005,NOH,22,26,17,11,0,0,0,76,UTA,17,16,30,12,0,0,0,75,20041122
2005,DET,22,13,19,35,0,0,0,89,CHA,23,28,22,18,0,0,0,91,20041123
2005,NJN,17,21,25,25,0,0,0,88,DEN,23,14,24,29,0,0,0,90,20041123
2005,NOH,23,22,17,24,11,5,7,109,GSW,18,36,20,12,11,5,13,115,20041123
2005,BOS,28,19,25,24,0,0,0,96,IND,23,27,22,34,0,0,0,106,20041123
2005,MIL,19,33,21,23,0,0,0,96,LAL,27,20,27,26,0,0,0,100,20041123
2005,POR,21,29,24,25,0,0,0,99,MIA,26,23,17,21,0,0,0,87,20041123
2005,SEA,26,37,26,14,0,0,0,103,MIN,24,26,19,23,0,0,0,92,20041123
2005,ATL,19,24,21,24,0,0,0,88,NYK,24,28,27,25,0,0,0,104,20041123
2005,HOU,25,23,29,19,0,0,0,96,SAC,27,23,24,28,0,0,0,102,20041123
2005,TOR,24,22,18,22,0,0,0,86,WAS,24,25,34,19,0,0,0,102,20041123
2005,MIA,24,19,28,28,0,0,0,99,ATL,26,20,24,23,0,0,0,93,20041124
2005,DET,17,20,22,17,0,0,0,76,CLE,24,30,17,21,0,0,0,92,20041124
2005,SEA,20,25,33,15,0,0,0,93,MEM,26,21,21,16,0,0,0,84,20041124
2005,POR,15,26,25,23,0,0,0,89,ORL,23,21,18,21,0,0,0,83,20041124
2005,BOS,18,34,21,24,0,0,0,97,PHI,26,30,36,18,0,0,0,110,20041124
2005,MIL,30,21,25,28,0,0,0,104,PHO,30,29,29,23,0,0,0,111,20041124
2005,DAL,17,28,22,13,0,0,0,80,SAS,18,31,25,20,0,0,0,94,20041124
2005,NYK,28,20,27,16,0,0,0,91,TOR,33,30,32,19,0,0,0,114,20041124
2005,CHI,30,22,21,28,0,0,0,101,UTA,24,21,29,25,0,0,0,99,20041124
2005,MIN,26,19,22,35,0,0,0,102,IND,26,21,30,29,0,0,0,106,20041125
2005,NJN,23,16,27,22,0,0,0,88,LAC,24,24,28,25,0,0,0,101,20041125
2005,ORL,33,32,25,27,0,0,0,117,ATL,28,28,30,13,0,0,0,99,20041126
2005,CLE,27,26,22,23,0,0,0,98,BOS,20,28,33,15,0,0,0,96,20041126
2005,POR,18,20,27,18,0,0,0,83,DAL,26,17,25,24,0,0,0,92,20041126
2005,SAS,26,27,16,20,0,0,0,89,DEN,15,22,18,20,0,0,0,75,20041126
2005,MIA,24,16,16,21,0,0,0,77,DET,18,24,20,16,0,0,0,78,20041126
2005,LAC,28,18,22,30,0,0,0,98,GSW,20,22,20,25,0,0,0,87,20041126
2005,CHA,27,16,18,16,0,0,0,77,IND,14,24,19,25,0,0,0,82,20041126
2005,SAC,23,28,34,24,0,0,0,109,LAL,23,25,32,26,0,0,0,106,20041126
2005,MEM,27,23,21,19,0,0,0,90,MIN,34,25,35,21,0,0,0,115,20041126
2005,WAS,21,23,28,31,11,0,0,114,PHI,22,30,26,25,13,0,0,116,20041126
2005,NOH,26,21,24,15,0,0,0,86,PHO,30,20,25,20,0,0,0,95,20041126
2005,NJN,8,19,24,28,0,0,0,79,SEA,21,27,15,29,0,0,0,92,20041126
2005,HOU,26,14,21,19,0,0,0,80,UTA,22,28,22,18,0,0,0,90,20041126
2005,ATL,23,26,21,22,0,0,0,92,CHA,22,29,26,30,0,0,0,107,20041127
2005,CHI,17,20,15,22,0,0,0,74,CLE,21,28,27,20,0,0,0,96,20041127
2005,DEN,25,21,20,16,0,0,0,82,HOU,13,21,22,20,0,0,0,76,20041127
2005,DAL,27,24,23,24,0,0,0,98,MEM,30,28,16,11,0,0,0,85,20041127
2005,DET,22,26,17,25,0,0,0,90,MIL,33,16,22,25,0,0,0,96,20041127
2005,TOR,16,27,23,36,0,0,0,102,NYK,29,21,25,33,0,0,0,108,20041127
2005,PHI,25,31,23,20,0,0,0,99,ORL,28,21,30,26,0,0,0,105,20041127
2005,UTA,10,18,30,18,0,0,0,76,SAS,28,26,27,28,0,0,0,109,20041127
2005,GSW,29,19,15,28,0,0,0,91,LAC,31,23,29,20,0,0,0,103,20041128
2005,NOH,20,22,21,13,0,0,0,76,LAL,21,20,26,22,0,0,0,89,20041128
2005,BOS,30,30,17,27,0,0,0,104,MIA,34,25,26,21,0,0,0,106,20041128
2005,NJN,10,15,21,25,0,0,0,71,POR,9,21,26,27,0,0,0,83,20041128
2005,MIN,34,27,24,36,0,0,0,121,SAC,31,29,24,26,0,0,0,110,20041128
2005,IND,21,25,22,27,0,0,0,95,SEA,24,31,22,26,0,0,0,103,20041128
2005,WAS,20,25,21,34,14,0,0,114,TOR,23,23,26,28,9,0,0,109,20041128
2005,NOH,18,21,20,8,0,0,0,67,DEN,27,15,16,18,0,0,0,76,20041129
2005,CLE,21,20,27,14,0,0,0,82,LAC,32,20,18,24,0,0,0,94,20041129
2005,BOS,37,32,25,23,0,0,0,117,ORL,20,25,33,23,0,0,0,101,20041129
2005,NYK,31,25,27,15,12,0,0,110,ATL,21,34,22,21,11,0,0,109,20041130
2005,SAS,26,24,19,38,0,0,0,107,DAL,14,26,25,24,0,0,0,89,20041130
2005,DET,25,19,25,24,0,0,0,93,HOU,18,15,26,13,0,0,0,72,20041130
2005,SAC,20,29,29,20,0,0,0,98,MEM,18,28,28,19,0,0,0,93,20041130
2005,TOR,21,27,20,26,0,0,0,94,MIA,17,25,23,27,0,0,0,92,20041130
2005,LAL,26,26,17,26,0,0,0,95,MIL,24,21,23,22,0,0,0,90,20041130
2005,CHA,20,26,14,26,0,0,0,86,NJN,27,23,22,27,0,0,0,99,20041130
2005,SEA,22,20,28,24,0,0,0,94,POR,23,22,17,38,0,0,0,100,20041130
2005,PHO,27,28,27,33,0,0,0,115,UTA,28,27,25,22,0,0,0,102,20041130
2005,MIL,28,30,22,20,0,0,0,100,BOS,30,24,29,18,0,0,0,101,20041201
2005,LAL,20,20,25,19,0,0,0,84,CHI,20,25,26,21,0,0,0,92,20041201
2005,MIN,29,22,27,29,0,0,0,107,GSW,27,27,30,15,0,0,0,99,20041201
2005,IND,21,17,20,18,0,0,0,76,LAC,24,16,24,24,0,0,0,88,20041201
2005,SAC,21,27,26,20,0,0,0,94,NOH,23,11,23,24,0,0,0,81,20041201
2005,MEM,23,21,17,21,0,0,0,82,NYK,18,31,22,19,0,0,0,90,20041201
2005,TOR,34,26,15,33,0,0,0,108,ORL,34,34,34,27,0,0,0,129,20041201
2005,CLE,29,17,27,28,0,0,0,101,PHO,24,24,38,34,0,0,0,120,20041201
2005,PHI,25,11,16,20,0,0,0,72,SAS,25,30,20,30,0,0,0,105,20041201
2005,UTA,27,24,31,28,9,0,0,119,SEA,29,27,29,25,19,0,0,129,20041201
2005,NJN,16,23,17,12,0,0,0,68,WAS,18,30,23,24,0,0,0,95,20041201
2005,HOU,24,27,21,21,13,0,0,106,DAL,25,31,20,17,20,0,0,113,20041202
2005,CLE,30,28,20,14,0,0,0,92,DEN,13,17,25,18,0,0,0,73,20041202
2005,WAS,36,26,31,21,0,0,0,114,ATL,18,17,28,27,0,0,0,90,20041203
2005,TOR,25,27,16,21,0,0,0,89,BOS,18,25,23,25,0,0,0,91,20041203
2005,MIA,24,29,25,27,0,0,0,105,CHI,21,29,18,13,0,0,0,81,20041203
2005,GSW,20,27,24,17,0,0,0,88,LAL,29,25,17,26,0,0,0,97,20041203
2005,PHI,22,14,24,26,0,0,0,86,MEM,23,24,24,23,0,0,0,94,20041203
2005,ORL,25,24,30,25,0,0,0,104,NYK,28,31,23,16,0,0,0,98,20041203
2005,MIN,29,21,19,28,0,0,0,97,PHO,29,17,24,23,0,0,0,93,20041203
2005,IND,22,25,20,20,0,0,0,87,SAC,30,30,31,22,0,0,0,113,20041203
2005,DET,16,21,11,29,0,0,0,77,SAS,22,24,17,17,0,0,0,80,20041203
2005,NYK,27,30,24,20,0,0,0,101,CHA,28,25,25,29,0,0,0,107,20041204
2005,TOR,18,30,26,23,0,0,0,97,CLE,39,18,25,23,0,0,0,105,20041204
2005,UTA,20,21,27,18,0,0,0,86,DAL,24,23,28,34,0,0,0,109,20041204
2005,MIA,22,26,19,28,0,0,0,95,DEN,35,21,23,25,0,0,0,104,20041204
2005,IND,29,18,23,26,0,0,0,96,GSW,28,28,21,27,0,0,0,104,20041204
2005,PHI,19,22,18,17,0,0,0,76,HOU,21,14,20,22,0,0,0,77,20041204
2005,MIN,32,17,25,18,15,0,0,107,LAC,22,20,27,23,8,0,0,100,20041204
2005,SAS,18,30,32,24,0,0,0,104,MIL,21,19,20,23,0,0,0,83,20041204
2005,ATL,22,19,17,30,0,0,0,88,NJN,30,27,23,29,0,0,0,109,20041204
2005,DET,32,19,23,18,0,0,0,92,NOH,20,18,17,14,0,0,0,69,20041204
2005,MEM,20,18,22,31,0,0,0,91,ORL,29,26,18,23,0,0,0,96,20041204
2005,POR,22,28,21,18,0,0,0,89,SEA,22,30,29,18,0,0,0,99,20041204
2005,CHI,20,26,24,18,0,0,0,88,WAS,17,22,30,26,0,0,0,95,20041204
2005,PHO,29,33,37,22,0,0,0,121,POR,30,20,26,23,0,0,0,99,20041205
2005,BOS,36,27,17,25,0,0,0,105,SAC,18,37,38,26,0,0,0,119,20041205
2005,PHI,27,27,21,17,0,0,0,92,ATL,26,20,25,25,0,0,0,96,20041206
2005,SAS,21,20,29,21,0,0,0,91,CHI,13,19,23,20,0,0,0,75,20041206
2005,DET,23,26,32,20,0,0,0,101,DAL,17,22,24,22,0,0,0,85,20041206
2005,ORL,21,25,28,28,0,0,0,102,DEN,31,37,20,27,0,0,0,115,20041206
2005,BOS,28,27,26,25,0,0,0,106,GSW,24,33,25,28,0,0,0,110,20041206
2005,CHA,25,22,19,13,10,4,0,93,LAC,23,21,19,16,10,10,0,99,20041206
2005,TOR,22,25,23,16,0,0,0,86,NJN,16,26,25,21,0,0,0,88,20041206
2005,MIA,29,20,32,19,0,0,0,100,UTA,17,29,17,17,0,0,0,80,20041206
2005,NJN,23,21,32,21,0,0,0,97,CLE,28,25,26,24,0,0,0,103,20041207
2005,NOH,16,14,23,28,0,0,0,81,HOU,22,21,16,30,0,0,0,89,20041207
2005,MIL,21,20,20,28,0,0,0,89,IND,19,16,19,32,0,0,0,86,20041207
2005,NYK,18,29,18,23,0,0,0,88,MEM,28,21,29,18,0,0,0,96,20041207
2005,DAL,28,22,21,26,0,0,0,97,MIN,28,18,18,23,0,0,0,87,20041207
2005,GSW,37,30,20,17,0,0,0,104,PHO,29,33,21,35,0,0,0,118,20041207
2005,CHA,28,20,21,23,0,0,0,92,SAC,22,33,30,24,0,0,0,109,20041207
2005,MEM,22,22,21,32,0,0,0,97,ATL,18,21,27,23,0,0,0,89,20041208
2005,CLE,21,23,18,23,0,0,0,85,CHI,27,27,26,33,0,0,0,113,20041208
2005,TOR,20,17,21,22,6,0,0,86,DET,17,21,31,11,10,0,0,90,20041208
2005,PHO,30,37,20,26,0,0,0,113,LAL,22,39,28,21,0,0,0,110,20041208
2005,MIA,24,14,32,31,0,0,0,101,MIL,17,24,22,33,0,0,0,96,20041208
2005,NYK,26,21,21,18,0,0,0,86,NOH,17,15,22,25,0,0,0,79,20041208
2005,MIN,31,30,29,29,0,0,0,119,PHI,26,22,19,17,0,0,0,84,20041208
2005,SEA,31,29,16,26,0,0,0,102,SAS,29,12,27,28,0,0,0,96,20041208
2005,ORL,26,29,31,20,0,0,0,106,UTA,34,23,26,17,0,0,0,100,20041208
2005,DEN,29,31,24,27,0,0,0,111,WAS,28,22,28,27,0,0,0,105,20041208
2005,SEA,35,27,18,27,0,0,0,107,DAL,26,26,21,29,0,0,0,102,20041209
2005,SAS,12,22,24,22,0,0,0,80,HOU,18,20,16,27,0,0,0,81,20041209
2005,BOS,25,27,13,22,0,0,0,87,POR,24,26,16,23,0,0,0,89,20041209
2005,PHI,17,34,26,16,0,0,0,93,CHI,19,27,22,20,0,0,0,88,20041210
2005,ATL,32,24,18,14,0,0,0,88,DET,20,18,16,18,0,0,0,72,20041210
2005,ORL,24,40,20,29,0,0,0,113,GSW,34,31,19,25,0,0,0,109,20041210
2005,MEM,25,20,23,16,0,0,0,84,MIA,24,23,22,23,0,0,0,92,20041210
2005,IND,28,20,16,22,0,0,0,86,MIL,21,21,34,19,0,0,0,95,20041210
2005,SAC,28,26,28,23,0,0,0,105,MIN,18,30,28,37,0,0,0,113,20041210
2005,NOH,22,20,21,23,5,0,0,91,NJN,26,17,22,21,8,0,0,94,20041210
2005,CHA,29,26,24,27,0,0,0,106,PHO,35,29,29,22,0,0,0,115,20041210
2005,DEN,29,27,27,18,0,0,0,101,TOR,18,19,23,27,0,0,0,87,20041210
2005,POR,19,24,21,17,6,0,0,87,UTA,19,23,20,19,11,0,0,92,20041210
2005,NYK,28,30,27,19,0,0,0,104,WAS,30,23,28,25,0,0,0,106,20041210
2005,NJN,22,16,26,31,0,0,0,95,ATL,17,23,20,30,0,0,0,90,20041211
2005,MIN,19,22,25,22,0,0,0,88,CHI,33,26,14,26,0,0,0,99,20041211
2005,DAL,28,22,28,24,0,0,0,102,HOU,15,26,17,20,0,0,0,78,20041211
2005,SAC,25,15,22,23,12,0,0,97,IND,19,27,19,20,7,0,0,92,20041211
2005,LAL,23,30,20,16,0,0,0,89,LAC,30,19,21,17,0,0,0,87,20041211
2005,DET,18,18,17,15,0,0,0,68,MEM,16,19,23,14,0,0,0,72,20041211
2005,CLE,21,24,25,27,0,0,0,97,SAS,31,38,19,28,0,0,0,116,20041211
2005,BOS,25,26,24,23,0,0,0,98,SEA,23,33,13,15,0,0,0,84,20041211
2005,CHA,28,24,16,19,0,0,0,87,GSW,23,23,27,26,0,0,0,99,20041212
2005,ORL,31,28,25,14,0,0,0,98,LAL,24,32,28,21,0,0,0,105,20041212
2005,DEN,24,20,27,25,0,0,0,96,NYK,21,28,34,24,0,0,0,107,20041212
2005,MIL,22,29,24,26,0,0,0,101,PHI,26,24,24,33,0,0,0,107,20041212
2005,UTA,23,19,26,20,0,0,0,88,POR,19,31,20,28,0,0,0,98,20041212
2005,MIA,18,36,23,29,0,0,0,106,TOR,27,30,23,18,0,0,0,98,20041212
2005,NOH,23,14,16,16,0,0,0,69,WAS,17,25,22,24,0,0,0,88,20041212
2005,DAL,20,26,19,29,0,0,0,94,CHI,23,23,24,23,0,0,0,93,20041213
2005,BOS,26,26,25,32,7,18,0,134,LAC,32,30,23,24,7,11,0,127,20041213
2005,CLE,28,21,23,20,0,0,0,92,MEM,21,30,22,13,0,0,0,86,20041213
2005,WAS,16,16,30,21,0,0,0,83,MIA,20,23,28,35,0,0,0,106,20041213
2005,ORL,23,26,30,21,0,0,0,100,PHO,28,28,32,33,0,0,0,121,20041213
2005,IND,27,16,24,24,17,0,0,108,ATL,22,27,28,14,6,0,0,97,20041214
2005,NOH,21,25,25,15,7,0,0,93,CHA,21,24,26,15,8,0,0,94,20041214
2005,GSW,33,24,31,23,0,0,0,111,DAL,22,27,28,30,0,0,0,107,20041214
2005,SAC,22,21,22,24,0,0,0,89,MIL,17,27,28,14,0,0,0,86,20041214
2005,POR,23,19,26,21,0,0,0,89,MIN,23,22,25,30,0,0,0,100,20041214
2005,NYK,25,24,22,16,0,0,0,87,NJN,28,15,21,15,0,0,0,79,20041214
2005,DEN,27,29,25,21,0,0,0,102,PHI,27,19,30,34,0,0,0,110,20041214
2005,LAL,23,20,23,27,0,0,0,93,SEA,32,21,27,28,0,0,0,108,20041214
2005,LAC,22,22,26,21,0,0,0,91,UTA,23,21,27,22,0,0,0,93,20041214
2005,DEN,24,24,29,23,0,0,0,100,BOS,26,15,32,26,0,0,0,99,20041215
2005,POR,20,25,19,24,0,0,0,88,CLE,19,32,29,32,0,0,0,112,20041215
2005,ATL,17,19,11,22,0,0,0,69,HOU,24,17,21,30,0,0,0,92,20041215
2005,CHI,23,21,27,25,0,0,0,96,MEM,27,21,22,18,0,0,0,88,20041215
2005,GSW,17,27,22,23,0,0,0,89,NOH,21,21,26,30,0,0,0,98,20041215
2005,DET,23,17,31,23,0,0,0,94,NYK,28,28,17,20,0,0,0,93,20041215
2005,UTA,26,23,23,14,0,0,0,86,PHO,19,41,29,19,0,0,0,108,20041215
2005,ORL,25,23,28,15,0,0,0,91,SAS,25,29,12,28,0,0,0,94,20041215
2005,MIN,27,25,22,16,0,0,0,90,TOR,25,22,24,25,0,0,0,96,20041215
2005,MIA,23,20,28,27,0,0,0,98,WAS,26,21,28,18,0,0,0,93,20041215
2005,MIL,24,17,16,20,0,0,0,77,CHI,17,23,19,26,0,0,0,85,20041216
2005,CLE,23,18,6,22,0,0,0,69,DET,19,12,21,29,0,0,0,81,20041216
2005,LAL,27,28,37,23,0,0,0,115,SAC,25,24,22,28,0,0,0,99,20041216
2005,POR,21,22,29,28,0,0,0,100,ATL,14,25,25,20,0,0,0,84,20041217
2005,UTA,17,23,27,39,0,0,0,106,BOS,29,29,28,28,0,0,0,114,20041217
2005,GSW,17,22,21,23,0,0,0,83,HOU,26,29,22,23,0,0,0,100,20041217
2005,TOR,21,26,24,15,0,0,0,86,IND,14,31,27,17,0,0,0,89,20041217
2005,WAS,30,24,29,21,16,0,0,120,LAL,28,26,25,25,12,0,0,116,20041217
2005,NJN,20,15,20,29,0,0,0,84,MEM,15,22,25,27,0,0,0,89,20041217
2005,DEN,25,21,26,28,0,0,0,100,MIA,30,27,29,21,0,0,0,107,20041217
2005,LAC,23,16,24,23,0,0,0,86,MIN,24,23,34,32,0,0,0,113,20041217
2005,SAS,16,28,18,21,0,0,0,83,NOH,21,17,16,13,0,0,0,67,20041217
2005,NYK,24,26,21,29,13,0,0,113,PHI,31,30,25,14,7,0,0,107,20041217
2005,PHO,21,34,23,34,0,0,0,112,SEA,37,20,24,29,0,0,0,110,20041217
2005,HOU,31,22,30,11,6,0,0,100,CHA,28,21,23,22,7,0,0,101,20041218
2005,IND,21,21,20,9,0,0,0,71,CHI,29,19,22,15,0,0,0,85,20041218
2005,BOS,27,27,20,28,12,0,0,114,CLE,27,30,30,15,5,0,0,107,20041218
2005,ATL,12,16,17,23,0,0,0,68,DAL,27,24,26,13,0,0,0,90,20041218
2005,POR,20,22,17,16,0,0,0,75,DET,19,17,15,23,0,0,0,74,20041218
2005,PHI,29,26,23,38,0,0,0,116,MIL,17,22,30,28,0,0,0,97,20041218
2005,DEN,23,27,16,29,0,0,0,95,ORL,33,31,33,20,0,0,0,117,20041218
2005,WAS,28,17,22,29,0,0,0,96,PHO,33,20,25,32,0,0,0,110,20041218
2005,GSW,27,18,22,18,0,0,0,85,SAS,16,33,23,32,0,0,0,104,20041218
2005,MEM,33,13,22,24,0,0,0,92,LAC,21,18,29,14,0,0,0,82,20041219
2005,ORL,30,33,23,21,0,0,0,107,MIA,30,24,32,31,0,0,0,117,20041219
2005,UTA,16,20,27,30,0,0,0,93,NYK,19,22,24,29,0,0,0,94,20041219
2005,NOH,28,11,14,18,0,0,0,71,SAC,28,22,35,22,0,0,0,107,20041219
2005,NJN,22,27,24,26,0,0,0,99,TOR,22,28,29,31,0,0,0,110,20041219
2005,POR,18,32,13,24,0,0,0,87,CHI,26,23,24,19,0,0,0,92,20041220
2005,PHO,28,25,28,26,0,0,0,107,DEN,32,22,23,28,0,0,0,105,20041220
2005,WAS,25,27,31,20,0,0,0,103,GSW,21,20,33,27,0,0,0,101,20041220
2005,TOR,24,22,27,29,0,0,0,102,HOU,24,27,29,34,0,0,0,114,20041220
2005,MEM,22,22,25,13,0,0,0,82,LAL,26,22,15,9,0,0,0,72,20041220
2005,UTA,29,28,20,26,0,0,0,103,PHI,20,21,38,22,0,0,0,101,20041220
2005,NJN,22,23,26,23,0,0,0,94,CHA,22,17,26,26,0,0,0,91,20041221
2005,MIN,22,21,24,30,0,0,0,97,CLE,29,29,19,30,0,0,0,107,20041221
2005,NOH,9,24,29,19,10,0,0,91,LAC,24,26,15,16,19,0,0,100,20041221
2005,BOS,33,27,21,19,0,0,0,100,MIA,33,26,28,21,0,0,0,108,20041221
2005,DAL,35,40,26,22,0,0,0,123,NYK,19,17,28,30,0,0,0,94,20041221
2005,WAS,25,22,24,22,0,0,0,93,SAC,32,24,24,24,0,0,0,104,20041221
2005,DAL,22,24,24,30,0,0,0,100,ATL,28,20,30,35,0,0,0,113,20041222
2005,NYK,34,24,26,25,0,0,0,109,BOS,23,27,30,34,0,0,0,114,20041222
2005,CHI,19,27,18,25,0,0,0,89,DET,19,19,24,20,0,0,0,82,20041222
2005,MEM,29,25,20,25,0,0,0,99,GSW,21,23,35,30,0,0,0,109,20041222
2005,CHA,16,22,28,24,0,0,0,90,HOU,23,21,18,25,0,0,0,87,20041222
2005,PHI,20,22,24,36,0,0,0,102,IND,25,25,21,19,0,0,0,90,20041222
2005,NOH,21,22,21,25,0,0,0,89,LAL,27,21,23,30,0,0,0,101,20041222
2005,POR,28,24,25,27,0,0,0,104,MIL,22,23,18,32,0,0,0,95,20041222
2005,CLE,28,10,29,23,0,0,0,90,NJN,18,31,19,24,0,0,0,92,20041222
2005,SAS,19,21,24,23,0,0,0,87,ORL,16,30,18,29,0,0,0,93,20041222
2005,DEN,15,23,31,14,0,0,0,83,SEA,24,29,26,19,0,0,0,98,20041222
2005,UTA,19,18,29,20,0,0,0,86,TOR,28,22,20,28,0,0,0,98,20041222
2005,MEM,27,26,24,25,0,0,0,102,PHO,29,27,22,31,0,0,0,109,20041223
2005,MIA,21,31,29,28,0,0,0,109,SAC,34,23,26,24,0,0,0,107,20041223
2005,MIN,29,22,14,17,0,0,0,82,SAS,26,17,22,31,0,0,0,96,20041223
2005,DET,18,28,23,29,0,0,0,98,IND,21,24,16,32,0,0,0,93,20041225
2005,MIA,32,22,19,21,10,0,0,104,LAL,31,25,21,17,8,0,0,102,20041225
2005,NOH,22,20,29,20,0,0,0,91,CLE,28,25,20,27,0,0,0,100,20041226
2005,DAL,25,18,32,27,0,0,0,102,DEN,24,28,20,16,0,0,0,88,20041226
2005,LAC,20,20,19,20,0,0,0,79,HOU,31,21,19,25,0,0,0,96,20041226
2005,CHI,24,28,21,19,0,0,0,92,MIL,36,25,15,23,0,0,0,99,20041226
2005,WAS,16,20,23,15,0,0,0,74,MIN,23,24,31,31,0,0,0,109,20041226
2005,CHA,28,14,18,22,0,0,0,82,NYK,24,23,25,19,0,0,0,91,20041226
2005,TOR,14,25,30,25,0,0,0,94,PHO,32,24,19,31,0,0,0,106,20041226
2005,GSW,21,15,37,25,0,0,0,98,SAC,18,28,24,24,0,0,0,94,20041226
2005,BOS,18,25,23,24,0,0,0,90,SAS,25,25,31,26,0,0,0,107,20041226
2005,NJN,21,27,18,21,3,0,0,90,DET,24,14,23,26,13,0,0,100,20041227
2005,DEN,26,20,32,23,0,0,0,101,GSW,26,27,22,29,0,0,0,104,20041227
2005,NOH,19,22,18,23,0,0,0,82,IND,27,28,23,22,0,0,0,100,20041227
2005,LAC,12,28,15,21,0,0,0,76,MEM,29,22,24,21,0,0,0,96,20041227
2005,ATL,24,32,24,22,0,0,0,102,MIA,29,26,33,28,0,0,0,116,20041227
2005,NYK,30,41,24,24,0,0,0,119,ORL,24,30,30,27,0,0,0,111,20041227
2005,PHI,27,27,23,34,0,0,0,111,POR,30,30,21,23,0,0,0,104,20041227
2005,SEA,29,23,21,25,0,0,0,98,UTA,21,31,20,16,0,0,0,88,20041227
2005,CHA,27,22,19,19,0,0,0,87,WAS,30,30,24,22,0,0,0,106,20041227
2005,CLE,26,24,29,32,0,0,0,111,ATL,32,19,24,27,0,0,0,102,20041228
2005,NJN,12,18,21,33,0,0,0,84,CHI,12,19,25,24,0,0,0,80,20041228
2005,BOS,20,29,24,21,0,0,0,94,DAL,41,32,18,22,0,0,0,113,20041228
2005,TOR,26,29,27,17,0,0,0,99,LAL,24,35,22,36,0,0,0,117,20041228
2005,HOU,25,16,18,28,0,0,0,87,MIL,37,23,30,25,0,0,0,115,20041228
2005,PHO,35,19,15,25,0,0,0,94,SAS,32,29,32,22,0,0,0,115,20041228
2005,PHI,29,30,28,27,0,0,0,114,SEA,26,22,31,28,0,0,0,107,20041228
2005,IND,14,19,22,19,0,0,0,74,CHA,15,19,19,18,0,0,0,71,20041229
2005,HOU,27,23,23,25,0,0,0,98,CLE,26,17,26,18,0,0,0,87,20041229
2005,TOR,30,26,26,23,0,0,0,105,GSW,26,29,23,33,0,0,0,111,20041229
2005,UTA,28,18,14,30,0,0,0,90,LAC,26,23,22,30,0,0,0,101,20041229
2005,BOS,38,27,29,15,0,0,0,109,MEM,29,27,27,34,0,0,0,117,20041229
2005,PHO,24,30,26,27,0,0,0,107,NOH,18,26,26,26,0,0,0,96,20041229
2005,MIN,22,19,25,21,0,0,0,87,NYK,24,24,21,31,0,0,0,100,20041229
2005,MIL,33,23,30,25,0,0,0,111,ORL,26,24,27,28,0,0,0,105,20041229
2005,DET,23,19,32,33,0,0,0,107,WAS,25,34,20,26,0,0,0,105,20041229
2005,SEA,26,35,23,10,0,0,0,94,ATL,22,22,19,16,0,0,0,79,20041230
2005,MIA,17,24,26,22,0,0,0,89,DET,20,27,22,9,0,0,0,78,20041230
2005,IND,23,21,22,30,0,0,0,96,NJN,17,17,29,20,0,0,0,83,20041230
2005,SAS,21,36,21,36,0,0,0,114,POR,14,22,26,18,0,0,0,80,20041230
2005,WAS,25,27,25,26,0,0,0,103,BOS,21,33,26,28,0,0,0,108,20041231
2005,SEA,30,27,18,28,0,0,0,103,CHA,22,23,30,22,0,0,0,97,20041231
2005,PHI,28,24,22,18,0,0,0,92,DEN,25,21,21,30,0,0,0,97,20041231
2005,MIL,20,24,19,27,0,0,0,90,HOU,27,24,22,32,0,0,0,105,20041231
2005,SAS,14,25,31,28,0,0,0,98,LAC,22,17,23,17,0,0,0,79,20041231
2005,SAC,22,31,28,28,0,0,0,109,UTA,28,25,17,32,0,0,0,102,20041231
2005,ORL,21,16,23,30,0,0,0,90,CHI,33,27,27,18,0,0,0,105,20050101
2005,CHA,20,23,25,22,0,0,0,90,MIA,28,27,35,23,0,0,0,113,20050101
2005,MEM,23,27,31,23,0,0,0,104,MIN,34,23,19,19,0,0,0,95,20050101
2005,NJN,26,23,16,28,0,0,0,93,NYK,20,16,22,29,0,0,0,87,20050101
2005,GSW,31,17,23,17,0,0,0,88,POR,18,23,24,32,0,0,0,97,20050101
2005,MIL,19,31,30,24,0,0,0,104,DAL,33,33,22,35,0,0,0,123,20050102
2005,BOS,24,15,22,27,0,0,0,88,DET,30,23,32,15,0,0,0,100,20050102
2005,UTA,23,23,19,15,0,0,0,80,HOU,26,18,32,23,0,0,0,99,20050102
2005,PHI,21,12,20,30,0,0,0,83,LAC,22,23,26,18,0,0,0,89,20050102
2005,DEN,21,21,21,28,0,0,0,91,LAL,24,20,35,20,0,0,0,99,20050102
2005,POR,30,26,23,19,0,0,0,98,PHO,22,41,20,34,0,0,0,117,20050102
2005,SAS,19,20,17,25,0,0,0,81,SAC,17,25,20,24,0,0,0,86,20050102
2005,ATL,26,20,25,30,0,0,0,101,WAS,26,24,22,32,0,0,0,104,20050102
2005,NOH,18,28,19,25,0,0,0,90,BOS,25,21,36,26,0,0,0,108,20050103
2005,CLE,27,27,24,16,0,0,0,94,CHA,32,20,15,16,0,0,0,83,20050103
2005,DET,14,25,23,25,0,0,0,87,CHI,21,23,16,20,0,0,0,80,20050103
2005,LAC,33,27,14,28,0,0,0,102,DEN,24,26,26,22,0,0,0,98,20050103
2005,PHI,23,29,29,31,0,0,0,112,GSW,29,21,27,27,0,0,0,104,20050103
2005,UTA,23,14,21,24,0,0,0,82,MEM,22,16,30,24,0,0,0,92,20050103
2005,SEA,21,28,22,27,0,0,0,98,MIA,20,23,26,27,0,0,0,96,20050103
2005,ORL,23,22,23,26,0,0,0,94,TOR,34,24,25,22,0,0,0,105,20050103
2005,MIL,24,28,27,20,0,0,0,99,IND,27,28,28,33,0,0,0,116,20050104
2005,PHO,38,27,30,27,0,0,0,122,MIN,33,25,22,35,0,0,0,115,20050104
2005,SAC,22,34,25,24,0,0,0,105,NYK,21,22,36,19,0,0,0,98,20050104
2005,LAL,18,14,21,30,0,0,0,83,SAS,32,24,22,22,0,0,0,100,20050104
2005,NJN,25,23,24,16,0,0,0,88,WAS,24,24,28,36,0,0,0,112,20050104
2005,GSW,23,20,21,19,0,0,0,83,BOS,25,20,27,12,0,0,0,84,20050105
2005,MIN,24,16,25,19,0,0,0,84,CHA,21,22,24,35,0,0,0,102,20050105
2005,ATL,29,20,28,8,0,0,0,85,CLE,29,19,30,23,0,0,0,101,20050105
2005,LAL,17,34,32,21,0,0,0,104,DAL,30,33,30,25,0,0,0,118,20050105
2005,PHO,32,27,27,22,0,0,0,108,HOU,24,28,23,23,0,0,0,98,20050105
2005,POR,23,28,21,26,0,0,0,98,LAC,23,25,27,27,0,0,0,102,20050105
2005,NYK,19,20,23,32,0,0,0,94,MIA,24,26,24,28,0,0,0,102,20050105
2005,NJN,21,23,19,11,0,0,0,74,MIL,22,31,21,23,0,0,0,97,20050105
2005,CHI,25,28,22,20,0,0,0,95,NOH,18,30,16,25,0,0,0,89,20050105
2005,SEA,26,23,18,20,0,0,0,87,ORL,15,31,30,29,0,0,0,105,20050105
2005,SAC,23,17,16,37,0,0,0,93,TOR,29,20,22,25,0,0,0,96,20050105
2005,PHI,39,20,18,29,0,0,0,106,UTA,21,27,25,26,0,0,0,99,20050105
2005,MEM,28,25,29,19,0,0,0,101,DET,23,21,16,19,0,0,0,79,20050106
2005,IND,24,27,27,20,0,0,0,98,SAS,31,26,27,27,0,0,0,111,20050106
2005,SEA,17,25,29,25,0,0,0,96,WAS,29,31,25,22,0,0,0,107,20050106
2005,SAC,28,25,26,21,0,0,0,100,ATL,31,15,31,20,0,0,0,97,20050107
2005,DET,30,33,19,28,0,0,0,110,BOS,29,24,20,31,0,0,0,104,20050107
2005,UTA,22,18,18,20,0,0,0,78,CHI,12,27,29,16,0,0,0,84,20050107
2005,HOU,13,24,37,30,0,0,0,104,LAL,26,35,22,28,0,0,0,111,20050107
2005,NOH,19,23,23,11,0,0,0,76,MEM,25,24,22,13,0,0,0,84,20050107
2005,PHI,15,22,21,26,0,0,0,84,MIN,19,24,22,24,0,0,0,89,20050107
2005,GSW,18,18,17,19,0,0,0,72,NJN,28,10,25,19,0,0,0,82,20050107
2005,CHA,27,24,20,20,0,0,0,91,ORL,29,34,28,20,0,0,0,111,20050107
2005,MIA,35,23,24,21,0,0,0,103,POR,22,23,26,21,0,0,0,92,20050107
2005,MIL,32,15,27,22,11,0,0,107,TOR,25,27,29,15,9,0,0,105,20050107
2005,BOS,25,27,17,22,0,0,0,91,CHI,28,30,25,19,0,0,0,102,20050108
2005,NYK,22,14,23,20,0,0,0,79,CLE,29,38,20,17,0,0,0,104,20050108
2005,IND,22,33,31,15,0,0,0,101,DAL,34,43,28,16,0,0,0,121,20050108
2005,PHO,33,36,26,13,0,0,0,108,LAC,14,32,28,17,0,0,0,91,20050108
2005,UTA,22,21,24,19,0,0,0,86,MIL,18,19,21,31,0,0,0,89,20050108
2005,SAC,26,23,23,30,15,0,0,117,NOH,23,24,25,30,19,0,0,121,20050108
2005,NJN,17,26,18,40,0,0,0,101,ORL,28,21,28,27,0,0,0,104,20050108
2005,DEN,18,20,30,22,0,0,0,90,SAS,24,24,24,27,0,0,0,99,20050108
2005,MIN,22,33,31,28,0,0,0,114,WAS,33,21,33,30,0,0,0,117,20050108
2005,HOU,35,23,17,41,0,0,0,116,DEN,23,24,26,25,0,0,0,98,20050109
2005,POR,23,19,32,31,0,0,0,105,NYK,31,24,29,29,0,0,0,113,20050109
2005,IND,17,25,17,30,0,0,0,89,PHO,35,30,32,27,0,0,0,124,20050109
2005,MIA,30,27,21,20,0,0,0,98,SEA,24,25,32,27,0,0,0,108,20050109
2005,GSW,23,21,17,26,0,0,0,87,TOR,18,24,36,31,0,0,0,109,20050109
2005,ORL,26,24,16,35,0,0,0,101,BOS,32,33,28,26,0,0,0,119,20050110
2005,GSW,22,26,17,20,0,0,0,85,CHI,27,22,35,10,0,0,0,94,20050110
2005,LAL,14,30,23,38,0,0,0,105,MIN,27,26,23,20,0,0,0,96,20050110
2005,POR,29,33,31,16,0,0,0,109,PHI,28,23,21,28,0,0,0,100,20050110
2005,SAS,20,22,30,24,0,0,0,96,UTA,23,22,27,25,0,0,0,97,20050110
2005,MIL,16,21,16,27,0,0,0,80,ATL,29,26,26,22,0,0,0,103,20050111
2005,CHA,23,19,32,13,11,0,0,98,CLE,19,26,19,23,13,0,0,100,20050111
2005,IND,22,26,13,25,0,0,0,86,MEM,28,29,10,18,0,0,0,85,20050111
2005,DET,18,27,23,21,0,0,0,89,NJN,16,21,22,21,0,0,0,80,20050111
2005,NOH,26,28,16,18,0,0,0,88,NYK,22,25,14,21,0,0,0,82,20050111
2005,MIA,25,30,25,27,0,0,0,107,PHO,40,27,33,22,0,0,0,122,20050111
2005,DEN,27,25,18,30,0,0,0,100,SAC,29,27,25,28,0,0,0,109,20050111
2005,LAC,27,23,26,23,0,0,0,99,SEA,31,20,23,30,0,0,0,104,20050111
2005,PHI,24,14,23,17,0,0,0,78,CHI,26,19,29,36,0,0,0,110,20050112
2005,HOU,34,23,37,30,0,0,0,124,DAL,35,26,24,29,0,0,0,114,20050112
2005,LAL,21,14,27,21,0,0,0,83,DEN,23,26,25,21,0,0,0,95,20050112
2005,NOH,22,16,21,17,0,0,0,76,DET,25,21,26,18,0,0,0,90,20050112
2005,MIA,25,23,27,23,0,0,0,98,GSW,22,25,18,26,0,0,0,91,20050112
2005,SEA,23,19,28,22,0,0,0,92,LAC,24,27,19,33,0,0,0,103,20050112
2005,ORL,25,25,21,16,0,0,0,87,MIN,23,18,21,18,0,0,0,80,20050112
2005,MIL,23,17,24,15,0,0,0,79,SAS,22,27,25,20,0,0,0,94,20050112
2005,BOS,25,24,26,18,0,0,0,93,TOR,29,30,25,20,0,0,0,104,20050112
2005,PHO,29,20,33,26,0,0,0,108,UTA,26,29,34,26,0,0,0,115,20050112
2005,POR,27,20,20,33,0,0,0,100,WAS,22,27,31,24,0,0,0,104,20050112
2005,NJN,19,24,19,19,4,0,0,85,HOU,12,29,22,18,13,0,0,94,20050113
2005,CLE,30,17,24,23,0,0,0,94,LAL,24,25,22,27,0,0,0,98,20050113
2005,UTA,24,18,25,26,0,0,0,93,SAC,18,37,27,25,0,0,0,107,20050113
2005,ATL,21,26,29,18,0,0,0,94,BOS,34,21,25,26,0,0,0,106,20050114
2005,MEM,26,32,26,25,0,0,0,109,CHA,23,21,22,23,0,0,0,89,20050114
2005,MIN,19,21,25,28,0,0,0,93,DEN,20,20,21,22,0,0,0,83,20050114
2005,ORL,24,17,23,30,0,0,0,94,DET,22,27,25,27,0,0,0,101,20050114
2005,PHO,23,25,15,20,0,0,0,83,IND,32,21,24,24,0,0,0,101,20050114
2005,MIA,31,17,27,21,10,6,0,112,LAC,21,32,21,22,10,8,0,114,20050114
2005,WAS,31,25,18,31,0,0,0,105,MIL,21,26,32,24,0,0,0,103,20050114
2005,POR,40,23,17,26,0,0,0,106,NOH,23,43,23,23,0,0,0,112,20050114
2005,TOR,26,24,26,20,0,0,0,96,PHI,33,24,19,30,0,0,0,106,20050114
2005,DAL,19,26,21,29,0,0,0,95,SAS,21,27,26,24,0,0,0,98,20050114
2005,GSW,28,24,19,13,0,0,0,84,SEA,27,25,29,22,0,0,0,103,20050114
2005,CHA,20,22,20,33,0,0,0,95,ATL,27,29,22,25,0,0,0,103,20050115
2005,NYK,20,22,23,19,0,0,0,84,CHI,22,15,19,30,0,0,0,86,20050115
2005,NJN,14,24,21,34,0,0,0,93,DAL,25,14,23,36,0,0,0,98,20050115
2005,PHI,21,21,24,29,0,0,0,95,DET,24,27,25,23,0,0,0,99,20050115
2005,LAL,33,18,26,27,0,0,0,104,GSW,29,20,32,21,0,0,0,102,20050115
2005,SAS,18,10,22,17,0,0,0,67,HOU,10,20,18,25,0,0,0,73,20050115
2005,ORL,27,26,12,20,0,0,0,85,IND,22,20,15,27,0,0,0,84,20050115
2005,MIL,21,21,23,17,0,0,0,82,MEM,25,23,29,24,0,0,0,101,20050115
2005,POR,25,19,19,21,0,0,0,84,MIN,20,24,23,25,0,0,0,92,20050115
2005,LAC,19,29,21,26,0,0,0,95,SAC,24,23,30,22,0,0,0,99,20050115
2005,CLE,11,18,24,31,0,0,0,84,UTA,23,19,15,14,0,0,0,71,20050115
2005,PHO,21,32,25,25,0,0,0,103,WAS,21,31,20,36,0,0,0,108,20050115
2005,CLE,24,31,20,22,0,0,0,97,SEA,29,24,23,29,0,0,0,105,20050116
2005,NOH,26,35,16,22,0,0,0,99,TOR,26,21,19,36,0,0,0,102,20050116
2005,NJN,26,16,23,20,0,0,0,85,ATL,18,19,21,26,0,0,0,84,20050117
2005,MIL,23,19,28,29,0,0,0,99,CHA,28,19,23,22,0,0,0,92,20050117
2005,PHO,20,24,16,20,0,0,0,80,DET,29,28,22,15,0,0,0,94,20050117
2005,DEN,21,31,22,23,0,0,0,97,GSW,26,23,31,27,0,0,0,107,20050117
2005,SAC,30,16,20,23,0,0,0,89,LAC,17,26,23,17,0,0,0,83,20050117
2005,UTA,26,20,22,34,0,0,0,102,LAL,18,27,24,25,0,0,0,94,20050117
2005,HOU,25,22,13,20,0,0,0,80,MEM,25,29,19,26,0,0,0,99,20050117
2005,TOR,30,28,16,26,0,0,0,100,MIN,24,21,23,23,0,0,0,91,20050117
2005,CHI,20,23,25,20,0,0,0,88,NYK,28,20,19,19,0,0,0,86,20050117
2005,NOH,22,20,15,34,0,0,0,91,PHI,28,31,20,16,0,0,0,95,20050117
2005,WAS,15,19,16,23,0,0,0,73,SAS,30,25,22,24,0,0,0,101,20050117
2005,WAS,20,20,38,42,0,0,0,120,DAL,40,33,28,36,0,0,0,137,20050118
2005,IND,21,21,19,26,0,0,0,87,HOU,13,25,21,15,0,0,0,74,20050118
2005,DET,33,17,30,21,0,0,0,101,ORL,29,23,24,27,0,0,0,103,20050118
2005,POR,23,27,28,22,7,0,0,107,SAC,20,27,31,22,13,0,0,113,20050118
2005,DEN,23,19,27,26,21,0,0,116,SEA,22,30,19,24,15,0,0,110,20050118
2005,CHI,28,19,22,14,0,0,0,83,BOS,28,22,18,24,0,0,0,92,20050119
2005,PHI,27,26,29,25,0,0,0,107,CHA,25,28,28,24,0,0,0,105,20050119
2005,MIN,21,28,18,23,0,0,0,90,LAL,23,23,19,28,0,0,0,93,20050119
2005,ATL,29,20,21,22,0,0,0,92,MIA,31,23,29,28,0,0,0,111,20050119
2005,MIL,27,20,21,22,0,0,0,90,NJN,31,23,19,23,0,0,0,96,20050119
2005,IND,24,24,13,26,0,0,0,87,NOH,25,22,14,29,0,0,0,90,20050119
2005,MEM,22,21,23,22,0,0,0,88,PHO,22,19,21,17,0,0,0,79,20050119
2005,CLE,26,29,24,28,0,0,0,107,POR,29,20,17,35,0,0,0,101,20050119
2005,LAC,19,22,14,24,0,0,0,79,SAS,21,19,25,15,0,0,0,80,20050119
2005,NYK,20,23,18,20,0,0,0,81,TOR,19,25,16,38,0,0,0,98,20050119
2005,LAC,29,19,20,9,0,0,0,77,DAL,20,22,31,26,0,0,0,99,20050120
2005,HOU,33,23,28,24,0,0,0,108,ORL,24,24,24,27,0,0,0,99,20050120
2005,CLE,24,26,20,26,0,0,0,96,SAC,28,31,31,33,0,0,0,123,20050120
2005,DAL,23,33,23,26,0,0,0,105,CHA,27,21,18,33,0,0,0,99,20050121
2005,ATL,20,23,28,14,0,0,0,85,CHI,23,32,19,21,0,0,0,95,20050121
2005,MEM,24,21,20,17,0,0,0,82,DEN,19,31,24,18,0,0,0,92,20050121
2005,GSW,24,27,26,24,0,0,0,101,LAL,26,26,29,24,0,0,0,105,20050121
2005,IND,30,17,26,20,13,0,0,106,MIA,23,23,23,24,7,0,0,100,20050121
2005,DET,26,22,18,20,0,0,0,86,MIL,29,15,22,23,0,0,0,89,20050121
2005,BOS,18,30,25,25,0,0,0,98,NJN,19,29,32,24,0,0,0,104,20050121
2005,HOU,22,21,29,20,0,0,0,92,NYK,22,24,17,28,0,0,0,91,20050121
2005,SAS,24,31,16,40,17,0,0,128,PHO,24,32,32,23,12,0,0,123,20050121
2005,MIN,25,37,26,24,0,0,0,112,SEA,18,33,25,31,0,0,0,107,20050121
2005,TOR,20,22,35,32,0,0,0,109,WAS,35,30,28,25,0,0,0,118,20050121
2005,BOS,23,27,30,16,0,0,0,96,ATL,21,26,22,31,0,0,0,100,20050122
2005,CHI,24,20,28,28,0,0,0,100,DET,24,23,21,21,0,0,0,89,20050122
2005,CLE,27,29,23,26,0,0,0,105,GSW,22,25,26,14,0,0,0,87,20050122
2005,WAS,22,20,23,30,0,0,0,95,IND,21,23,23,26,0,0,0,93,20050122
2005,LAC,27,19,14,25,0,0,0,85,NOH,27,16,20,25,0,0,0,88,20050122
2005,PHI,36,18,29,28,0,0,0,111,ORL,35,30,19,31,0,0,0,115,20050122
2005,MIN,22,21,19,30,0,0,0,92,POR,19,14,26,24,0,0,0,83,20050122
2005,MEM,28,19,32,31,0,0,0,110,UTA,20,21,29,24,0,0,0,94,20050122
2005,DEN,20,23,29,21,0,0,0,93,DAL,22,25,24,24,0,0,0,95,20050123
2005,NOH,13,12,20,23,0,0,0,68,MIA,37,19,22,19,0,0,0,97,20050123
2005,MIL,26,23,26,26,0,0,0,101,NYK,23,27,20,26,0,0,0,96,20050123
2005,NJN,23,34,21,27,0,0,0,105,PHO,25,30,34,24,0,0,0,113,20050123
2005,SAS,30,20,32,21,0,0,0,103,SAC,16,20,18,19,0,0,0,73,20050123
2005,UTA,23,24,33,25,0,0,0,105,SEA,33,29,24,36,0,0,0,122,20050123
2005,CHA,29,30,21,12,0,0,0,92,TOR,29,24,24,26,0,0,0,103,20050123
2005,CHI,23,35,36,13,0,0,0,107,ATL,24,12,21,25,0,0,0,82,20050124
2005,WAS,13,17,38,38,0,0,0,106,CLE,26,14,33,24,0,0,0,97,20050124
2005,ORL,15,12,24,27,0,0,0,78,HOU,24,24,19,22,0,0,0,89,20050124
2005,DAL,23,15,21,28,0,0,0,87,LAC,23,30,18,26,0,0,0,97,20050124
2005,DET,19,20,24,20,0,0,0,83,MIN,22,26,18,20,0,0,0,86,20050124
2005,MIA,27,28,21,22,0,0,0,98,PHI,32,25,20,29,0,0,0,106,20050124
2005,SAS,20,27,24,28,0,0,0,99,POR,30,16,28,33,0,0,0,107,20050124
2005,BOS,27,24,20,26,0,0,0,97,CHA,21,26,23,22,0,0,0,92,20050125
2005,DEN,27,22,29,29,0,0,0,107,CHI,19,32,28,32,0,0,0,111,20050125
2005,SEA,20,37,26,21,0,0,0,104,LAL,28,23,17,25,0,0,0,93,20050125
2005,ORL,15,27,22,19,0,0,0,83,MEM,25,17,21,32,0,0,0,95,20050125
2005,PHO,28,37,35,33,0,0,0,133,NYK,33,22,33,30,0,0,0,118,20050125
2005,NJN,18,27,23,25,0,0,0,93,SAC,30,26,32,25,0,0,0,113,20050125
2005,IND,28,20,20,18,0,0,0,86,BOS,26,23,28,23,0,0,0,100,20050126
2005,MEM,31,26,26,28,0,0,0,111,CLE,30,33,25,26,0,0,0,114,20050126
2005,DEN,12,22,17,19,0,0,0,70,DET,25,12,27,23,0,0,0,87,20050126
2005,NJN,28,27,28,30,0,0,0,113,GSW,14,27,33,25,0,0,0,99,20050126
2005,LAL,17,26,16,30,0,0,0,89,LAC,26,22,22,35,0,0,0,105,20050126
2005,PHO,30,31,32,28,0,0,0,121,MIL,31,26,25,33,0,0,0,115,20050126
2005,ATL,26,21,17,23,0,0,0,87,MIN,21,28,32,23,0,0,0,104,20050126
2005,HOU,19,22,14,27,0,0,0,82,NOH,16,23,24,14,0,0,0,77,20050126
2005,DAL,22,32,18,23,0,0,0,95,POR,15,24,32,17,0,0,0,88,20050126
2005,MIA,32,29,27,23,0,0,0,111,TOR,26,20,26,24,0,0,0,96,20050126
2005,SEA,18,33,26,23,0,0,0,100,UTA,22,25,32,30,0,0,0,109,20050126
2005,PHI,25,27,35,20,0,0,0,107,WAS,24,34,24,35,0,0,0,117,20050126
2005,CHA,21,23,29,20,0,0,0,93,CHI,29,21,24,27,0,0,0,101,20050127
2005,DET,26,21,23,18,0,0,0,88,IND,20,20,17,19,0,0,0,76,20050127
2005,SAC,24,21,22,13,0,0,0,80,SAS,30,23,17,20,0,0,0,90,20050127
2005,MIA,27,27,30,22,0,0,0,106,ATL,28,23,31,14,0,0,0,96,20050128
2005,PHO,40,34,22,32,0,0,0,128,BOS,31,17,36,35,0,0,0,119,20050128
2005,TOR,22,27,22,23,0,0,0,94,CHA,22,26,20,33,0,0,0,101,20050128
2005,SEA,23,21,20,24,0,0,0,88,GSW,18,25,18,24,0,0,0,85,20050128
2005,SAC,28,26,30,19,14,0,0,117,HOU,28,22,26,27,8,0,0,111,20050128
2005,NJN,17,31,33,28,0,0,0,109,LAL,25,19,33,26,0,0,0,103,20050128
2005,DEN,20,29,19,38,0,0,0,106,MIL,31,19,30,20,0,0,0,100,20050128
2005,UTA,22,24,22,23,0,0,0,91,MIN,13,23,28,29,0,0,0,93,20050128
2005,PHI,19,24,22,22,8,0,0,95,NOH,31,23,15,18,12,0,0,99,20050128
2005,CLE,30,18,21,27,0,0,0,96,NYK,20,24,31,24,0,0,0,99,20050128
2005,WAS,29,23,20,29,0,0,0,101,ORL,23,28,27,30,0,0,0,108,20050128
2005,LAC,22,26,18,20,0,0,0,86,POR,17,23,23,27,0,0,0,90,20050128
2005,BOS,20,27,21,33,0,0,0,101,CHI,27,20,29,21,0,0,0,97,20050129
2005,PHI,23,29,23,18,0,0,0,93,DAL,25,18,27,19,0,0,0,89,20050129
2005,NYK,18,17,13,13,0,0,0,61,DET,20,19,27,25,0,0,0,91,20050129
2005,DEN,25,30,24,16,0,0,0,95,IND,19,28,26,15,0,0,0,88,20050129
2005,GSW,25,24,24,12,0,0,0,85,LAC,21,28,31,16,0,0,0,96,20050129
2005,ATL,19,27,23,14,0,0,0,83,MEM,27,19,18,20,0,0,0,84,20050129
2005,NOH,21,28,20,14,0,0,0,83,SAS,33,19,21,20,0,0,0,93,20050129
2005,NJN,29,34,19,17,0,0,0,99,UTA,19,26,13,24,0,0,0,82,20050129
2005,ORL,20,35,21,27,0,0,0,103,WAS,21,24,27,25,0,0,0,97,20050129
2005,MIL,24,25,28,10,0,0,0,87,CLE,32,22,18,32,0,0,0,104,20050130
2005,CHA,22,19,21,28,0,0,0,90,LAL,27,23,27,24,0,0,0,101,20050130
2005,HOU,26,20,24,25,0,0,0,95,MIA,30,18,25,31,0,0,0,104,20050130
2005,SAC,20,19,31,24,0,0,0,94,MIN,20,25,17,22,0,0,0,84,20050130
2005,PHO,30,28,46,19,0,0,0,123,TOR,21,25,26,33,0,0,0,105,20050130
2005,ORL,19,13,22,25,0,0,0,79,ATL,20,20,21,19,0,0,0,80,20050131
2005,HOU,19,30,18,30,0,0,0,97,BOS,15,25,25,29,0,0,0,94,20050131
2005,NYK,29,22,18,20,0,0,0,89,LAC,25,20,27,24,0,0,0,96,20050131
2005,MEM,21,22,30,25,0,0,0,98,NOH,27,19,20,25,0,0,0,91,20050131
2005,IND,24,21,23,20,0,0,0,88,PHI,28,24,13,24,0,0,0,89,20050131
2005,SAS,25,23,28,27,0,0,0,103,SEA,22,12,25,25,0,0,0,84,20050131
2005,MIA,26,27,25,26,0,0,0,104,DAL,24,26,37,22,0,0,0,109,20050201
2005,NYK,21,24,12,19,0,0,0,76,DEN,25,32,18,21,0,0,0,96,20050201
2005,POR,29,10,20,20,0,0,0,79,LAL,26,23,20,23,0,0,0,92,20050201
2005,PHO,29,20,25,23,0,0,0,97,MEM,31,14,34,29,0,0,0,108,20050201
2005,MIN,29,27,11,19,0,0,0,86,MIL,21,26,23,21,0,0,0,91,20050201
2005,CHI,25,24,18,30,0,0,0,97,NJN,23,25,32,27,0,0,0,107,20050201
2005,CLE,29,30,24,19,0,0,0,102,ORL,27,31,25,22,0,0,0,105,20050201
2005,SEA,24,26,32,24,0,0,0,106,SAC,26,23,26,26,0,0,0,101,20050201
2005,CHA,24,23,29,33,0,0,0,109,UTA,27,25,35,18,0,0,0,105,20050201
2005,DET,25,27,18,35,0,0,0,105,WAS,25,22,28,21,0,0,0,96,20050201
2005,NJN,23,16,25,25,0,0,0,89,BOS,29,26,32,23,0,0,0,110,20050202
2005,ATL,26,14,17,27,0,0,0,84,DET,23,26,22,28,0,0,0,99,20050202
2005,SAC,28,15,32,21,15,0,0,111,GSW,22,33,23,18,11,0,0,107,20050202
2005,TOR,18,18,30,32,0,0,0,98,IND,32,21,18,26,0,0,0,97,20050202
2005,PHO,31,29,35,13,0,0,0,108,MIN,21,24,15,19,0,0,0,79,20050202
2005,DAL,25,29,23,13,0,0,0,90,NOH,17,23,24,18,0,0,0,82,20050202
2005,HOU,31,32,25,30,0,0,0,118,PHI,33,22,16,24,0,0,0,95,20050202
2005,DEN,22,23,25,24,0,0,0,94,POR,19,30,19,29,0,0,0,97,20050202
2005,SAS,26,17,37,23,0,0,0,103,LAL,23,17,15,36,0,0,0,91,20050203
2005,LAC,28,18,28,32,0,0,0,106,MEM,29,24,29,21,0,0,0,103,20050203
2005,CLE,28,15,26,19,0,0,0,88,MIA,24,26,27,23,0,0,0,100,20050203
2005,ORL,38,29,21,12,0,0,0,100,BOS,39,28,16,29,0,0,0,112,20050204
2005,NOH,13,29,20,20,0,0,0,82,GSW,19,20,22,29,0,0,0,90,20050204
2005,DAL,26,26,18,24,0,0,0,94,IND,32,27,19,17,0,0,0,95,20050204
2005,LAC,26,22,25,17,0,0,0,90,MIL,21,22,28,21,0,0,0,92,20050204
2005,HOU,26,28,29,21,15,0,0,119,MIN,33,25,21,25,9,0,0,113,20050204
2005,ATL,20,24,20,21,0,0,0,85,PHI,26,24,26,27,0,0,0,103,20050204
2005,CHA,22,18,15,34,0,0,0,89,POR,27,20,21,33,0,0,0,101,20050204
2005,NYK,29,32,29,25,0,0,0,115,SAC,28,26,26,36,0,0,0,116,20050204
2005,WAS,36,22,22,20,0,0,0,100,TOR,27,16,26,34,0,0,0,103,20050204
2005,IND,19,22,20,23,0,0,0,84,ATL,18,23,20,18,0,0,0,79,20050205
2005,ORL,25,26,19,22,0,0,0,92,CLE,26,24,27,24,0,0,0,101,20050205
2005,GSW,18,24,25,24,0,0,0,91,DEN,32,32,25,18,0,0,0,107,20050205
2005,CHI,19,17,36,25,0,0,0,97,MIA,25,26,26,31,0,0,0,108,20050205
2005,DET,22,30,11,22,0,0,0,85,NJN,25,29,25,28,0,0,0,107,20050205
2005,NYK,27,26,28,25,0,0,0,106,PHO,30,22,27,35,0,0,0,114,20050205
2005,SAC,17,34,23,34,0,0,0,108,POR,29,30,25,30,0,0,0,114,20050205
2005,CHA,22,24,26,27,0,0,0,99,SEA,34,35,20,24,0,0,0,113,20050205
2005,NOH,22,15,26,29,0,0,0,92,UTA,30,23,30,25,0,0,0,108,20050205
2005,MIL,19,20,31,24,0,0,0,94,WAS,32,32,27,21,0,0,0,112,20050205
2005,LAL,14,25,30,33,0,0,0,102,HOU,24,26,34,19,0,0,0,103,20050206
2005,BOS,22,26,29,26,0,0,0,103,MIN,20,25,31,24,0,0,0,100,20050206
2005,LAC,21,26,32,25,0,0,0,104,PHI,24,24,32,26,0,0,0,106,20050206
2005,DAL,32,33,28,29,0,0,0,122,TOR,24,28,29,32,0,0,0,113,20050206
2005,LAL,15,30,24,39,0,0,0,108,ATL,31,31,17,35,0,0,0,114,20050207
2005,GSW,25,25,22,24,0,0,0,96,MIA,28,23,30,24,0,0,0,105,20050207
2005,PHI,26,21,33,13,4,0,0,97,NJN,25,29,19,20,14,0,0,107,20050207
2005,NYK,24,28,26,13,11,0,0,102,UTA,29,24,16,22,8,0,0,99,20050207
2005,IND,34,19,29,22,0,0,0,104,WAS,27,29,22,30,0,0,0,108,20050207
2005,SAS,29,23,26,26,0,0,0,104,CHA,17,17,21,30,0,0,0,85,20050208
2005,TOR,23,20,19,29,0,0,0,91,CLE,32,25,26,21,0,0,0,104,20050208
2005,CHI,21,27,25,34,0,0,0,107,DAL,23,27,23,27,0,0,0,100,20050208
2005,UTA,14,24,26,23,0,0,0,87,DEN,23,20,29,25,0,0,0,97,20050208
2005,MIN,14,30,21,31,0,0,0,96,MEM,29,34,27,18,0,0,0,108,20050208
2005,BOS,31,15,15,36,0,0,0,97,MIL,36,42,20,23,0,0,0,121,20050208
2005,GSW,29,32,21,31,0,0,0,113,ORL,30,27,22,30,0,0,0,109,20050208
2005,PHO,24,36,30,35,0,0,0,125,SAC,33,31,30,29,0,0,0,123,20050208
2005,NOH,22,21,21,27,0,0,0,91,SEA,26,23,30,29,0,0,0,108,20050208
2005,LAC,31,29,13,16,0,0,0,89,BOS,24,18,23,29,0,0,0,94,20050209
2005,CHI,29,14,22,27,0,0,0,92,HOU,28,23,25,29,0,0,0,105,20050209
2005,CHA,17,19,26,25,0,0,0,87,IND,26,28,18,22,0,0,0,94,20050209
2005,DEN,14,27,27,24,0,0,0,92,MIN,21,24,24,29,0,0,0,98,20050209
2005,LAL,21,22,22,27,12,0,0,104,NJN,20,29,24,19,11,0,0,103,20050209
2005,MIA,32,21,20,22,21,0,0,116,NYK,23,24,20,28,15,0,0,110,20050209
2005,MEM,25,26,22,25,0,0,0,98,PHI,24,29,23,19,0,0,0,95,20050209
2005,NOH,19,26,22,24,0,0,0,91,POR,19,13,28,20,0,0,0,80,20050209
2005,MIL,32,25,24,29,0,0,0,110,TOR,34,27,27,19,0,0,0,107,20050209
2005,SAS,22,18,20,27,0,0,0,87,WAS,15,24,24,32,0,0,0,95,20050209
2005,LAL,14,21,23,23,0,0,0,81,DET,30,21,29,23,0,0,0,103,20050210
2005,ATL,15,29,28,24,0,0,0,96,ORL,31,25,22,23,0,0,0,101,20050210
2005,SAC,28,24,29,26,0,0,0,107,SEA,26,28,23,38,0,0,0,115,20050210
2005,NYK,29,22,11,32,0,0,0,94,BOS,25,32,27,27,0,0,0,111,20050211
2005,MIA,18,20,33,26,0,0,0,97,CHA,19,21,21,26,0,0,0,87,20050211
2005,DEN,30,16,29,31,0,0,0,106,CLE,29,27,20,25,0,0,0,101,20050211
2005,HOU,29,24,27,11,0,0,0,91,IND,28,18,24,13,0,0,0,83,20050211
2005,POR,32,19,18,13,0,0,0,82,MEM,22,27,15,24,0,0,0,88,20050211
2005,SAS,13,19,27,42,0,0,0,101,NJN,22,18,31,20,0,0,0,91,20050211
2005,GSW,36,24,19,29,0,0,0,108,NOH,27,27,27,30,0,0,0,111,20050211
2005,SEA,33,22,27,31,0,0,0,113,PHO,29,26,24,26,0,0,0,105,20050211
2005,DAL,30,31,29,25,0,0,0,115,SAC,30,34,29,20,0,0,0,113,20050211
2005,PHI,28,23,31,24,0,0,0,106,TOR,24,21,25,21,0,0,0,91,20050211
2005,MIN,20,21,19,22,0,0,0,82,UTA,27,10,34,29,0,0,0,100,20050211
2005,LAC,17,18,27,29,0,0,0,91,WAS,22,18,24,30,0,0,0,94,20050211
2005,WAS,21,18,28,19,0,0,0,86,DET,29,27,30,21,0,0,0,107,20050212
2005,ATL,20,15,24,24,0,0,0,83,MIL,28,30,28,27,0,0,0,113,20050212
2005,ORL,22,22,27,28,0,0,0,99,PHI,31,31,23,27,0,0,0,112,20050212
2005,SAC,26,28,23,27,0,0,0,104,BOS,29,25,27,19,0,0,0,100,20050213
2005,LAL,24,19,27,19,0,0,0,89,CLE,25,22,29,27,0,0,0,103,20050213
2005,PHO,31,28,22,13,12,0,0,106,GSW,22,23,25,24,8,0,0,102,20050213
2005,POR,15,13,21,31,0,0,0,80,HOU,23,21,13,24,0,0,0,81,20050213
2005,MEM,16,23,13,21,0,0,0,73,IND,21,23,20,12,0,0,0,76,20050213
2005,SAS,22,20,28,22,0,0,0,92,MIA,19,22,30,25,0,0,0,96,20050213
2005,CHI,28,21,20,18,0,0,0,87,MIN,21,20,22,20,0,0,0,83,20050213
2005,DEN,31,12,16,20,0,0,0,79,NJN,29,22,26,17,0,0,0,94,20050213
2005,CHA,19,26,25,29,0,0,0,99,NYK,21,34,24,23,0,0,0,102,20050213
2005,NOH,26,23,25,20,0,0,0,94,ORL,26,23,32,16,0,0,0,97,20050213
2005,DAL,21,30,15,29,0,0,0,95,SEA,19,23,24,26,0,0,0,92,20050213
2005,LAC,22,27,30,27,0,0,0,106,TOR,33,30,12,34,0,0,0,109,20050213
2005,POR,26,19,18,17,0,0,0,80,CHA,19,22,23,13,0,0,0,77,20050214
2005,MIL,24,17,17,25,0,0,0,83,DET,26,32,27,22,0,0,0,107,20050214
2005,WAS,24,24,24,24,0,0,0,96,NOH,27,24,26,21,0,0,0,98,20050214
2005,NYK,23,25,26,31,0,0,0,105,PHI,23,37,25,21,0,0,0,106,20050214
2005,UTA,38,24,23,43,0,0,0,128,PHO,34,24,40,38,0,0,0,136,20050214
2005,DEN,22,25,25,28,0,0,0,100,ATL,28,31,20,17,0,0,0,96,20050215
2005,SAC,20,24,31,27,0,0,0,102,CHI,25,28,21,33,0,0,0,107,20050215
2005,DAL,34,33,19,28,0,0,0,114,GSW,29,24,35,19,0,0,0,107,20050215
2005,WAS,30,19,28,16,0,0,0,93,HOU,35,27,29,32,0,0,0,123,20050215
2005,UTA,20,28,26,21,0,0,0,95,LAL,18,26,27,31,0,0,0,102,20050215
2005,NJN,21,17,12,21,0,0,0,71,MIN,14,26,24,18,0,0,0,82,20050215
2005,LAC,28,25,18,23,0,0,0,94,ORL,33,21,22,23,0,0,0,99,20050215
2005,MEM,28,15,23,22,0,0,0,88,BOS,29,21,22,18,0,0,0,90,20050216
2005,DEN,23,27,19,19,0,0,0,88,CHA,25,24,33,12,0,0,0,94,20050216
2005,ATL,24,26,18,21,0,0,0,89,CLE,30,25,29,27,0,0,0,111,20050216
2005,POR,18,22,22,25,0,0,0,87,IND,19,24,28,24,0,0,0,95,20050216
2005,LAC,20,25,30,20,0,0,0,95,MIA,28,27,35,23,0,0,0,113,20050216
2005,SAC,25,22,23,15,0,0,0,85,NJN,21,23,26,26,0,0,0,96,20050216
2005,SAS,17,31,20,33,0,0,0,101,NOH,18,22,19,19,0,0,0,78,20050216
2005,MIL,27,23,26,14,0,0,0,90,NYK,26,29,25,28,0,0,0,108,20050216
2005,DET,28,20,20,25,0,0,0,93,PHI,13,22,23,17,0,0,0,75,20050216
2005,GSW,26,26,37,28,0,0,0,117,SEA,31,27,21,31,0,0,0,110,20050216
2005,CHI,37,25,31,28,0,0,0,121,TOR,34,24,32,25,0,0,0,115,20050216
2005,CLE,24,21,20,23,0,0,0,88,MIN,26,25,15,28,0,0,0,94,20050217
2005,DAL,22,23,38,36,0,0,0,119,PHO,22,33,32,26,0,0,0,113,20050217
2005,MIL,26,30,31,25,0,0,0,112,CHA,23,26,37,16,0,0,0,102,20050222
2005,MIA,22,23,28,19,9,0,0,101,CHI,22,21,25,24,13,0,0,105,20050222
2005,NYK,23,19,17,29,0,0,0,88,DET,31,20,20,26,0,0,0,97,20050222
2005,SEA,20,24,17,26,0,0,0,87,HOU,28,23,15,19,0,0,0,85,20050222
2005,BOS,27,24,23,21,0,0,0,95,LAL,22,25,25,32,0,0,0,104,20050222
2005,TOR,19,24,28,29,0,0,0,100,NJN,21,22,21,18,0,0,0,82,20050222
2005,IND,20,32,29,27,0,0,0,108,ORL,18,18,21,27,0,0,0,84,20050222
2005,ATL,19,28,32,25,0,0,0,104,SAC,33,24,29,28,0,0,0,114,20050222
2005,CHI,20,17,25,29,0,0,0,91,CLE,21,22,30,27,0,0,0,100,20050223
2005,BOS,21,23,23,19,0,0,0,86,DEN,29,28,37,13,0,0,0,107,20050223
2005,ATL,27,18,25,26,0,0,0,96,GSW,26,32,23,20,0,0,0,101,20050223
2005,MIA,21,20,22,24,4,0,0,91,IND,27,20,19,21,6,0,0,93,20050223
2005,NJN,28,20,14,19,0,0,0,81,MIL,21,26,30,23,0,0,0,100,20050223
2005,SEA,25,28,26,24,0,0,0,103,NOH,19,16,22,28,0,0,0,85,20050223
2005,LAC,26,23,24,28,0,0,0,101,PHO,29,31,28,30,0,0,0,118,20050223
2005,LAL,27,16,20,23,0,0,0,86,POR,18,21,22,22,0,0,0,83,20050223
2005,HOU,26,19,21,15,0,0,0,81,SAS,21,21,29,28,0,0,0,99,20050223
2005,DAL,30,21,24,26,0,0,0,101,UTA,20,30,19,14,0,0,0,83,20050223
2005,MEM,23,21,17,22,0,0,0,83,WAS,21,21,30,21,0,0,0,93,20050223
2005,SAC,23,32,33,25,0,0,0,113,DAL,27,31,24,40,0,0,0,122,20050224
2005,MIN,16,20,22,28,0,0,0,86,LAC,26,19,19,28,0,0,0,92,20050224
2005,PHI,31,27,21,22,0,0,0,101,NYK,28,27,26,32,0,0,0,113,20050224
2005,WAS,24,17,27,22,0,0,0,90,CHI,22,28,26,21,0,0,0,97,20050225
2005,CLE,27,14,20,21,0,0,0,82,IND,27,31,20,28,0,0,0,106,20050225
2005,DET,28,30,25,28,0,0,0,111,LAL,19,26,23,22,0,0,0,90,20050225
2005,DEN,20,30,12,29,6,0,0,97,MEM,19,21,31,20,3,0,0,94,20050225
2005,TOR,27,27,21,31,0,0,0,106,MIL,24,25,23,30,0,0,0,102,20050225
2005,CHA,17,25,20,24,0,0,0,86,NJN,29,26,12,26,0,0,0,93,20050225
2005,ATL,31,22,24,24,0,0,0,101,POR,29,26,24,23,0,0,0,102,20050225
2005,MIN,21,23,25,19,0,0,0,88,SEA,16,19,29,34,0,0,0,98,20050225
2005,BOS,26,23,29,31,0,0,0,109,UTA,27,28,25,22,0,0,0,102,20050225
2005,CHI,26,25,25,18,0,0,0,94,CHA,27,29,16,18,0,0,0,90,20050226
2005,PHO,38,30,27,29,0,0,0,124,DAL,31,40,26,26,0,0,0,123,20050226
2005,ORL,22,18,31,27,0,0,0,98,MIA,20,26,24,31,0,0,0,101,20050226
2005,IND,24,13,23,19,0,0,0,79,NYK,27,20,24,19,0,0,0,90,20050226
2005,SAC,26,19,29,27,0,0,0,101,PHI,31,19,25,24,0,0,0,99,20050226
2005,MEM,25,22,10,27,0,0,0,84,SAS,21,19,18,24,0,0,0,82,20050226
2005,DET,25,21,32,16,0,0,0,94,GSW,29,16,21,22,0,0,0,88,20050227
2005,UTA,23,19,27,30,0,0,0,99,HOU,25,17,27,23,0,0,0,92,20050227
2005,ATL,28,25,30,21,0,0,0,104,LAC,24,28,26,33,0,0,0,111,20050227
2005,SEA,10,24,18,21,0,0,0,73,MIL,31,18,26,24,0,0,0,99,20050227
2005,CLE,20,26,29,23,0,0,0,98,NJN,30,28,25,21,0,0,0,104,20050227
2005,DEN,25,19,23,27,0,0,0,94,NOH,25,25,24,19,0,0,0,93,20050227
2005,MIA,26,28,23,35,0,0,0,112,ORL,24,14,30,35,0,0,0,103,20050227
2005,BOS,30,32,25,19,14,0,0,120,PHO,33,22,29,22,7,0,0,113,20050227
2005,MIN,24,32,18,17,0,0,0,91,POR,22,26,21,14,0,0,0,83,20050227
2005,LAL,29,26,29,18,0,0,0,102,TOR,28,37,21,22,0,0,0,108,20050227
2005,SAC,32,22,27,29,0,0,0,110,WAS,24,30,31,23,0,0,0,108,20050227
2005,SAS,20,19,25,30,0,0,0,94,CLE,25,15,30,22,0,0,0,92,20050228
2005,NOH,28,15,21,22,0,0,0,86,DAL,25,27,16,22,0,0,0,90,20050228
2005,LAL,23,24,21,39,8,0,0,115,NYK,25,22,36,24,10,0,0,117,20050228
2005,LAC,20,24,23,19,0,0,0,86,UTA,20,23,23,21,0,0,0,87,20050228
2005,SAC,26,19,15,27,0,0,0,87,CHA,27,28,18,21,0,0,0,94,20050301
2005,HOU,36,30,31,22,0,0,0,119,CHI,24,15,26,24,0,0,0,89,20050301
2005,ATL,18,16,16,24,0,0,0,74,DEN,13,20,32,32,0,0,0,97,20050301
2005,SEA,32,21,19,29,0,0,0,101,IND,20,28,25,20,0,0,0,93,20050301
2005,GSW,23,27,25,22,0,0,0,97,MEM,22,31,33,13,0,0,0,99,20050301
2005,PHI,36,29,28,25,0,0,0,118,MIL,33,25,19,34,0,0,0,111,20050301
2005,DET,34,26,23,20,0,0,0,103,POR,26,24,23,20,0,0,0,93,20050301
2005,LAL,30,21,28,22,0,0,0,101,BOS,27,29,21,27,0,0,0,104,20050302
2005,SEA,28,26,24,25,0,0,0,103,CLE,19,26,24,17,0,0,0,86,20050302
2005,DAL,23,23,23,23,0,0,0,92,LAC,31,29,19,22,0,0,0,101,20050302
2005,GSW,20,24,24,31,0,0,0,99,MIN,27,24,22,20,0,0,0,93,20050302
2005,CHA,21,18,29,17,0,0,0,85,NOH,25,21,26,22,0,0,0,94,20050302
2005,SAC,30,28,26,27,0,0,0,111,ORL,31,36,19,28,0,0,0,114,20050302
2005,NJN,15,21,32,31,0,0,0,99,PHI,19,22,23,29,0,0,0,93,20050302
2005,TOR,18,18,20,30,0,0,0,86,SAS,21,21,28,22,0,0,0,92,20050302
2005,ATL,18,23,19,14,0,0,0,74,UTA,28,25,21,22,0,0,0,96,20050302
2005,HOU,17,23,31,27,0,0,0,98,WAS,28,19,26,28,0,0,0,101,20050302
2005,IND,25,18,18,26,0,0,0,87,DEN,28,30,21,17,0,0,0,96,20050303
2005,MIA,15,29,32,30,0,0,0,106,NJN,24,24,17,25,0,0,0,90,20050303
2005,DET,22,25,29,21,0,0,0,97,PHO,24,26,16,34,0,0,0,100,20050303
2005,CHA,23,18,25,18,0,0,0,84,BOS,27,29,27,21,0,0,0,104,20050304
2005,DAL,21,31,29,22,0,0,0,103,LAL,25,27,28,28,0,0,0,108,20050304
2005,TOR,16,24,27,8,0,0,0,75,MEM,25,17,21,23,0,0,0,86,20050304
2005,SAC,21,20,25,17,0,0,0,83,MIA,26,22,30,26,0,0,0,104,20050304
2005,MIL,30,25,25,17,0,0,0,97,MIN,19,31,23,30,0,0,0,103,20050304
2005,UTA,30,12,18,25,0,0,0,85,NOH,28,19,23,22,0,0,0,92,20050304
2005,NYK,25,27,14,23,0,0,0,89,ORL,38,25,25,23,0,0,0,111,20050304
2005,CLE,27,19,19,24,0,0,0,89,PHI,29,18,26,25,0,0,0,98,20050304
2005,IND,24,24,28,30,0,0,0,106,POR,24,30,24,19,0,0,0,97,20050304
2005,CHI,26,20,20,33,0,0,0,99,SAS,20,35,19,28,0,0,0,102,20050304
2005,DET,23,22,22,20,0,0,0,87,SEA,22,20,27,26,0,0,0,95,20050304
2005,GSW,27,26,23,27,0,0,0,103,WAS,19,32,14,25,0,0,0,90,20050304
2005,PHI,27,21,21,29,0,0,0,98,ATL,25,25,24,23,0,0,0,97,20050305
2005,WAS,18,19,24,25,0,0,0,86,CHA,24,20,16,24,0,0,0,84,20050305
2005,DEN,24,35,22,24,0,0,0,105,LAC,20,26,24,19,0,0,0,89,20050305
2005,CHI,21,23,19,24,0,0,0,87,MIL,16,25,29,25,0,0,0,95,20050305
2005,ORL,29,30,26,20,0,0,0,105,NJN,15,22,22,22,0,0,0,81,20050305
2005,POR,24,23,31,38,0,0,0,116,PHO,34,35,33,27,0,0,0,129,20050305
2005,MIN,27,23,22,27,0,0,0,99,BOS,27,23,23,24,0,0,0,97,20050306
2005,MIA,24,31,26,21,0,0,0,102,CLE,25,19,18,20,0,0,0,82,20050306
2005,DAL,18,17,20,14,0,0,0,69,HOU,20,24,17,29,0,0,0,90,20050306
2005,IND,19,18,28,29,0,0,0,94,LAL,23,27,27,26,0,0,0,103,20050306
2005,TOR,24,29,24,18,0,0,0,95,NOH,24,12,19,29,0,0,0,84,20050306
2005,GSW,27,23,27,22,0,0,0,99,NYK,32,28,23,32,0,0,0,115,20050306
2005,DET,16,30,17,22,0,0,0,85,SAC,20,35,19,26,0,0,0,100,20050306
2005,UTA,20,30,22,22,0,0,0,94,SAS,27,27,19,28,0,0,0,101,20050306
2005,PHO,32,28,22,28,0,0,0,110,SEA,28,22,27,22,0,0,0,99,20050306
2005,MIL,22,17,18,28,0,0,0,85,CHI,21,24,20,25,0,0,0,90,20050307
2005,TOR,28,25,23,29,0,0,0,105,DAL,32,25,27,29,0,0,0,113,20050307
2005,POR,26,24,24,24,0,0,0,98,DEN,31,25,34,21,0,0,0,111,20050307
2005,MEM,29,16,33,27,0,0,0,105,LAC,25,25,21,31,0,0,0,102,20050307
2005,PHI,27,23,21,29,0,0,0,100,MIA,31,32,28,17,0,0,0,108,20050307
2005,ORL,22,27,18,25,0,0,0,92,CLE,25,28,31,27,0,0,0,111,20050308
2005,LAC,25,19,33,33,0,0,0,110,LAL,28,24,18,31,0,0,0,101,20050308
2005,ATL,33,18,23,27,0,0,0,101,MIL,22,23,34,26,0,0,0,105,20050308
2005,CHA,27,26,14,30,0,0,0,97,MIN,17,25,31,29,0,0,0,102,20050308
2005,WAS,21,19,23,20,0,0,0,83,NYK,26,22,23,22,0,0,0,93,20050308
2005,GSW,24,29,23,28,0,0,0,104,PHI,23,27,17,18,0,0,0,85,20050308
2005,MEM,21,16,28,17,0,0,0,82,SAC,25,27,22,11,0,0,0,85,20050308
2005,NJN,12,16,30,16,0,0,0,74,SAS,24,23,21,22,0,0,0,90,20050308
2005,HOU,21,29,22,25,0,0,0,97,SEA,33,26,6,30,0,0,0,95,20050308
2005,IND,33,22,14,20,0,0,0,89,UTA,16,26,22,19,0,0,0,83,20050308
2005,ATL,30,22,18,21,0,0,0,91,BOS,20,26,18,31,0,0,0,95,20050309
2005,GSW,19,23,28,18,0,0,0,88,DET,22,22,30,18,0,0,0,92,20050309
2005,NJN,27,18,18,14,9,0,0,86,NOH,13,21,24,19,8,0,0,85,20050309
2005,SAS,24,20,36,21,0,0,0,101,PHO,36,18,29,24,0,0,0,107,20050309
2005,CHI,23,17,26,31,0,0,0,97,POR,25,20,24,15,0,0,0,84,20050309
2005,ORL,24,25,24,23,0,0,0,96,TOR,29,29,22,26,0,0,0,106,20050309
2005,LAL,21,20,29,30,0,0,0,100,DAL,20,25,29,21,0,0,0,95,20050310
2005,MIN,24,22,28,16,0,0,0,90,MIA,24,27,23,33,0,0,0,107,20050310
2005,DET,20,26,22,27,9,9,0,113,BOS,14,32,26,23,9,11,0,115,20050311
2005,GSW,20,20,19,24,0,0,0,83,IND,30,30,24,17,0,0,0,101,20050311
2005,DAL,28,29,31,24,0,0,0,112,MIL,30,29,24,27,0,0,0,110,20050311
2005,MIN,22,27,28,24,0,0,0,101,ORL,19,29,28,20,0,0,0,96,20050311
2005,CHA,20,19,20,21,0,0,0,80,PHI,20,37,34,21,0,0,0,112,20050311
2005,HOU,29,31,26,41,0,0,0,127,PHO,26,34,30,17,0,0,0,107,20050311
2005,LAC,31,22,35,24,0,0,0,112,SAC,24,31,30,28,0,0,0,113,20050311
2005,CHI,21,32,22,25,0,0,0,100,SEA,27,26,16,28,0,0,0,97,20050311
2005,ATL,34,23,20,24,15,0,0,116,TOR,28,29,18,26,11,0,0,112,20050311
2005,MEM,22,23,32,17,0,0,0,94,UTA,20,28,18,16,0,0,0,82,20050311
2005,GSW,28,26,36,15,0,0,0,105,ATL,26,14,25,27,0,0,0,92,20050312
2005,LAL,27,30,24,36,0,0,0,117,CHA,25,34,25,32,0,0,0,116,20050312
2005,NJN,17,22,16,10,0,0,0,65,MIA,22,15,33,20,0,0,0,90,20050312
2005,MIL,22,30,21,34,0,0,0,107,NOH,27,25,33,26,0,0,0,111,20050312
2005,MEM,17,18,13,18,0,0,0,66,POR,11,29,19,21,0,0,0,80,20050312
2005,DEN,25,21,22,22,0,0,0,90,SAS,25,25,18,19,0,0,0,87,20050312
2005,WAS,21,29,27,24,0,0,0,101,BOS,20,33,15,37,0,0,0,105,20050313
2005,IND,26,27,18,15,0,0,0,86,CLE,20,30,26,22,0,0,0,98,20050313
2005,PHO,27,26,29,24,0,0,0,106,DEN,23,29,25,24,0,0,0,101,20050313
2005,UTA,14,15,21,12,0,0,0,62,DET,19,19,20,6,0,0,0,64,20050313
2005,CHI,16,23,28,11,0,0,0,78,LAC,25,26,17,15,0,0,0,83,20050313
2005,DAL,23,21,27,31,0,0,0,102,MIN,27,19,23,24,0,0,0,93,20050313
2005,SEA,28,17,15,30,0,0,0,90,NYK,25,25,15,15,0,0,0,80,20050313
2005,NJN,21,22,34,21,0,0,0,98,ORL,21,20,14,27,0,0,0,82,20050313
2005,HOU,30,36,23,22,0,0,0,111,SAC,24,28,25,19,0,0,0,96,20050313
2005,PHI,31,29,17,33,0,0,0,110,TOR,28,35,36,29,0,0,0,128,20050313
2005,DET,31,24,17,28,14,0,0,114,ATL,23,23,31,23,8,0,0,108,20050314
2005,BOS,41,27,22,29,0,0,0,119,CHA,28,40,21,21,0,0,0,110,20050314
2005,HOU,25,17,34,21,0,0,0,97,GSW,12,23,27,32,0,0,0,94,20050314
2005,POR,24,17,16,26,0,0,0,83,MEM,25,28,22,29,0,0,0,104,20050314
2005,MIL,22,15,19,15,0,0,0,71,MIA,29,31,32,18,0,0,0,110,20050314
2005,NOH,12,24,22,31,0,0,0,89,SAS,25,31,34,22,0,0,0,112,20050314
2005,LAL,22,16,19,24,0,0,0,81,WAS,23,29,21,22,0,0,0,95,20050314
2005,SEA,25,21,28,25,0,0,0,99,CHI,25,32,12,24,0,0,0,93,20050315
2005,UTA,23,9,17,24,0,0,0,73,CLE,26,24,23,19,0,0,0,92,20050315
2005,MIN,27,21,17,35,0,0,0,100,DAL,18,17,25,31,0,0,0,91,20050315
2005,MIA,27,17,24,30,0,0,0,98,NYK,22,28,28,18,0,0,0,96,20050315
2005,LAL,25,17,20,29,0,0,0,91,PHI,27,25,35,21,0,0,0,108,20050315
2005,ORL,19,28,24,23,0,0,0,94,SAC,26,35,16,28,0,0,0,105,20050315
2005,WAS,28,21,31,42,0,0,0,122,ATL,20,24,29,20,0,0,0,93,20050316
2005,TOR,30,24,25,30,0,0,0,109,BOS,29,24,37,20,0,0,0,110,20050316
2005,CHA,17,30,31,23,0,0,0,101,DEN,29,33,32,26,0,0,0,120,20050316
2005,SEA,19,28,25,23,0,0,0,95,DET,27,15,36,24,0,0,0,102,20050316
2005,POR,25,18,21,13,0,0,0,77,HOU,34,23,28,23,0,0,0,108,20050316
2005,UTA,15,22,22,25,0,0,0,84,IND,23,21,31,28,0,0,0,103,20050316
2005,ORL,26,28,17,31,0,0,0,102,LAC,32,26,29,23,0,0,0,110,20050316
2005,CLE,20,23,16,29,0,0,0,88,MIL,29,19,25,23,0,0,0,96,20050316
2005,CHI,11,24,26,23,0,0,0,84,NJN,28,22,22,28,0,0,0,100,20050316
2005,MEM,25,22,20,21,0,0,0,88,NOH,19,18,28,17,0,0,0,82,20050316
2005,MIN,18,21,18,16,0,0,0,73,SAS,32,19,22,16,0,0,0,89,20050316
2005,POR,22,24,21,27,0,0,0,94,DAL,13,31,22,32,0,0,0,98,20050317
2005,SAC,23,25,31,18,0,0,0,97,GSW,34,23,23,20,0,0,0,100,20050317
2005,LAL,20,25,22,22,0,0,0,89,MIA,25,22,22,33,0,0,0,102,20050317
2005,NYK,25,28,28,25,0,0,0,106,ATL,17,26,35,14,0,0,0,92,20050318
2005,NOH,24,28,16,26,0,0,0,94,CHI,30,16,23,21,0,0,0,90,20050318
2005,PHI,20,35,17,21,0,0,0,93,CLE,18,24,25,14,0,0,0,81,20050318
2005,LAC,22,28,18,28,0,0,0,96,DEN,28,32,21,34,0,0,0,115,20050318
2005,TOR,23,23,21,25,0,0,0,92,DET,34,20,27,22,0,0,0,103,20050318
2005,BOS,28,28,21,26,0,0,0,103,HOU,22,20,19,31,0,0,0,92,20050318
2005,LAL,22,24,23,28,0,0,0,97,IND,30,20,28,25,0,0,0,103,20050318
2005,MIN,19,16,22,26,0,0,0,83,MEM,12,29,17,30,0,0,0,88,20050318
2005,WAS,26,17,26,21,0,0,0,90,MIL,23,33,23,20,0,0,0,99,20050318
2005,UTA,16,24,12,28,0,0,0,80,NJN,22,21,27,24,0,0,0,94,20050318
2005,GSW,31,23,28,28,0,0,0,110,PHO,26,27,30,17,0,0,0,100,20050318
2005,CHA,20,22,12,22,0,0,0,76,SAS,24,28,20,21,0,0,0,93,20050318
2005,ORL,22,24,25,19,0,0,0,90,SEA,21,27,25,25,0,0,0,98,20050318
2005,CHA,28,22,23,20,0,0,0,93,DAL,26,35,18,25,0,0,0,104,20050319
2005,SAC,19,28,19,35,10,0,0,111,LAC,24,21,30,26,6,0,0,107,20050319
2005,NYK,21,13,29,19,0,0,0,82,MIA,25,26,22,24,0,0,0,97,20050319
2005,BOS,26,37,31,19,0,0,0,113,NOH,33,24,17,26,0,0,0,100,20050319
2005,CHI,27,20,20,27,0,0,0,94,PHI,25,30,16,17,0,0,0,88,20050319
2005,ORL,24,26,23,24,0,0,0,97,POR,24,28,18,22,0,0,0,92,20050319
2005,UTA,22,26,22,25,0,0,0,95,WAS,23,17,28,28,0,0,0,96,20050319
2005,MIL,26,27,27,23,0,0,0,103,DEN,33,29,27,25,0,0,0,114,20050320
2005,SAS,31,21,24,25,0,0,0,101,DET,31,31,19,29,0,0,0,110,20050320
2005,NJN,16,24,31,23,0,0,0,94,IND,14,20,25,26,0,0,0,85,20050320
2005,SEA,27,19,25,31,0,0,0,102,LAL,23,18,22,37,0,0,0,100,20050320
2005,PHO,26,25,28,18,0,0,0,97,MEM,24,25,24,18,0,0,0,91,20050320
2005,HOU,16,28,18,24,0,0,0,86,MIN,25,32,25,12,0,0,0,94,20050320
2005,GSW,25,26,29,24,0,0,0,104,SAC,27,24,21,22,0,0,0,94,20050320
2005,CLE,27,26,21,24,0,0,0,98,TOR,30,25,20,30,0,0,0,105,20050320
2005,ORL,31,24,18,24,0,0,0,97,CHA,24,20,28,30,0,0,0,102,20050321
2005,ATL,21,23,28,19,0,0,0,91,CHI,27,28,28,22,0,0,0,105,20050321
2005,NOH,20,15,26,25,0,0,0,86,DAL,20,36,27,20,0,0,0,103,20050321
2005,POR,21,25,20,23,0,0,0,89,LAC,28,24,25,19,0,0,0,96,20050321
2005,SAS,21,26,13,15,0,0,0,75,NYK,21,22,21,24,0,0,0,88,20050321
2005,PHO,25,27,24,29,0,0,0,105,ATL,25,21,28,20,0,0,0,94,20050322
2005,DET,22,25,12,17,0,0,0,76,CLE,23,22,20,26,0,0,0,91,20050322
2005,WAS,25,22,29,22,0,0,0,98,DEN,28,30,34,35,0,0,0,127,20050322
2005,MIA,16,25,14,27,0,0,0,82,HOU,20,16,25,23,0,0,0,84,20050322
2005,IND,34,19,17,21,0,0,0,91,NJN,26,19,23,30,0,0,0,98,20050322
2005,POR,19,30,21,23,0,0,0,93,SAC,30,27,29,26,0,0,0,112,20050322
2005,MIL,25,18,20,21,0,0,0,84,SEA,27,23,18,24,0,0,0,92,20050322
2005,LAL,24,31,33,19,0,0,0,107,UTA,27,28,27,33,0,0,0,115,20050322
2005,PHO,29,41,21,29,0,0,0,120,CHA,14,33,29,29,0,0,0,105,20050323
2005,DAL,28,29,26,26,0,0,0,109,GSW,31,23,16,27,0,0,0,97,20050323
2005,SAS,25,19,23,26,0,0,0,93,IND,31,18,31,20,0,0,0,100,20050323
2005,MIL,17,32,25,34,0,0,0,108,LAC,34,32,27,23,0,0,0,116,20050323
2005,NOH,16,30,28,28,0,0,0,102,MIN,33,28,19,27,0,0,0,107,20050323
2005,BOS,22,22,18,20,0,0,0,82,NYK,31,25,23,28,0,0,0,107,20050323
2005,DET,17,21,22,24,0,0,0,84,PHI,31,29,24,23,0,0,0,107,20050323
2005,CHI,20,40,22,12,0,0,0,94,TOR,21,20,21,23,0,0,0,85,20050323
2005,LAL,30,19,24,23,0,0,0,96,DEN,27,27,32,31,0,0,0,117,20050324
2005,CLE,28,11,22,19,0,0,0,80,HOU,28,20,21,30,0,0,0,99,20050324
2005,MEM,26,27,21,31,0,0,0,105,NJN,24,31,18,23,0,0,0,96,20050324
2005,CHA,29,24,22,33,0,0,0,108,ORL,27,24,22,21,0,0,0,94,20050324
2005,SEA,18,22,32,24,0,0,0,96,POR,23,25,16,27,0,0,0,91,20050324
2005,DAL,18,40,18,25,0,0,0,101,SAC,28,23,24,34,0,0,0,109,20050324
2005,WAS,21,25,20,19,0,0,0,85,UTA,16,24,26,18,0,0,0,84,20050324
2005,CHI,26,21,19,28,0,0,0,94,BOS,29,23,20,14,0,0,0,86,20050325
2005,IND,19,24,25,26,0,0,0,94,DET,20,17,24,20,0,0,0,81,20050325
2005,MIL,27,19,32,27,12,0,0,117,GSW,20,27,34,24,13,0,0,118,20050325
2005,WAS,18,21,18,37,0,0,0,94,LAC,28,24,19,27,0,0,0,98,20050325
2005,PHO,21,33,28,33,0,0,0,115,MIA,34,26,34,31,0,0,0,125,20050325
2005,HOU,22,16,26,17,0,0,0,81,NOH,17,21,18,12,0,0,0,68,20050325
2005,TOR,32,29,21,19,0,0,0,101,PHI,34,27,24,18,0,0,0,103,20050325
2005,ATL,19,20,34,22,0,0,0,95,SAS,33,26,27,25,0,0,0,111,20050325
2005,NYK,19,23,27,26,6,0,0,101,SEA,23,15,28,29,14,0,0,109,20050325
2005,TOR,23,30,25,31,0,0,0,109,ATL,26,33,20,25,0,0,0,104,20050326
2005,MIA,26,13,31,22,0,0,0,92,CHA,23,27,20,24,0,0,0,94,20050326
2005,IND,23,22,23,28,0,0,0,96,CHI,33,22,20,25,0,0,0,100,20050326
2005,CLE,29,21,16,20,0,0,0,86,DAL,29,37,23,28,0,0,0,117,20050326
2005,SAC,28,28,22,21,0,0,0,99,DEN,29,20,33,31,0,0,0,113,20050326
2005,BOS,23,25,25,15,11,0,0,99,DET,28,22,18,20,17,0,0,105,20050326
2005,NOH,21,28,29,18,0,0,0,96,MEM,18,18,26,23,0,0,0,85,20050326
2005,MIN,20,28,23,25,0,0,0,96,NJN,18,17,24,16,0,0,0,75,20050326
2005,PHO,31,26,36,25,0,0,0,118,ORL,31,30,24,31,0,0,0,116,20050326
2005,NYK,22,20,33,21,0,0,0,96,POR,26,26,28,23,0,0,0,103,20050326
2005,MIL,20,27,24,18,0,0,0,89,UTA,23,18,29,24,0,0,0,94,20050326
2005,PHI,18,25,21,32,0,0,0,96,LAL,20,20,23,26,0,0,0,89,20050327
2005,LAC,20,16,28,21,0,0,0,85,MIN,18,27,20,24,0,0,0,89,20050327
2005,HOU,17,19,20,14,0,0,0,70,SAS,24,15,16,28,0,0,0,83,20050327
2005,WAS,29,27,19,20,0,0,0,95,SEA,31,19,17,27,0,0,0,94,20050327
2005,NJN,19,21,29,26,0,0,0,95,CHA,19,25,24,23,0,0,0,91,20050328
2005,MEM,23,19,19,25,0,0,0,86,CHI,26,25,24,19,0,0,0,94,20050328
2005,DAL,30,12,28,25,0,0,0,95,DET,19,14,32,23,0,0,0,88,20050328
2005,NYK,27,17,23,33,0,0,0,100,GSW,23,21,32,32,0,0,0,108,20050328
2005,IND,27,18,29,16,0,0,0,90,MIL,19,15,16,26,0,0,0,76,20050328
2005,CLE,24,18,21,38,8,0,0,109,NOH,28,25,25,23,7,0,0,108,20050328
2005,ATL,15,33,19,35,0,0,0,102,ORL,32,30,23,24,0,0,0,109,20050328
2005,DEN,23,32,33,26,0,0,0,114,PHO,24,32,33,34,0,0,0,123,20050328
2005,WAS,24,27,29,34,0,0,0,114,POR,28,16,25,37,0,0,0,106,20050328
2005,PHI,25,29,26,29,0,0,0,109,SAC,31,27,24,36,0,0,0,118,20050328
2005,HOU,24,32,20,23,0,0,0,99,UTA,22,20,26,17,0,0,0,85,20050328
2005,LAC,18,21,19,26,0,0,0,84,CLE,27,23,20,24,0,0,0,94,20050329
2005,NYK,26,20,33,28,0,0,0,107,LAL,26,25,35,31,0,0,0,117,20050329
2005,SEA,19,25,28,30,0,0,0,102,MEM,21,29,28,21,0,0,0,99,20050329
2005,TOR,29,22,25,15,0,0,0,91,MIA,25,26,28,24,0,0,0,103,20050329
2005,DAL,18,28,31,35,0,0,0,112,BOS,13,30,31,26,0,0,0,100,20050330
2005,CHI,23,24,22,33,0,0,0,102,CHA,25,22,28,24,0,0,0,99,20050330
2005,SAC,11,31,18,22,0,0,0,82,DET,25,21,29,24,0,0,0,99,20050330
2005,GSW,24,36,24,29,0,0,0,113,MIL,32,20,29,28,0,0,0,109,20050330
2005,LAC,25,13,25,15,0,0,0,78,NJN,28,24,31,12,0,0,0,95,20050330
2005,TOR,21,24,24,27,0,0,0,96,ORL,21,34,30,23,0,0,0,108,20050330
2005,PHI,24,17,29,17,0,0,0,87,PHO,29,36,27,24,0,0,0,116,20050330
2005,HOU,31,26,26,17,0,0,0,100,POR,26,21,17,20,0,0,0,84,20050330
2005,SEA,18,17,13,28,0,0,0,76,SAS,31,20,17,21,0,0,0,89,20050330
2005,DEN,33,16,27,33,0,0,0,109,UTA,27,19,30,22,0,0,0,98,20050330
2005,ATL,19,27,25,28,0,0,0,99,WAS,26,25,26,25,0,0,0,102,20050330
2005,CLE,23,25,13,27,2,0,0,90,CHI,22,24,21,21,14,0,0,102,20050331
2005,MIA,29,18,28,19,14,0,0,108,IND,23,23,30,18,20,0,0,114,20050331
2005,MIN,23,19,35,28,0,0,0,105,LAL,19,19,26,32,0,0,0,96,20050331
2005,BOS,32,36,22,26,0,0,0,116,ATL,18,28,31,23,0,0,0,100,20050401
2005,TOR,31,30,27,31,0,0,0,119,CHA,18,34,28,27,0,0,0,107,20050401
2005,SAC,32,41,31,24,0,0,0,128,CLE,33,19,30,27,0,0,0,109,20050401
2005,SAS,14,24,24,22,0,0,0,84,DEN,27,23,23,29,0,0,0,102,20050401
2005,LAC,19,23,23,19,0,0,0,84,DET,23,22,29,23,0,0,0,97,20050401
2005,NOH,11,17,20,28,0,0,0,76,HOU,17,16,23,17,0,0,0,73,20050401
2005,MEM,24,28,13,28,0,0,0,93,MIL,20,30,14,18,0,0,0,82,20050401
2005,NJN,18,25,22,28,0,0,0,93,NYK,23,19,24,25,0,0,0,91,20050401
2005,WAS,29,26,38,18,0,0,0,111,ORL,23,18,28,33,0,0,0,102,20050401
2005,DAL,24,31,24,21,0,0,0,100,PHI,19,22,16,26,0,0,0,83,20050401
2005,MIN,23,26,20,29,0,0,0,98,PHO,30,16,28,33,0,0,0,107,20050401
2005,POR,28,22,15,22,0,0,0,87,SEA,26,20,24,19,0,0,0,89,20050401
2005,GSW,25,27,26,30,0,0,0,108,UTA,29,14,18,30,0,0,0,91,20050401
2005,CHA,24,28,24,21,0,0,0,97,CHI,24,33,27,28,0,0,0,112,20050402
2005,ORL,25,25,22,31,0,0,0,103,NJN,25,27,25,25,0,0,0,102,20050402
2005,MIA,29,25,27,30,0,0,0,111,NOH,24,20,19,36,0,0,0,99,20050402
2005,DEN,26,36,17,24,0,0,0,103,POR,31,23,26,17,0,0,0,97,20050402
2005,LAL,23,25,28,18,0,0,0,94,SAS,26,20,29,20,0,0,0,95,20050402
2005,LAC,30,24,34,23,0,0,0,111,ATL,22,22,23,24,0,0,0,91,20050403
2005,PHI,38,17,18,24,0,0,0,97,BOS,13,32,25,23,0,0,0,93,20050403
2005,DAL,14,16,29,21,0,0,0,80,CLE,31,11,18,40,0,0,0,100,20050403
2005,SEA,22,19,26,25,0,0,0,92,GSW,27,23,26,25,0,0,0,101,20050403
2005,PHO,31,10,28,22,0,0,0,91,HOU,25,17,20,16,0,0,0,78,20050403
2005,LAL,14,18,32,18,0,0,0,82,MEM,32,23,24,23,0,0,0,102,20050403
2005,NYK,30,24,19,29,0,0,0,102,MIL,30,24,28,24,0,0,0,106,20050403
2005,MIN,20,27,38,27,0,0,0,112,SAC,25,21,24,30,0,0,0,100,20050403
2005,DET,32,27,28,26,0,0,0,113,TOR,25,26,32,20,0,0,0,103,20050403
2005,IND,16,13,24,26,0,0,0,79,WAS,11,18,30,17,0,0,0,76,20050403
2005,NOH,16,22,29,29,0,0,0,96,ATL,22,16,28,20,0,0,0,86,20050405
2005,LAC,22,32,20,30,0,0,0,104,CHA,28,24,26,24,0,0,0,102,20050405
2005,NJN,26,32,30,23,0,0,0,111,CLE,23,17,26,14,0,0,0,80,20050405
2005,ORL,23,21,39,22,0,0,0,105,DAL,30,27,39,18,0,0,0,114,20050405
2005,HOU,18,32,34,33,0,0,0,117,GSW,26,27,36,33,0,0,0,122,20050405
2005,DEN,28,18,24,24,0,0,0,94,MEM,24,27,25,15,0,0,0,91,20050405
2005,CHI,24,20,25,17,0,0,0,86,MIA,38,26,19,21,0,0,0,104,20050405
2005,IND,28,28,23,18,0,0,0,97,NYK,28,22,16,13,0,0,0,79,20050405
2005,LAL,25,34,26,14,0,0,0,99,PHO,31,39,32,23,0,0,0,125,20050405
2005,SEA,24,33,24,20,0,0,0,101,SAC,27,38,32,25,0,0,0,122,20050405
2005,POR,21,19,10,29,0,0,0,79,UTA,16,30,21,23,0,0,0,90,20050405
2005,BOS,33,27,27,29,0,0,0,116,WAS,19,32,27,30,0,0,0,108,20050405
2005,MIL,21,26,26,24,0,0,0,97,BOS,26,21,23,33,0,0,0,103,20050406
2005,WAS,22,22,22,27,0,0,0,93,DET,29,30,15,31,0,0,0,105,20050406
2005,CLE,22,10,25,20,0,0,0,77,IND,26,23,28,21,0,0,0,98,20050406
2005,UTA,8,25,23,30,0,0,0,86,MIN,31,24,36,20,0,0,0,111,20050406
2005,DEN,24,26,24,20,0,0,0,94,NOH,20,17,18,28,0,0,0,83,20050406
2005,CHI,16,33,21,25,7,0,0,102,ORL,29,20,22,24,6,0,0,101,20050406
2005,CHA,23,24,32,24,0,0,0,103,PHI,36,30,20,20,0,0,0,106,20050406
2005,GSW,33,31,24,16,0,0,0,104,POR,28,26,28,20,0,0,0,102,20050406
2005,LAC,16,17,24,25,0,0,0,82,SAS,18,24,30,19,0,0,0,91,20050406
2005,MEM,32,28,27,17,0,0,0,104,TOR,19,13,22,20,0,0,0,74,20050406
2005,SAS,20,14,13,21,0,0,0,68,DAL,26,19,31,28,0,0,0,104,20050407
2005,HOU,33,27,28,26,0,0,0,114,LAL,26,25,25,24,0,0,0,100,20050407
2005,NYK,17,20,33,28,0,0,0,98,NJN,25,32,30,23,0,0,0,110,20050407
2005,PHO,37,31,22,29,0,0,0,119,GSW,36,22,32,37,0,0,0,127,20050408
2005,WAS,21,23,15,24,0,0,0,83,IND,29,15,23,26,0,0,0,93,20050408
2005,MIA,14,21,23,23,0,0,0,81,MEM,32,28,17,20,0,0,0,97,20050408
2005,CHA,18,15,24,18,0,0,0,75,MIL,17,32,16,28,0,0,0,93,20050408
2005,DEN,25,29,27,26,0,0,0,107,MIN,27,24,22,31,0,0,0,104,20050408
2005,UTA,27,20,25,26,0,0,0,98,NOH,23,16,24,24,0,0,0,87,20050408
2005,CHI,25,29,22,26,0,0,0,102,NYK,31,24,22,17,0,0,0,94,20050408
2005,DET,29,22,33,30,0,0,0,114,ORL,23,22,22,35,0,0,0,102,20050408
2005,CLE,22,26,25,25,0,0,0,98,PHI,27,23,33,20,0,0,0,103,20050408
2005,SAC,25,29,32,33,0,0,0,119,POR,35,28,18,34,0,0,0,115,20050408
2005,LAL,27,29,27,34,0,0,0,117,SEA,26,16,20,32,0,0,0,94,20050408
2005,ATL,31,16,26,23,5,0,0,101,TOR,14,19,36,27,13,0,0,109,20050408
2005,MIN,30,22,24,22,0,0,0,98,ATL,23,28,25,29,0,0,0,105,20050409
2005,TOR,26,24,27,20,0,0,0,97,CHI,35,27,23,25,0,0,0,110,20050409
2005,MIL,24,15,28,14,0,0,0,81,CLE,31,31,19,17,0,0,0,98,20050409
2005,UTA,23,17,13,28,0,0,0,81,DAL,23,25,20,20,0,0,0,88,20050409
2005,SEA,25,29,34,17,0,0,0,105,DEN,41,27,29,24,0,0,0,121,20050409
2005,SAS,20,26,31,28,11,9,0,125,LAC,30,23,25,27,11,8,0,124,20050409
2005,BOS,19,25,19,23,0,0,0,86,NJN,37,18,30,14,0,0,0,99,20050409
2005,HOU,25,20,33,20,0,0,0,98,PHO,31,16,17,33,0,0,0,97,20050409
2005,PHI,35,29,16,32,0,0,0,112,WAS,21,31,33,21,0,0,0,106,20050409
2005,SAS,29,20,33,35,13,6,0,136,GSW,25,28,37,27,13,4,0,134,20050410
2005,NYK,31,20,30,23,9,0,0,113,IND,23,25,26,30,8,0,0,112,20050410
2005,CHA,26,20,22,27,0,0,0,95,MEM,24,28,26,24,0,0,0,102,20050410
2005,DET,17,25,22,16,0,0,0,80,MIA,20,10,19,23,0,0,0,72,20050410
2005,POR,25,25,20,20,0,0,0,90,NOH,25,19,16,21,0,0,0,81,20050410
2005,LAL,28,18,35,24,0,0,0,105,SAC,28,28,43,25,0,0,0,124,20050410
2005,CHA,25,32,23,21,9,0,0,110,ATL,38,19,22,22,4,0,0,105,20050411
2005,DET,22,19,17,15,12,0,0,85,CHI,20,21,11,21,11,0,0,84,20050411
2005,MEM,23,21,27,18,0,0,0,89,DAL,22,29,28,31,0,0,0,110,20050411
2005,GSW,29,35,22,20,0,0,0,106,DEN,36,32,30,24,0,0,0,122,20050411
2005,PHO,31,21,25,31,0,0,0,108,LAL,29,25,21,22,0,0,0,97,20050411
2005,CLE,26,33,20,35,0,0,0,114,ORL,32,22,22,30,0,0,0,106,20050411
2005,HOU,14,23,34,19,0,0,0,90,SEA,13,24,26,15,0,0,0,78,20050411
2005,IND,18,29,22,25,0,0,0,94,TOR,23,24,26,17,0,0,0,90,20050411
2005,MIL,26,23,24,39,0,0,0,112,WAS,31,29,22,37,0,0,0,119,20050411
2005,UTA,15,18,19,33,0,0,0,85,LAC,27,18,25,24,0,0,0,94,20050412
2005,TOR,20,18,32,35,0,0,0,105,NYK,22,32,14,25,0,0,0,93,20050412
2005,BOS,23,27,28,27,0,0,0,105,PHI,30,24,24,20,0,0,0,98,20050412
2005,NOH,22,26,25,12,0,0,0,85,PHO,25,29,19,26,0,0,0,99,20050412
2005,POR,15,15,32,27,0,0,0,89,SAS,23,25,24,23,0,0,0,95,20050412
2005,ATL,18,22,19,25,0,0,0,84,CHA,32,33,24,16,0,0,0,105,20050413
2005,NOH,23,19,35,25,0,0,0,102,DEN,36,31,24,25,0,0,0,116,20050413
2005,ORL,17,21,24,32,0,0,0,94,DET,31,25,22,25,0,0,0,103,20050413
2005,MEM,26,16,24,26,0,0,0,92,HOU,24,28,17,31,0,0,0,100,20050413
2005,NJN,30,19,18,19,0,0,0,86,IND,18,20,31,21,0,0,0,90,20050413
2005,BOS,30,21,29,31,0,0,0,111,MIL,26,26,32,24,0,0,0,108,20050413
2005,GSW,24,24,29,23,0,0,0,100,MIN,30,26,30,30,0,0,0,116,20050413
2005,DAL,25,21,26,23,0,0,0,95,SEA,17,28,25,20,0,0,0,90,20050413
2005,SAS,17,16,32,26,0,0,0,91,UTA,31,12,25,25,0,0,0,93,20050413
2005,CHI,12,23,21,26,0,0,0,82,WAS,28,20,29,16,0,0,0,93,20050413
2005,NYK,29,24,17,25,0,0,0,95,CLE,28,17,27,17,0,0,0,89,20050414
2005,MIA,26,35,20,23,15,0,0,119,PHI,27,25,25,27,22,0,0,126,20050414
2005,DAL,34,27,24,17,0,0,0,102,POR,20,26,25,19,0,0,0,90,20050414
2005,MIA,21,25,35,18,0,0,0,99,BOS,34,20,25,22,0,0,0,101,20050415
2005,ORL,18,23,22,14,0,0,0,77,CHI,29,31,25,32,0,0,0,117,20050415
2005,MEM,16,32,26,28,0,0,0,102,DEN,34,33,15,29,0,0,0,111,20050415
2005,MIL,20,19,24,10,0,0,0,73,DET,20,26,26,27,0,0,0,99,20050415
2005,POR,32,23,15,18,0,0,0,88,GSW,37,28,22,21,0,0,0,108,20050415
2005,PHI,24,22,20,24,0,0,0,90,IND,26,21,22,17,0,0,0,86,20050415
2005,SAC,34,33,27,21,0,0,0,115,LAL,29,23,30,24,0,0,0,106,20050415
2005,LAC,33,24,22,12,0,0,0,91,PHO,25,31,22,20,0,0,0,98,20050415
2005,NOH,23,16,17,16,0,0,0,72,SEA,25,28,20,24,0,0,0,97,20050415
2005,NJN,19,22,32,28,0,0,0,101,TOR,29,26,19,16,0,0,0,90,20050415
2005,MIN,22,26,22,30,0,0,0,100,UTA,27,17,21,19,0,0,0,84,20050415
2005,CLE,23,28,32,28,0,0,0,111,WAS,30,26,29,34,0,0,0,119,20050415
2005,CHI,22,26,36,30,0,0,0,114,ATL,29,34,19,23,0,0,0,105,20050416
2005,NYK,27,31,21,21,0,0,0,100,CHA,25,24,20,29,0,0,0,98,20050416
2005,DEN,34,15,21,17,0,0,0,87,HOU,24,32,24,35,0,0,0,115,20050416
2005,NOH,18,23,28,20,0,0,0,89,LAC,26,25,23,20,0,0,0,94,20050416
2005,ORL,23,20,26,34,0,0,0,103,MIL,25,30,33,25,0,0,0,113,20050416
2005,SAC,26,26,21,25,0,0,0,98,PHO,32,30,37,17,0,0,0,116,20050416
2005,MEM,15,20,20,20,0,0,0,75,SAS,21,27,25,24,0,0,0,97,20050416
2005,CLE,23,29,13,22,0,0,0,87,DET,23,17,25,25,0,0,0,90,20050417
2005,DAL,34,22,29,29,0,0,0,114,LAL,29,20,21,42,0,0,0,112,20050417
2005,IND,15,22,25,18,0,0,0,80,MIA,24,23,17,20,0,0,0,84,20050417
2005,SEA,27,28,32,22,0,0,0,109,MIN,24,26,20,24,0,0,0,94,20050417
2005,PHI,25,22,18,18,0,0,0,83,NJN,38,27,18,21,0,0,0,104,20050417
2005,ATL,29,33,24,32,21,0,0,139,NYK,32,28,31,27,17,0,0,135,20050417
2005,UTA,25,14,15,28,0,0,0,82,POR,28,26,24,22,0,0,0,100,20050417
2005,BOS,26,23,33,21,0,0,0,103,TOR,32,18,23,25,0,0,0,98,20050417
2005,CHA,24,33,18,29,0,0,0,104,WAS,29,22,22,33,0,0,0,106,20050417
2005,LAL,26,25,26,22,0,0,0,99,GSW,33,29,36,28,0,0,0,126,20050418
2005,LAC,31,18,26,15,0,0,0,90,HOU,40,30,22,23,0,0,0,115,20050418
2005,SAS,21,16,24,31,0,0,0,92,MEM,23,24,18,29,0,0,0,94,20050418
2005,MIN,24,24,28,26,0,0,0,102,NOH,26,20,26,27,0,0,0,99,20050418
2005,IND,24,20,27,17,0,0,0,88,ORL,28,23,24,17,0,0,0,92,20050418
2005,MIL,29,21,25,31,0,0,0,106,PHI,36,34,24,28,0,0,0,122,20050418
2005,DEN,25,32,31,26,0,0,0,114,PHO,44,31,31,22,0,0,0,128,20050418
2005,SAC,21,21,20,20,0,0,0,82,UTA,26,19,26,21,0,0,0,92,20050418
2005,DET,25,20,31,19,0,0,0,95,ATL,9,23,16,20,0,0,0,68,20050419
2005,NYK,19,24,25,23,0,0,0,91,CHI,17,19,33,23,0,0,0,92,20050419
2005,BOS,25,22,24,15,0,0,0,86,CLE,23,35,19,23,0,0,0,100,20050419
2005,SEA,14,18,38,26,0,0,0,96,DAL,23,28,23,27,0,0,0,101,20050419
2005,POR,28,42,18,27,0,0,0,115,DEN,22,34,34,29,0,0,0,119,20050419
2005,CHA,25,21,19,15,0,0,0,80,MIA,30,27,20,22,0,0,0,99,20050419
2005,TOR,33,27,33,34,0,0,0,127,MIL,29,30,30,20,0,0,0,109,20050419
2005,WAS,13,27,31,30,0,0,0,101,NJN,32,29,32,16,0,0,0,109,20050419
2005,NJN,20,27,32,23,0,0,0,102,BOS,24,34,8,27,0,0,0,93,20050420
2005,DET,25,24,21,16,0,0,0,86,CHA,24,33,23,17,0,0,0,97,20050420
2005,UTA,21,13,27,28,0,0,0,89,GSW,32,24,24,26,0,0,0,106,20050420
2005,SEA,24,14,19,21,0,0,0,78,HOU,28,28,34,16,0,0,0,106,20050420
2005,CHI,28,20,16,19,0,0,0,83,IND,16,22,22,25,0,0,0,85,20050420
2005,DAL,29,26,31,22,0,0,0,108,MEM,16,25,30,17,0,0,0,88,20050420
2005,SAS,15,21,21,16,0,0,0,73,MIN,19,25,31,20,0,0,0,95,20050420
2005,LAC,31,15,23,17,0,0,0,86,NOH,20,18,17,20,0,0,0,75,20050420
2005,WAS,36,22,30,17,0,0,0,105,NYK,28,26,31,28,0,0,0,113,20050420
2005,MIA,28,22,25,23,0,0,0,98,ORL,28,29,21,15,0,0,0,93,20050420
2005,ATL,19,19,29,19,0,0,0,86,PHI,37,30,23,20,0,0,0,110,20050420
2005,LAL,20,29,32,22,0,0,0,103,POR,28,31,20,27,0,0,0,106,20050420
2005,PHO,28,30,29,20,0,0,0,107,SAC,36,36,28,32,0,0,0,132,20050420
2005,CLE,26,36,29,13,0,0,0,104,TOR,22,25,21,27,0,0,0,95,20050420
2005,IND,20,11,25,26,0,0,0,82,BOS,18,39,29,16,0,0,0,102,20050423
2005,HOU,26,26,18,28,0,0,0,98,DAL,16,24,23,23,0,0,0,86,20050423
2005,PHI,28,18,24,15,0,0,0,85,DET,16,32,32,26,0,0,0,106,20050423
2005,SAC,22,18,24,18,0,0,0,82,SEA,30,25,15,17,0,0,0,87,20050423
2005,WAS,26,26,30,12,0,0,0,94,CHI,24,29,24,26,0,0,0,103,20050424
2005,NJN,19,23,31,25,0,0,0,98,MIA,22,32,33,29,0,0,0,116,20050424
2005,MEM,28,22,28,25,0,0,0,103,PHO,39,20,28,27,0,0,0,114,20050424
2005,DEN,23,29,21,20,0,0,0,93,SAS,27,25,23,12,0,0,0,87,20050424
2005,IND,30,17,17,18,0,0,0,82,BOS,22,20,27,10,0,0,0,79,20050425
2005,HOU,34,26,24,29,0,0,0,113,DAL,30,26,32,23,0,0,0,111,20050425
2005,PHI,23,13,21,27,0,0,0,84,DET,20,22,27,30,0,0,0,99,20050426
2005,NJN,16,23,20,28,0,0,0,87,MIA,26,22,28,28,0,0,0,104,20050426
2005,SAC,22,22,18,31,0,0,0,93,SEA,26,29,33,17,0,0,0,105,20050426
2005,WAS,29,21,20,33,0,0,0,103,CHI,19,38,24,32,0,0,0,113,20050427
2005,MEM,31,23,23,26,0,0,0,103,PHO,29,31,22,26,0,0,0,108,20050427
2005,DEN,18,14,30,14,0,0,0,76,SAS,29,34,23,18,0,0,0,104,20050427
2005,DAL,32,22,24,28,0,0,0,106,HOU,27,22,34,19,0,0,0,102,20050428
2005,BOS,19,19,21,17,0,0,0,76,IND,24,31,16,28,0,0,0,99,20050428
2005,MIA,17,32,25,16,9,9,0,108,NJN,24,21,24,21,9,6,0,105,20050428
2005,PHO,31,26,26,27,0,0,0,110,MEM,30,17,20,23,0,0,0,90,20050429
2005,DET,32,22,24,26,0,0,0,104,PHI,24,27,29,35,0,0,0,115,20050429
2005,SEA,19,26,36,23,0,0,0,104,SAC,31,23,38,24,0,0,0,116,20050429
2005,SAS,24,26,11,25,0,0,0,86,DEN,20,21,17,20,0,0,0,78,20050430
2005,DAL,26,22,29,20,0,0,0,97,HOU,22,29,26,16,0,0,0,93,20050430
2005,BOS,31,25,22,32,0,0,0,110,IND,20,27,16,16,0,0,0,79,20050430
2005,CHI,23,32,22,22,0,0,0,99,WAS,31,26,33,27,0,0,0,117,20050430
2005,PHO,39,24,28,32,0,0,0,123,MEM,20,36,26,33,0,0,0,115,20050501
2005,MIA,27,21,30,32,0,0,0,110,NJN,16,31,23,27,0,0,0,97,20050501
2005,DET,21,20,19,23,14,0,0,97,PHI,24,14,23,22,9,0,0,92,20050501
2005,SEA,20,36,24,35,0,0,0,115,SAC,31,37,16,18,0,0,0,102,20050501
2005,HOU,22,22,24,32,0,0,0,100,DAL,24,28,24,27,0,0,0,103,20050502
2005,SAS,28,29,30,20,19,0,0,126,DEN,27,24,29,27,8,0,0,115,20050502
2005,CHI,15,22,23,39,0,0,0,99,WAS,29,32,19,26,0,0,0,106,20050502
2005,IND,23,27,20,20,0,0,0,90,BOS,21,21,23,20,0,0,0,85,20050503
2005,PHI,24,20,17,17,0,0,0,78,DET,21,22,17,28,0,0,0,88,20050503
2005,SAC,24,33,36,25,0,0,0,118,SEA,29,31,30,32,0,0,0,122,20050503
2005,WAS,34,29,23,26,0,0,0,112,CHI,28,21,24,37,0,0,0,110,20050504
2005,DEN,21,22,24,22,0,0,0,89,SAS,25,20,26,28,0,0,0,99,20050504
2005,DAL,26,19,25,13,0,0,0,83,HOU,18,34,17,32,0,0,0,101,20050505
2005,BOS,20,29,21,14,8,0,0,92,IND,27,16,19,22,5,0,0,89,20050505
2005,CHI,26,28,20,17,0,0,0,91,WAS,23,29,16,26,0,0,0,94,20050506
2005,IND,22,13,29,33,0,0,0,97,BOS,20,12,18,20,0,0,0,70,20050507
2005,HOU,20,24,20,12,0,0,0,76,DAL,32,27,33,24,0,0,0,116,20050507
2005,WAS,18,29,17,22,0,0,0,86,MIA,26,23,33,23,0,0,0,105,20050508
2005,SEA,22,13,22,24,0,0,0,81,SAS,35,27,13,28,0,0,0,103,20050508
2005,IND,20,18,19,24,0,0,0,81,DET,23,29,20,24,0,0,0,96,20050509
2005,DAL,22,25,26,29,0,0,0,102,PHO,29,34,36,28,0,0,0,127,20050509
2005,WAS,20,27,24,31,0,0,0,102,MIA,30,24,26,28,0,0,0,108,20050510
2005,SEA,16,26,23,26,0,0,0,91,SAS,28,26,25,29,0,0,0,108,20050510
2005,IND,18,22,28,24,0,0,0,92,DET,33,17,19,14,0,0,0,83,20050511
2005,DAL,34,20,26,28,0,0,0,108,PHO,22,24,36,24,0,0,0,106,20050511
2005,SAS,29,22,24,16,0,0,0,91,SEA,21,28,26,17,0,0,0,92,20050512
2005,MIA,21,28,30,23,0,0,0,102,WAS,24,27,19,25,0,0,0,95,20050512
2005,PHO,27,33,27,32,0,0,0,119,DAL,31,28,23,20,0,0,0,102,20050513
2005,DET,11,17,17,29,0,0,0,74,IND,17,25,16,21,0,0,0,79,20050513
2005,MIA,23,24,40,12,0,0,0,99,WAS,26,25,25,19,0,0,0,95,20050514
2005,PHO,22,28,29,30,0,0,0,109,DAL,30,36,27,26,0,0,0,119,20050515
2005,DET,21,26,25,17,0,0,0,89,IND,13,21,22,20,0,0,0,76,20050515
2005,SAS,26,14,26,23,0,0,0,89,SEA,28,18,36,19,0,0,0,101,20050515
2005,IND,21,14,11,21,0,0,0,67,DET,23,19,27,17,0,0,0,86,20050517
2005,SEA,18,32,18,22,0,0,0,90,SAS,25,25,28,25,0,0,0,103,20050517
2005,DAL,29,26,22,31,0,0,0,108,PHO,25,23,28,38,0,0,0,114,20050518
2005,DET,19,20,23,26,0,0,0,88,IND,21,25,17,16,0,0,0,79,20050519
2005,SAS,20,32,20,26,0,0,0,98,SEA,25,22,26,23,0,0,0,96,20050519
2005,PHO,28,25,24,34,19,0,0,130,DAL,32,30,22,27,15,0,0,126,20050520
2005,SAS,30,25,23,43,0,0,0,121,PHO,20,29,33,32,0,0,0,114,20050522
2005,DET,24,20,30,16,0,0,0,90,MIA,25,18,24,14,0,0,0,81,20050523
2005,SAS,31,22,27,31,0,0,0,111,PHO,21,33,31,23,0,0,0,108,20050524
2005,DET,23,13,27,23,0,0,0,86,MIA,24,23,15,30,0,0,0,92,20050525
2005,PHO,29,10,24,29,0,0,0,92,SAS,38,18,24,22,0,0,0,102,20050528
2005,MIA,22,31,26,34,0,0,0,113,DET,24,27,24,29,0,0,0,104,20050529
2005,PHO,26,26,35,24,0,0,0,111,SAS,23,36,21,26,0,0,0,106,20050530
2005,MIA,21,25,23,27,0,0,0,96,DET,25,35,19,27,0,0,0,106,20050531
2005,SAS,24,25,29,23,0,0,0,101,PHO,24,26,20,25,0,0,0,95,20050601
2005,DET,26,13,21,16,0,0,0,76,MIA,28,25,20,15,0,0,0,88,20050602
2005,MIA,16,16,13,21,0,0,0,66,DET,17,27,24,23,0,0,0,91,20050604
2005,DET,21,24,19,24,0,0,0,88,MIA,23,17,26,16,0,0,0,82,20050606
2005,DET,20,17,14,18,0,0,0,69,SAS,17,18,20,29,0,0,0,84,20050609
2005,DET,19,23,21,13,0,0,0,76,SAS,30,28,21,18,0,0,0,97,20050612
2005,SAS,27,15,23,14,0,0,0,79,DET,21,20,29,26,0,0,0,96,20050614
2005,SAS,17,19,21,14,0,0,0,71,DET,23,28,23,28,0,0,0,102,20050616
2005,SAS,21,21,22,25,7,0,0,96,DET,23,19,21,26,6,0,0,95,20050619
2005,DET,23,23,25,24,0,0,0,95,SAS,23,24,20,19,0,0,0,86,20050621
2005,DET,16,23,18,17,0,0,0,74,SAS,18,20,19,24,0,0,0,81,20050623
2006,SAC,21,12,19,15,0,0,0,67,NOK,22,22,28,21,0,0,0,93,20051101
2006,MIL,29,21,23,29,15,0,0,117,PHI,32,23,19,28,6,0,0,108,20051101
2006,DAL,24,19,20,27,11,10,0,111,PHO,25,28,21,16,11,7,0,108,20051101
2006,DEN,21,27,24,19,0,0,0,91,SAS,27,19,23,33,0,0,0,102,20051101
2006,NYK,28,26,17,23,6,0,0,100,BOS,24,29,21,20,20,0,0,114,20051102
2006,CHA,28,31,30,9,7,0,0,105,CHI,20,20,28,30,11,0,0,109,20051102
2006,NOK,19,28,21,19,0,0,0,87,CLE,35,31,25,18,0,0,0,109,20051102
2006,LAL,26,22,20,21,10,0,0,99,DEN,28,22,17,22,8,0,0,97,20051102
2006,PHI,20,22,18,28,0,0,0,88,DET,28,24,24,32,0,0,0,108,20051102
2006,ATL,26,31,16,24,0,0,0,97,GSW,25,22,39,36,0,0,0,122,20051102
2006,SAC,27,22,16,24,0,0,0,89,HOU,18,28,26,26,0,0,0,98,20051102
2006,MIA,24,14,28,31,0,0,0,97,MEM,21,21,16,20,0,0,0,78,20051102
2006,POR,21,24,16,25,0,0,0,86,MIN,14,34,26,16,0,0,0,90,20051102
2006,MIL,17,29,27,37,0,0,0,110,NJN,29,19,17,31,0,0,0,96,20051102
2006,IND,20,27,24,19,0,0,0,90,ORL,22,21,20,15,0,0,0,78,20051102
2006,LAC,26,24,14,37,0,0,0,101,SEA,27,23,25,18,0,0,0,93,20051102
2006,WAS,29,25,25,20,0,0,0,99,TOR,24,33,25,14,0,0,0,96,20051102
2006,DAL,25,23,19,15,0,0,0,82,UTA,19,25,21,28,0,0,0,93,20051102
2006,PHO,31,35,29,27,0,0,0,122,LAL,30,26,31,25,0,0,0,112,20051103
2006,IND,29,30,23,23,0,0,0,105,MIA,23,27,21,31,0,0,0,102,20051103
2006,DET,22,16,23,21,0,0,0,82,BOS,18,25,17,21,0,0,0,81,20051104
2006,POR,17,19,21,11,0,0,0,68,DEN,30,20,27,30,0,0,0,107,20051104
2006,UTA,19,23,28,21,0,0,0,91,GSW,16,24,18,27,0,0,0,85,20051104
2006,ATL,15,25,11,26,0,0,0,77,LAC,26,30,20,16,0,0,0,92,20051104
2006,WAS,32,11,18,25,0,0,0,86,NYK,16,19,26,14,0,0,0,75,20051104
2006,MEM,26,17,25,26,0,0,0,94,ORL,22,18,22,23,0,0,0,85,20051104
2006,CHA,26,26,27,31,0,0,0,110,PHI,22,22,22,27,0,0,0,93,20051104
2006,CLE,28,17,17,14,0,0,0,76,SAS,25,25,32,20,0,0,0,102,20051104
2006,MIN,24,23,31,16,8,0,0,102,SEA,22,25,26,21,13,0,0,107,20051104
2006,NJN,27,18,31,26,0,0,0,102,TOR,19,9,29,35,0,0,0,92,20051104
2006,BOS,32,25,30,16,2,0,0,105,CHA,25,30,23,25,4,0,0,107,20051105
2006,SAS,24,19,21,20,0,0,0,84,DAL,22,27,22,32,0,0,0,103,20051105
2006,TOR,22,18,22,22,0,0,0,84,DET,38,20,31,28,0,0,0,117,20051105
2006,NOK,27,25,13,26,0,0,0,91,HOU,23,29,19,13,0,0,0,84,20051105
2006,PHI,30,31,31,19,0,0,0,111,IND,28,24,28,29,0,0,0,109,20051105
2006,MIN,20,24,23,24,8,0,0,99,LAC,26,23,27,15,9,0,0,100,20051105
2006,CLE,32,23,26,25,0,0,0,106,MEM,27,29,26,31,0,0,0,113,20051105
2006,MIA,23,29,23,25,0,0,0,100,MIL,26,23,24,32,0,0,0,105,20051105
2006,CHI,24,22,20,33,0,0,0,99,NJN,20,26,28,26,0,0,0,100,20051105
2006,ATL,21,27,24,21,0,0,0,93,POR,24,26,21,23,0,0,0,94,20051105
2006,PHO,22,22,29,24,0,0,0,97,UTA,27,22,17,22,0,0,0,88,20051105
2006,ORL,22,20,19,18,0,0,0,79,WAS,22,18,25,22,0,0,0,87,20051105
2006,DEN,20,24,25,23,0,0,0,92,LAL,34,19,25,34,0,0,0,112,20051106
2006,GSW,24,22,21,16,0,0,0,83,NYK,20,19,26,16,0,0,0,81,20051106
2006,SAC,30,25,39,24,0,0,0,118,PHO,33,27,26,31,0,0,0,117,20051106
2006,UTA,19,23,29,14,10,0,0,95,CHA,12,27,23,23,6,0,0,91,20051107
2006,SAS,33,17,19,22,13,0,0,104,CHI,21,21,26,23,4,0,0,95,20051107
2006,NJN,28,18,20,23,0,0,0,89,MIA,32,20,20,18,0,0,0,90,20051107
2006,LAC,17,28,12,21,0,0,0,78,MIN,26,18,21,28,0,0,0,93,20051107
2006,CLE,24,27,23,31,0,0,0,105,TOR,24,21,19,29,0,0,0,93,20051107
2006,LAL,26,22,31,24,0,0,0,103,ATL,29,22,18,28,0,0,0,97,20051108
2006,ORL,18,20,17,21,0,0,0,76,HOU,20,19,13,22,0,0,0,74,20051108
2006,SEA,20,17,14,18,0,0,0,69,MEM,24,17,27,26,0,0,0,94,20051108
2006,GSW,27,26,29,28,0,0,0,110,MIL,23,30,21,29,0,0,0,103,20051108
2006,DET,31,21,29,21,0,0,0,102,SAC,22,23,22,21,0,0,0,88,20051108
2006,MEM,28,31,17,22,0,0,0,98,BOS,27,20,24,28,0,0,0,99,20051109
2006,SAS,27,21,23,23,0,0,0,94,CHA,19,24,20,23,0,0,0,86,20051109
2006,GSW,28,21,19,16,0,0,0,84,CHI,20,19,28,18,0,0,0,85,20051109
2006,SEA,26,17,24,18,0,0,0,85,CLE,34,31,24,23,0,0,0,112,20051109
2006,SAC,31,22,29,9,0,0,0,91,DEN,29,28,26,24,0,0,0,107,20051109
2006,MIA,29,25,18,18,0,0,0,90,IND,27,25,24,19,0,0,0,95,20051109
2006,LAL,23,22,16,13,0,0,0,74,MIN,14,31,23,20,0,0,0,88,20051109
2006,UTA,24,19,14,26,0,0,0,83,NJN,25,17,30,19,0,0,0,91,20051109
2006,ORL,23,18,23,24,0,0,0,88,NOK,16,24,17,26,0,0,0,83,20051109
2006,DAL,26,26,19,26,0,0,0,97,PHI,26,20,30,36,0,0,0,112,20051109
2006,NYK,25,24,13,21,0,0,0,83,POR,20,19,25,31,0,0,0,95,20051109
2006,LAC,28,26,19,29,0,0,0,102,WAS,25,29,20,23,0,0,0,97,20051109
2006,LAC,27,23,25,27,0,0,0,102,ATL,25,22,22,26,0,0,0,95,20051110
2006,HOU,20,24,20,20,0,0,0,84,MIA,22,26,12,28,0,0,0,88,20051110
2006,DET,30,22,22,37,0,0,0,111,PHO,25,27,30,22,0,0,0,104,20051110
2006,SAS,26,21,34,22,0,0,0,103,BOS,13,31,15,23,0,0,0,82,20051111
2006,DAL,27,20,34,17,0,0,0,98,CHA,22,17,23,26,0,0,0,88,20051111
2006,MEM,18,18,12,22,0,0,0,70,CLE,24,23,24,18,0,0,0,89,20051111
2006,NYK,27,19,16,22,0,0,0,84,GSW,17,20,24,25,0,0,0,86,20051111
2006,NJN,23,18,20,29,0,0,0,90,IND,28,25,35,14,0,0,0,102,20051111
2006,LAL,25,21,23,12,0,0,0,81,PHI,27,15,20,23,0,0,0,85,20051111
2006,DET,25,16,23,20,0,0,0,84,POR,28,20,15,18,0,0,0,81,20051111
2006,DEN,19,25,22,19,0,0,0,85,SAC,29,32,20,20,0,0,0,101,20051111
2006,UTA,18,27,23,31,0,0,0,99,TOR,21,14,23,26,0,0,0,84,20051111
2006,SEA,25,24,24,23,0,0,0,96,WAS,29,42,35,31,0,0,0,137,20051111
2006,MEM,24,19,22,20,0,0,0,85,ATL,23,17,17,27,0,0,0,84,20051112
2006,UTA,21,24,26,27,0,0,0,98,CHI,32,23,24,24,0,0,0,103,20051112
2006,CHA,27,16,19,37,0,0,0,99,MIA,35,22,31,20,0,0,0,108,20051112
2006,IND,32,24,18,28,0,0,0,102,MIL,22,18,31,32,0,0,0,103,20051112
2006,HOU,27,21,22,29,0,0,0,99,NJN,22,15,27,27,0,0,0,91,20051112
2006,DAL,29,24,26,30,0,0,0,109,NOK,25,25,22,31,0,0,0,103,20051112
2006,GSW,18,29,23,16,0,0,0,86,PHO,35,18,28,20,0,0,0,101,20051112
2006,SAS,27,26,25,17,0,0,0,95,WAS,24,28,33,25,0,0,0,110,20051112
2006,HOU,14,30,19,19,0,0,0,82,BOS,28,27,29,18,0,0,0,102,20051113
2006,MIN,24,17,19,31,0,0,0,91,DEN,24,24,24,30,0,0,0,102,20051113
2006,CLE,20,28,23,17,20,0,0,108,ORL,18,13,32,25,12,0,0,100,20051113
2006,LAC,28,22,29,29,0,0,0,108,PHI,31,29,26,27,0,0,0,113,20051113
2006,NYK,29,28,20,28,0,0,0,105,SAC,16,25,25,29,0,0,0,95,20051113
2006,SEA,25,36,30,26,9,0,0,126,TOR,23,32,22,40,4,0,0,121,20051113
2006,CHI,18,18,20,26,0,0,0,82,GSW,23,26,26,25,0,0,0,100,20051114
2006,LAL,21,12,14,26,0,0,0,73,MEM,22,20,31,12,0,0,0,85,20051114
2006,NYK,15,22,18,18,0,0,0,73,UTA,16,20,8,18,0,0,0,62,20051114
2006,WAS,22,22,26,29,0,0,0,99,CLE,18,29,35,32,0,0,0,114,20051115
2006,DEN,20,21,27,12,0,0,0,80,DAL,17,23,20,23,0,0,0,83,20051115
2006,BOS,25,33,23,19,0,0,0,100,DET,23,25,29,38,0,0,0,115,20051115
2006,MIL,23,23,17,22,0,0,0,85,LAC,26,29,30,24,0,0,0,109,20051115
2006,NOK,21,20,28,21,12,0,0,102,MIA,24,18,24,24,19,0,0,109,20051115
2006,HOU,19,20,28,27,0,0,0,94,MIN,24,23,22,20,0,0,0,89,20051115
2006,SEA,27,21,22,29,0,0,0,99,NJN,19,29,31,30,0,0,0,109,20051115
2006,CHA,20,26,14,17,0,0,0,77,ORL,19,28,16,22,0,0,0,85,20051115
2006,TOR,20,25,20,27,0,0,0,92,PHI,39,14,20,31,0,0,0,104,20051115
2006,UTA,18,21,27,17,0,0,0,83,SAC,33,18,43,25,0,0,0,119,20051115
2006,ATL,31,21,15,12,0,0,0,79,SAS,18,34,24,27,0,0,0,103,20051115
2006,SEA,31,32,29,21,0,0,0,113,BOS,28,17,30,25,0,0,0,100,20051116
2006,IND,30,16,26,18,0,0,0,90,CHA,22,34,33,33,0,0,0,122,20051116
2006,MIL,26,22,27,15,0,0,0,90,GSW,21,24,15,27,0,0,0,87,20051116
2006,NYK,24,23,25,20,0,0,0,92,LAL,27,22,29,19,0,0,0,97,20051116
2006,DEN,22,27,20,22,0,0,0,91,NOK,25,19,16,21,0,0,0,81,20051116
2006,MEM,28,30,28,29,0,0,0,115,PHO,32,22,16,33,0,0,0,103,20051116
2006,CHI,29,23,18,23,0,0,0,93,POR,28,33,18,17,0,0,0,96,20051116
2006,PHI,40,24,26,31,0,0,0,121,TOR,28,26,28,33,0,0,0,115,20051116
2006,ATL,16,17,24,21,0,0,0,78,DAL,11,29,25,22,0,0,0,87,20051117
2006,WAS,26,21,31,20,0,0,0,98,MIN,26,31,22,30,0,0,0,109,20051117
2006,HOU,12,24,16,28,0,0,0,80,SAS,21,28,21,16,0,0,0,86,20051117
2006,TOR,22,26,20,25,0,0,0,93,BOS,18,26,26,30,0,0,0,100,20051118
2006,ORL,24,18,20,22,0,0,0,84,CLE,30,26,26,20,0,0,0,102,20051118
2006,NYK,24,24,19,19,0,0,0,86,DEN,24,23,28,20,0,0,0,95,20051118
2006,DET,26,13,18,21,0,0,0,78,HOU,22,14,12,22,0,0,0,70,20051118
2006,CHA,21,27,19,18,0,0,0,85,IND,28,20,22,23,0,0,0,93,20051118
2006,LAC,27,26,21,23,0,0,0,97,LAL,21,24,20,26,0,0,0,91,20051118
2006,PHI,27,25,19,25,0,0,0,96,MIA,25,34,24,23,0,0,0,106,20051118
2006,ATL,18,14,18,42,0,0,0,92,NOK,23,28,21,23,0,0,0,95,20051118
2006,UTA,19,23,25,27,0,0,0,94,PHO,18,29,27,28,0,0,0,102,20051118
2006,GSW,34,15,14,28,0,0,0,91,POR,22,16,17,25,0,0,0,80,20051118
2006,MIL,22,22,21,17,0,0,0,82,SAC,31,17,29,26,0,0,0,103,20051118
2006,CHI,26,18,19,21,0,0,0,84,SEA,21,12,33,32,0,0,0,98,20051118
2006,DET,16,21,25,20,0,0,0,82,DAL,40,18,32,29,0,0,0,119,20051119
2006,CHA,20,18,23,28,0,0,0,89,MIN,23,22,29,28,0,0,0,102,20051119
2006,WAS,27,12,21,23,0,0,0,83,NJN,19,27,23,20,0,0,0,89,20051119
2006,NOK,27,21,20,30,0,0,0,98,ORL,21,22,27,25,0,0,0,95,20051119
2006,CLE,30,27,28,38,0,0,0,123,PHI,31,35,28,26,0,0,0,120,20051119
2006,PHO,25,28,20,18,0,0,0,91,SAS,24,23,31,19,0,0,0,97,20051119
2006,MEM,23,20,21,16,0,0,0,80,UTA,18,17,20,17,0,0,0,72,20051119
2006,MEM,21,28,17,17,0,0,0,83,DEN,19,32,22,26,0,0,0,99,20051120
2006,HOU,19,18,15,22,0,0,0,74,IND,15,23,20,27,0,0,0,85,20051120
2006,GSW,33,24,22,22,0,0,0,101,LAC,30,31,33,19,0,0,0,113,20051120
2006,CHI,26,25,23,22,0,0,0,96,LAL,22,27,22,22,0,0,0,93,20051120
2006,POR,28,29,14,21,0,0,0,92,NYK,26,28,27,22,0,0,0,103,20051120
2006,SAC,36,27,25,16,0,0,0,104,SEA,25,32,30,19,0,0,0,106,20051120
2006,MIA,24,24,22,24,0,0,0,94,TOR,13,30,24,40,0,0,0,107,20051120
2006,NJN,21,23,30,23,0,0,0,97,GSW,22,25,35,18,0,0,0,100,20051121
2006,NOK,27,20,16,28,0,0,0,91,PHI,32,33,18,20,0,0,0,103,20051121
2006,SAS,25,24,24,23,0,0,0,96,SAC,19,20,19,35,0,0,0,93,20051121
2006,MIL,21,18,21,20,0,0,0,80,UTA,20,34,23,23,0,0,0,100,20051121
2006,BOS,18,33,22,20,0,0,0,93,CLE,27,31,26,31,0,0,0,115,20051122
2006,HOU,27,26,21,19,0,0,0,93,DAL,19,29,29,25,0,0,0,102,20051122
2006,POR,31,20,18,26,0,0,0,95,MEM,23,15,25,24,0,0,0,87,20051122
2006,TOR,18,20,25,19,0,0,0,82,PHO,18,24,19,29,0,0,0,90,20051122
2006,UTA,19,32,22,20,0,0,0,93,SEA,14,24,22,27,0,0,0,87,20051122
2006,DEN,27,28,19,34,0,0,0,108,WAS,21,30,26,28,0,0,0,105,20051122
2006,BOS,27,33,36,21,0,0,0,117,ATL,26,35,35,24,0,0,0,120,20051123
2006,NYK,21,24,18,32,0,0,0,95,CHA,25,29,30,24,0,0,0,108,20051123
2006,DEN,23,20,19,27,0,0,0,89,DET,28,32,29,25,0,0,0,114,20051123
2006,SAS,36,30,29,18,0,0,0,113,GSW,24,12,26,27,0,0,0,89,20051123
2006,PHO,25,31,19,25,0,0,0,100,HOU,19,27,19,23,0,0,0,88,20051123
2006,TOR,30,28,23,19,0,0,0,100,LAC,24,24,30,25,0,0,0,103,20051123
2006,POR,21,24,12,22,0,0,0,79,MIA,22,30,20,28,0,0,0,100,20051123
2006,PHI,23,37,17,20,0,0,0,97,MIL,22,29,31,26,0,0,0,108,20051123
2006,MIN,26,22,14,18,0,0,0,80,NOK,17,19,24,24,0,0,0,84,20051123
2006,WAS,13,18,27,25,0,0,0,83,ORL,22,22,24,23,0,0,0,91,20051123
2006,NJN,27,31,20,27,0,0,0,105,SAC,26,33,35,20,0,0,0,114,20051123
2006,CLE,15,15,22,24,0,0,0,76,IND,25,22,21,30,0,0,0,98,20051124
2006,SEA,19,32,20,25,0,0,0,96,LAL,24,19,36,29,0,0,0,108,20051124
2006,CHA,25,23,17,24,0,0,0,89,BOS,28,19,22,21,0,0,0,90,20051125
2006,LAC,22,30,24,19,0,0,0,95,DEN,23,28,35,19,0,0,0,105,20051125
2006,WAS,26,22,26,21,9,16,0,120,DET,13,30,30,22,9,10,0,114,20051125
2006,ATL,22,14,21,30,0,0,0,87,IND,17,16,23,29,0,0,0,85,20051125
2006,HOU,20,17,22,22,0,0,0,81,MEM,22,15,23,26,0,0,0,86,20051125
2006,DAL,27,30,17,29,0,0,0,103,MIA,22,23,23,22,0,0,0,90,20051125
2006,MIL,26,18,24,23,0,0,0,91,MIN,28,13,24,34,0,0,0,99,20051125
2006,POR,35,18,16,20,0,0,0,89,ORL,27,29,25,23,0,0,0,104,20051125
2006,NJN,16,14,34,17,0,0,0,81,PHO,25,19,26,22,0,0,0,92,20051125
2006,TOR,26,29,30,19,0,0,0,104,SAC,26,27,29,24,0,0,0,106,20051125
2006,CHI,21,24,31,30,0,0,0,106,SAS,17,26,31,25,0,0,0,99,20051125
2006,GSW,20,20,24,30,0,0,0,94,UTA,29,22,16,23,0,0,0,90,20051125
2006,WAS,20,21,20,21,0,0,0,82,CHA,28,17,24,31,0,0,0,100,20051126
2006,MIN,17,20,28,24,0,0,0,89,CLE,16,26,27,16,0,0,0,85,20051126
2006,MEM,31,29,27,25,0,0,0,112,DAL,27,22,26,17,0,0,0,92,20051126
2006,TOR,25,23,17,26,0,0,0,91,GSW,31,32,27,27,0,0,0,117,20051126
2006,CHI,27,17,27,23,0,0,0,94,HOU,22,22,16,29,0,0,0,89,20051126
2006,DET,17,22,24,22,0,0,0,85,MIL,18,17,24,17,0,0,0,76,20051126
2006,PHI,30,28,11,25,8,0,0,102,NYK,20,25,25,24,11,0,0,105,20051126
2006,MIA,16,17,21,23,0,0,0,77,ORL,20,21,20,19,0,0,0,80,20051126
2006,NOK,29,26,22,28,0,0,0,105,SEA,29,18,23,29,0,0,0,99,20051126
2006,POR,25,14,17,21,0,0,0,77,ATL,18,23,22,12,0,0,0,75,20051127
2006,IND,31,16,26,24,0,0,0,97,LAC,32,22,16,22,0,0,0,92,20051127
2006,NJN,26,10,29,26,11,0,0,102,LAL,10,18,28,35,5,0,0,96,20051127
2006,ORL,21,26,17,23,0,0,0,87,BOS,19,26,18,20,0,0,0,83,20051128
2006,NJN,36,19,22,24,0,0,0,101,DEN,21,19,30,22,0,0,0,92,20051128
2006,NOK,20,23,20,20,0,0,0,83,GSW,18,28,32,21,0,0,0,99,20051128
2006,NYK,20,19,23,32,0,0,0,94,MIA,29,36,22,20,0,0,0,107,20051128
2006,DAL,28,16,25,24,0,0,0,93,TOR,19,27,20,25,0,0,0,91,20051128
2006,ORL,26,16,16,18,0,0,0,76,CHI,22,19,27,17,0,0,0,85,20051129
2006,ATL,22,29,15,19,0,0,0,85,HOU,26,26,22,26,0,0,0,100,20051129
2006,DAL,27,27,22,24,11,0,0,111,MIL,23,32,24,21,13,0,0,113,20051129
2006,LAC,22,25,25,21,0,0,0,93,MIN,21,23,16,24,0,0,0,84,20051129
2006,POR,20,22,23,18,0,0,0,83,PHI,23,35,22,27,0,0,0,107,20051129
2006,CHA,25,21,20,26,0,0,0,92,SAC,30,29,32,19,0,0,0,110,20051129
2006,LAL,17,21,21,25,0,0,0,84,SAS,29,14,27,20,0,0,0,90,20051129
2006,IND,16,18,29,21,0,0,0,84,UTA,13,14,14,19,0,0,0,60,20051129
2006,MIA,18,25,27,26,0,0,0,96,ATL,12,22,25,15,0,0,0,74,20051130
2006,PHI,25,25,26,27,0,0,0,103,BOS,28,23,27,32,0,0,0,110,20051130
2006,LAC,26,21,27,23,8,0,0,105,CLE,22,30,19,26,15,0,0,112,20051130
2006,NOK,24,31,27,20,0,0,0,102,DEN,28,26,23,18,0,0,0,95,20051130
2006,SAC,31,19,22,34,0,0,0,106,GSW,31,26,25,31,0,0,0,113,20051130
2006,DET,28,12,27,26,0,0,0,93,NJN,21,24,18,20,0,0,0,83,20051130
2006,CHI,29,29,24,19,0,0,0,101,NYK,24,26,24,35,0,0,0,109,20051130
2006,IND,17,27,20,27,0,0,0,91,PHO,35,26,25,23,0,0,0,109,20051130
2006,CHA,24,22,24,24,0,0,0,94,SEA,30,26,27,21,0,0,0,104,20051130
2006,MEM,32,26,15,19,0,0,0,92,TOR,17,18,14,17,0,0,0,66,20051130
2006,POR,28,23,25,13,0,0,0,89,WAS,23,30,22,21,0,0,0,96,20051130
2006,SAS,22,23,21,26,0,0,0,92,DAL,23,20,22,25,0,0,0,90,20051201
2006,LAL,26,25,24,17,13,0,0,105,UTA,21,22,25,24,9,0,0,101,20051201
2006,TOR,34,20,23,25,0,0,0,102,ATL,23,22,22,34,0,0,0,101,20051202
2006,CHI,34,22,15,35,0,0,0,106,BOS,28,20,28,26,0,0,0,102,20051202
2006,NYK,28,31,8,31,0,0,0,98,DET,26,33,24,23,0,0,0,106,20051202
2006,CHA,30,27,20,23,0,0,0,100,GSW,24,30,21,32,0,0,0,107,20051202
2006,MIN,24,21,29,39,0,0,0,113,LAL,28,32,22,26,0,0,0,108,20051202
2006,ORL,15,17,15,22,0,0,0,69,MEM,33,22,14,22,0,0,0,91,20051202
2006,PHI,23,18,23,22,0,0,0,86,NOK,28,26,9,25,0,0,0,88,20051202
2006,DEN,27,15,33,22,0,0,0,97,PHO,25,34,14,29,0,0,0,102,20051202
2006,IND,18,32,27,21,0,0,0,98,POR,22,16,14,26,0,0,0,78,20051202
2006,MIA,29,28,24,17,0,0,0,98,SAC,24,24,25,14,0,0,0,87,20051202
2006,CLE,30,18,31,29,0,0,0,108,SEA,26,32,23,34,0,0,0,115,20051202
2006,MIL,33,22,22,28,0,0,0,105,WAS,27,29,17,29,0,0,0,102,20051202
2006,DET,16,28,27,21,0,0,0,92,CHI,25,19,10,25,0,0,0,79,20051203
2006,NOK,15,25,27,21,0,0,0,88,DAL,23,26,26,22,0,0,0,97,20051203
2006,MIA,24,26,23,26,0,0,0,99,DEN,25,31,28,17,0,0,0,101,20051203
2006,MEM,34,13,26,17,0,0,0,90,HOU,13,13,24,25,0,0,0,75,20051203
2006,CLE,18,21,24,27,0,0,0,90,LAC,31,21,24,26,0,0,0,102,20051203
2006,ORL,19,23,20,22,0,0,0,84,MIL,27,21,18,38,0,0,0,104,20051203
2006,TOR,27,29,15,24,0,0,0,95,NJN,27,23,14,18,0,0,0,82,20051203
2006,PHI,22,22,18,29,0,0,0,91,SAS,18,23,31,28,0,0,0,100,20051203
2006,CHA,24,24,25,25,0,0,0,98,LAL,28,18,23,30,0,0,0,99,20051204
2006,BOS,22,24,30,26,0,0,0,102,NYK,26,19,22,32,0,0,0,99,20051204
2006,ATL,10,26,15,43,0,0,0,94,PHO,25,32,31,24,0,0,0,112,20051204
2006,UTA,24,31,15,28,0,0,0,98,POR,13,32,28,20,0,0,0,93,20051204
2006,MIN,25,23,18,19,0,0,0,85,SAC,21,15,18,23,0,0,0,77,20051204
2006,IND,28,18,27,29,0,0,0,102,SEA,27,22,33,25,0,0,0,107,20051204
2006,DAL,22,31,26,23,0,0,0,102,CHI,23,28,20,23,0,0,0,94,20051205
2006,MIA,28,21,26,14,0,0,0,89,LAC,21,31,26,21,0,0,0,99,20051205
2006,SAS,26,20,31,33,0,0,0,110,ORL,25,21,15,24,0,0,0,85,20051205
2006,MIN,22,24,22,23,0,0,0,91,UTA,24,19,18,16,0,0,0,77,20051205
2006,ATL,22,34,30,30,0,0,0,116,DEN,32,32,24,37,0,0,0,125,20051206
2006,BOS,18,20,16,19,0,0,0,73,HOU,18,30,17,26,0,0,0,91,20051206
2006,DAL,22,24,20,18,0,0,0,84,IND,16,24,15,20,0,0,0,75,20051206
2006,NOK,18,21,14,20,0,0,0,73,MEM,19,31,20,19,0,0,0,89,20051206
2006,LAL,34,27,27,23,0,0,0,111,MIL,25,26,21,20,0,0,0,92,20051206
2006,POR,24,23,18,20,0,0,0,85,PHO,34,32,36,28,0,0,0,130,20051206
2006,CLE,23,28,22,29,0,0,0,102,SAC,19,25,28,25,0,0,0,97,20051206
2006,NYK,17,24,30,33,0,0,0,104,SEA,27,23,22,29,0,0,0,101,20051206
2006,TOR,32,29,18,26,6,0,0,111,WAS,35,24,24,22,14,0,0,119,20051206
2006,NJN,22,23,27,25,0,0,0,97,CHA,18,19,24,23,0,0,0,84,20051207
2006,PHO,33,30,28,27,0,0,0,118,GSW,28,37,24,21,0,0,0,110,20051207
2006,NYK,25,25,13,16,0,0,0,79,LAC,19,20,16,29,0,0,0,84,20051207
2006,BOS,31,28,24,18,0,0,0,101,NOK,24,24,23,16,0,0,0,87,20051207
2006,CHI,20,24,35,23,0,0,0,102,ORL,22,29,17,25,0,0,0,93,20051207
2006,MIL,18,36,11,23,0,0,0,88,PHI,19,20,32,14,0,0,0,85,20051207
2006,MIN,16,24,11,33,0,0,0,84,POR,18,23,20,13,0,0,0,74,20051207
2006,MIA,14,16,29,25,0,0,0,84,SAS,17,30,24,27,0,0,0,98,20051207
2006,LAL,23,27,31,21,0,0,0,102,TOR,23,21,18,29,0,0,0,91,20051207
2006,ATL,24,24,16,19,0,0,0,83,UTA,29,20,25,21,0,0,0,95,20051207
2006,WAS,30,21,20,16,0,0,0,87,IND,18,32,37,24,0,0,0,111,20051208
2006,HOU,29,18,26,33,0,0,0,106,SAC,31,21,27,16,0,0,0,95,20051208
2006,LAL,33,14,25,21,0,0,0,93,CHI,19,18,31,12,0,0,0,80,20051209
2006,NJN,29,25,26,29,0,0,0,109,CLE,19,27,26,28,0,0,0,100,20051209
2006,DET,25,22,27,32,0,0,0,106,GSW,27,22,29,25,0,0,0,103,20051209
2006,DAL,19,24,21,26,0,0,0,90,MEM,16,20,21,26,0,0,0,83,20051209
2006,DEN,15,27,25,33,0,0,0,100,MIA,13,30,24,25,0,0,0,92,20051209
2006,CHA,30,18,29,38,0,0,0,115,PHI,34,28,35,22,0,0,0,119,20051209
2006,NYK,29,15,20,17,0,0,0,81,PHO,22,24,18,21,0,0,0,85,20051209
2006,NOK,27,19,21,22,6,0,0,95,POR,24,17,23,25,9,0,0,98,20051209
2006,BOS,17,25,23,24,0,0,0,89,SAS,22,29,24,26,0,0,0,101,20051209
2006,SEA,31,29,28,18,0,0,0,106,UTA,29,20,23,18,0,0,0,90,20051209
2006,SAS,23,25,23,13,0,0,0,84,ATL,15,27,27,25,0,0,0,94,20051210
2006,TOR,25,25,29,32,0,0,0,111,CHA,24,29,19,31,0,0,0,103,20051210
2006,BOS,23,24,20,27,0,0,0,94,DAL,28,24,24,27,0,0,0,103,20051210
2006,MEM,9,18,19,20,0,0,0,66,IND,24,19,16,21,0,0,0,80,20051210
2006,PHO,34,23,19,15,0,0,0,91,LAC,37,16,30,18,0,0,0,101,20051210
2006,CLE,32,23,27,24,0,0,0,106,MIL,28,24,34,25,0,0,0,111,20051210
2006,LAL,18,22,23,19,0,0,0,82,MIN,27,21,26,21,0,0,0,95,20051210
2006,PHI,30,24,30,23,0,0,0,107,NJN,25,24,20,26,0,0,0,95,20051210
2006,DEN,21,25,11,26,0,0,0,83,ORL,27,21,23,23,0,0,0,94,20051210
2006,SAC,31,31,30,31,0,0,0,123,SEA,29,28,13,34,0,0,0,104,20051210
2006,CHI,22,34,28,34,0,0,0,118,WAS,27,20,37,27,0,0,0,111,20051210
2006,DET,30,29,24,26,0,0,0,109,LAC,23,22,27,29,0,0,0,101,20051211
2006,WAS,18,30,24,23,6,0,0,101,MIA,21,21,35,18,9,0,0,104,20051211
2006,HOU,24,23,21,32,0,0,0,100,POR,20,22,15,29,0,0,0,86,20051211
2006,NOK,22,34,24,20,0,0,0,100,SAC,28,25,27,30,0,0,0,110,20051211
2006,LAL,28,30,24,27,0,0,0,109,DAL,27,29,31,19,0,0,0,106,20051212
2006,MIL,26,35,26,25,0,0,0,112,NYK,26,23,26,17,0,0,0,92,20051212
2006,MIN,25,19,18,23,4,0,0,89,PHI,20,24,22,19,5,0,0,90,20051212
2006,NOK,31,23,19,18,0,0,0,91,PHO,23,23,16,25,0,0,0,87,20051212
2006,DET,18,33,15,12,0,0,0,78,UTA,15,23,25,29,0,0,0,92,20051212
2006,DEN,26,23,23,29,0,0,0,101,CHA,20,24,30,11,0,0,0,85,20051213
2006,MIA,24,28,17,31,0,0,0,100,CHI,22,21,22,32,0,0,0,97,20051213
2006,ATL,25,23,30,22,0,0,0,100,CLE,19,22,27,26,0,0,0,94,20051213
2006,SAC,24,20,23,26,0,0,0,93,MIN,19,20,26,26,0,0,0,91,20051213
2006,LAC,23,27,17,17,3,0,0,87,SAS,22,22,24,16,11,0,0,95,20051213
2006,GSW,20,28,28,22,12,0,0,110,SEA,26,24,22,26,9,0,0,107,20051213
2006,NJN,14,21,17,22,0,0,0,74,WAS,29,13,31,21,0,0,0,94,20051213
2006,IND,21,10,21,19,0,0,0,71,BOS,22,25,14,24,0,0,0,85,20051214
2006,PHO,24,20,26,26,0,0,0,96,DAL,30,22,25,25,0,0,0,102,20051214
2006,SAC,27,21,27,23,0,0,0,98,DET,36,20,27,26,0,0,0,109,20051214
2006,HOU,24,31,16,27,13,0,0,111,GSW,18,29,30,21,7,0,0,105,20051214
2006,LAL,22,23,28,21,0,0,0,94,MEM,16,21,15,27,0,0,0,79,20051214
2006,MIA,18,29,25,28,0,0,0,100,MIL,26,18,20,19,0,0,0,83,20051214
2006,CHA,19,15,27,30,0,0,0,91,NJN,22,18,18,25,0,0,0,83,20051214
2006,LAC,22,28,16,23,0,0,0,89,NOK,28,31,23,20,0,0,0,102,20051214
2006,ORL,25,29,18,33,0,0,0,105,NYK,24,15,23,28,0,0,0,90,20051214
2006,ATL,20,26,32,23,0,0,0,101,PHI,31,22,25,28,0,0,0,106,20051214
2006,CHI,22,29,25,29,0,0,0,105,TOR,25,31,12,26,0,0,0,94,20051214
2006,POR,22,21,14,20,0,0,0,77,UTA,20,24,18,20,0,0,0,82,20051214
2006,DEN,19,21,25,20,0,0,0,85,CLE,24,20,22,28,0,0,0,94,20051215
2006,SAS,14,25,24,27,0,0,0,90,MIN,21,8,29,30,0,0,0,88,20051215
2006,HOU,20,28,25,31,0,0,0,104,SEA,22,29,20,27,0,0,0,98,20051215
2006,NYK,31,31,19,30,0,0,0,111,ATL,39,32,26,25,0,0,0,122,20051216
2006,MIL,24,26,25,25,0,0,0,100,BOS,26,11,33,26,0,0,0,96,20051216
2006,ORL,21,27,19,26,10,0,0,103,DAL,26,22,18,27,16,0,0,109,20051216
2006,CHI,19,20,19,24,0,0,0,82,DET,29,23,33,25,0,0,0,110,20051216
2006,UTA,18,19,25,21,0,0,0,83,IND,19,19,23,32,0,0,0,93,20051216
2006,WAS,22,25,19,25,0,0,0,91,LAL,19,23,28,27,0,0,0,97,20051216
2006,DEN,19,29,23,23,12,0,0,106,NJN,29,18,21,26,21,0,0,115,20051216
2006,PHO,20,23,21,37,0,0,0,101,NOK,26,24,28,10,0,0,0,88,20051216
2006,MIA,30,33,26,23,0,0,0,112,PHI,21,30,23,31,0,0,0,105,20051216
2006,SEA,37,30,24,20,0,0,0,111,POR,16,30,24,29,0,0,0,99,20051216
2006,GSW,23,24,31,30,0,0,0,108,TOR,28,16,22,32,0,0,0,98,20051216
2006,DET,21,28,26,28,0,0,0,103,CHA,12,14,30,22,0,0,0,78,20051217
2006,BOS,21,21,21,23,0,0,0,86,CHI,30,21,39,28,0,0,0,118,20051217
2006,MIA,18,26,29,34,0,0,0,107,CLE,22,39,32,22,0,0,0,115,20051217
2006,HOU,24,25,14,18,0,0,0,81,LAC,23,26,18,22,0,0,0,89,20051217
2006,PHO,20,29,16,22,0,0,0,87,MEM,23,25,21,22,0,0,0,91,20051217
2006,UTA,25,19,21,23,0,0,0,88,MIL,13,23,29,15,0,0,0,80,20051217
2006,IND,21,23,27,31,0,0,0,102,NYK,19,29,25,23,0,0,0,96,20051217
2006,SAC,17,27,26,19,0,0,0,89,SAS,29,14,28,19,0,0,0,90,20051217
2006,DEN,24,20,33,21,9,0,0,107,ATL,29,20,26,23,12,0,0,110,20051218
2006,MIN,16,18,32,29,0,0,0,95,DAL,18,25,24,35,0,0,0,102,20051218
2006,HOU,12,19,34,11,0,0,0,76,LAL,14,28,15,17,0,0,0,74,20051218
2006,GSW,24,15,24,27,0,0,0,90,NJN,37,29,28,24,0,0,0,118,20051218
2006,SAS,19,18,25,14,0,0,0,76,NOK,21,16,23,29,0,0,0,89,20051218
2006,WAS,19,21,18,34,0,0,0,92,POR,19,29,22,27,0,0,0,97,20051218
2006,PHI,27,25,28,27,0,0,0,107,TOR,21,27,14,18,0,0,0,80,20051218
2006,GSW,27,24,29,18,0,0,0,98,BOS,26,36,23,24,0,0,0,109,20051219
2006,SAC,30,22,21,26,4,0,0,103,CHA,25,27,27,20,7,0,0,106,20051219
2006,DET,28,20,21,18,6,13,0,106,MEM,18,21,22,26,6,11,0,104,20051219
2006,TOR,19,25,28,20,0,0,0,92,ORL,27,19,24,20,0,0,0,90,20051219
2006,WAS,21,26,27,27,0,0,0,101,SEA,31,28,22,30,0,0,0,111,20051219
2006,CHA,36,21,20,28,0,0,0,105,CHI,28,19,22,23,0,0,0,92,20051220
2006,UTA,29,15,15,26,0,0,0,85,CLE,22,27,33,28,0,0,0,110,20051220
2006,POR,25,22,19,23,0,0,0,89,DET,23,23,25,22,0,0,0,93,20051220
2006,DAL,18,26,17,29,0,0,0,90,LAL,25,28,42,17,0,0,0,112,20051220
2006,ATL,9,26,25,32,0,0,0,92,MIA,21,35,36,19,0,0,0,111,20051220
2006,SAS,30,24,23,23,7,0,0,107,MIL,24,23,31,22,9,0,0,109,20051220
2006,LAC,23,21,27,14,0,0,0,85,NJN,26,31,23,19,0,0,0,99,20051220
2006,SEA,24,20,22,17,0,0,0,83,PHO,29,25,27,30,0,0,0,111,20051220
2006,UTA,23,16,30,20,0,0,0,89,BOS,20,27,27,27,0,0,0,101,20051221
2006,WAS,27,25,32,32,0,0,0,116,DEN,25,29,23,33,0,0,0,110,20051221
2006,TOR,21,27,22,24,0,0,0,94,HOU,16,27,15,23,0,0,0,81,20051221
2006,LAC,18,20,20,17,0,0,0,75,IND,24,22,20,31,0,0,0,97,20051221
2006,POR,24,15,21,19,0,0,0,79,MEM,18,25,23,23,0,0,0,89,20051221
2006,NOK,16,14,15,24,0,0,0,69,MIN,26,23,21,18,0,0,0,88,20051221
2006,SAS,29,27,33,20,0,0,0,109,NYK,16,19,23,38,0,0,0,96,20051221
2006,NJN,23,23,28,22,0,0,0,96,ORL,19,21,27,18,0,0,0,85,20051221
2006,GSW,22,28,33,17,0,0,0,100,PHI,35,26,26,24,0,0,0,111,20051221
2006,CLE,31,26,14,37,0,0,0,108,CHI,26,27,26,21,0,0,0,100,20051222
2006,DAL,33,21,19,32,0,0,0,105,SAC,21,28,23,23,0,0,0,95,20051222
2006,PHI,25,30,29,24,0,0,0,108,ATL,30,28,18,35,0,0,0,111,20051223
2006,LAC,28,28,21,20,0,0,0,97,CHA,21,28,17,22,0,0,0,88,20051223
2006,IND,16,24,21,28,0,0,0,89,CLE,29,23,24,18,0,0,0,94,20051223
2006,HOU,15,22,18,31,0,0,0,86,DEN,22,30,27,29,0,0,0,108,20051223
2006,GSW,22,20,21,22,0,0,0,85,DET,27,23,30,17,0,0,0,97,20051223
2006,CHI,23,13,23,18,0,0,0,77,MEM,28,17,26,24,0,0,0,95,20051223
2006,NJN,12,24,33,26,0,0,0,95,MIA,24,17,19,28,0,0,0,88,20051223
2006,NOK,22,23,25,24,0,0,0,94,MIL,23,21,28,29,0,0,0,101,20051223
2006,POR,22,26,16,27,0,0,0,91,MIN,24,25,21,13,0,0,0,83,20051223
2006,UTA,19,26,23,22,0,0,0,90,NYK,21,26,22,29,0,0,0,98,20051223
2006,LAL,26,28,28,22,0,0,0,104,ORL,24,16,28,20,0,0,0,88,20051223
2006,WAS,33,24,30,25,0,0,0,112,PHO,31,24,30,26,0,0,0,111,20051223
2006,TOR,16,30,20,24,0,0,0,90,SAS,22,27,20,26,0,0,0,95,20051223
2006,DAL,20,26,29,26,0,0,0,101,SEA,21,31,24,22,0,0,0,98,20051223
2006,SAS,8,22,23,17,0,0,0,70,DET,18,22,17,28,0,0,0,85,20051225
2006,LAL,26,22,22,22,0,0,0,92,MIA,31,22,17,27,0,0,0,97,20051225
2006,CHI,21,24,21,25,0,0,0,91,CLE,27,28,22,25,0,0,0,102,20051226
2006,IND,20,21,20,19,0,0,0,80,DAL,26,24,30,22,0,0,0,102,20051226
2006,DEN,44,21,19,34,0,0,0,118,GSW,37,29,17,29,0,0,0,112,20051226
2006,PHO,24,21,35,23,0,0,0,103,MIN,20,22,28,19,0,0,0,89,20051226
2006,NJN,32,31,30,16,0,0,0,109,NYK,20,30,25,26,0,0,0,101,20051226
2006,MIL,29,15,28,21,0,0,0,93,ORL,34,24,23,27,0,0,0,108,20051226
2006,POR,25,30,25,25,0,0,0,105,SAC,30,15,24,23,0,0,0,92,20051226
2006,BOS,23,32,28,28,0,0,0,111,SEA,17,33,40,28,0,0,0,118,20051226
2006,MEM,30,26,20,19,7,0,0,102,UTA,27,18,25,25,10,0,0,105,20051226
2006,LAL,29,23,14,25,0,0,0,91,WAS,20,23,29,22,0,0,0,94,20051226
2006,CHA,26,25,16,26,0,0,0,93,ATL,23,21,28,18,0,0,0,90,20051227
2006,PHI,27,27,26,28,0,0,0,108,DEN,25,27,28,26,0,0,0,106,20051227
2006,TOR,29,16,30,31,0,0,0,106,DET,32,31,27,23,0,0,0,113,20051227
2006,UTA,19,17,24,22,0,0,0,82,HOU,26,15,18,15,0,0,0,74,20051227
2006,SAC,27,32,28,23,0,0,0,110,LAC,22,22,22,27,0,0,0,93,20051227
2006,MIL,31,23,21,23,0,0,0,98,MIA,29,23,27,30,0,0,0,109,20051227
2006,CLE,21,20,21,29,0,0,0,91,NJN,29,27,24,16,0,0,0,96,20051227
2006,IND,29,19,15,23,0,0,0,86,SAS,27,19,20,33,0,0,0,99,20051227
2006,CHI,21,24,18,17,0,0,0,80,CHA,22,23,20,28,0,0,0,93,20051228
2006,BOS,38,19,28,24,0,0,0,109,GSW,37,21,32,21,0,0,0,111,20051228
2006,MEM,29,17,20,22,12,0,0,100,LAL,35,19,13,21,11,0,0,99,20051228
2006,SEA,15,26,26,28,0,0,0,95,MIN,30,21,28,29,0,0,0,108,20051228
2006,HOU,17,30,25,18,0,0,0,90,NOK,26,25,17,24,0,0,0,92,20051228
2006,NYK,18,28,25,24,0,0,0,95,ORL,28,24,30,23,0,0,0,105,20051228
2006,PHI,27,23,21,20,0,0,0,91,POR,28,22,21,24,0,0,0,95,20051228
2006,ATL,26,25,28,23,0,0,0,102,TOR,35,18,26,29,0,0,0,108,20051228
2006,PHO,28,22,28,26,0,0,0,104,WAS,24,26,26,23,0,0,0,99,20051228
2006,SEA,27,31,24,30,0,0,0,112,DEN,25,36,24,20,0,0,0,105,20051229
2006,MIA,26,26,20,29,0,0,0,101,DET,27,26,26,27,0,0,0,106,20051229
2006,NOK,22,22,19,21,0,0,0,84,SAS,35,29,18,29,0,0,0,111,20051229
2006,PHO,27,29,25,29,0,0,0,110,CHA,23,30,27,20,0,0,0,100,20051230
2006,GSW,31,21,29,30,0,0,0,111,DAL,32,30,21,26,0,0,0,109,20051230
2006,TOR,22,23,23,31,0,0,0,99,IND,31,24,22,20,0,0,0,97,20051230
2006,NYK,25,32,21,30,0,0,0,108,MIL,28,26,26,33,0,0,0,113,20051230
2006,ATL,19,23,32,17,0,0,0,91,NJN,20,28,26,25,0,0,0,99,20051230
2006,MIN,22,29,21,15,0,0,0,87,ORL,32,27,20,28,0,0,0,107,20051230
2006,MEM,21,28,18,26,0,0,0,93,POR,22,19,15,34,0,0,0,90,20051230
2006,BOS,24,25,37,26,0,0,0,112,SAC,28,31,28,29,0,0,0,116,20051230
2006,MIA,34,27,30,37,0,0,0,128,WAS,28,27,38,20,0,0,0,113,20051230
2006,PHO,28,17,24,23,15,0,0,107,CHI,27,22,26,17,6,0,0,98,20051231
2006,DET,20,20,23,21,0,0,0,84,CLE,21,33,27,16,0,0,0,97,20051231
2006,SAS,18,23,28,29,0,0,0,98,DEN,15,30,16,27,0,0,0,88,20051231
2006,GSW,23,26,25,20,0,0,0,94,HOU,18,26,22,23,0,0,0,89,20051231
2006,BOS,31,33,25,22,0,0,0,111,LAC,31,15,30,16,0,0,0,92,20051231
2006,DAL,22,22,29,22,0,0,0,95,NOK,25,19,19,27,0,0,0,90,20051231
2006,MEM,30,25,20,25,0,0,0,100,SEA,26,24,18,28,0,0,0,96,20051231
2006,PHI,23,25,34,20,0,0,0,102,UTA,29,26,26,27,0,0,0,108,20051231
2006,UTA,22,31,23,22,0,0,0,98,LAL,22,27,24,21,0,0,0,94,20060101
2006,MIN,23,21,15,11,0,0,0,70,MIA,15,26,32,24,0,0,0,97,20060101
2006,LAC,26,29,25,20,0,0,0,100,POR,20,26,22,26,0,0,0,94,20060101
2006,MIL,23,20,30,20,0,0,0,93,CHI,23,29,18,22,0,0,0,92,20060102
2006,BOS,31,22,25,32,0,0,0,110,DEN,29,29,35,27,0,0,0,120,20060102
2006,SEA,23,24,24,25,0,0,0,96,IND,38,25,26,26,0,0,0,115,20060102
2006,CHA,25,27,14,20,0,0,0,86,NOK,25,28,19,31,0,0,0,103,20060102
2006,PHO,23,26,26,29,14,9,6,133,NYK,27,34,20,23,14,9,13,140,20060102
2006,TOR,23,29,21,35,0,0,0,108,ATL,25,28,27,17,0,0,0,97,20060103
2006,POR,20,24,19,18,0,0,0,81,DAL,24,23,21,27,0,0,0,95,20060103
2006,ORL,26,29,22,22,0,0,0,99,DET,26,31,22,29,0,0,0,108,20060103
2006,GSW,17,25,24,28,0,0,0,94,MEM,25,37,20,22,0,0,0,104,20060103
2006,PHI,24,27,32,28,0,0,0,111,SAC,26,21,28,23,0,0,0,98,20060103
2006,LAL,16,29,17,18,0,0,0,80,UTA,16,26,21,27,0,0,0,90,20060103
2006,HOU,27,30,32,34,0,0,0,123,WAS,21,25,24,41,0,0,0,111,20060103
2006,CHA,23,28,30,25,0,0,0,106,BOS,28,32,21,28,0,0,0,109,20060104
2006,SEA,24,27,26,24,0,0,0,101,CHI,24,16,28,29,0,0,0,97,20060104
2006,IND,25,23,18,20,0,0,0,86,DEN,34,24,21,27,0,0,0,106,20060104
2006,CLE,19,23,20,29,0,0,0,91,MIL,25,21,21,17,0,0,0,84,20060104
2006,DAL,17,24,19,18,0,0,0,78,MIN,18,20,31,22,0,0,0,91,20060104
2006,MIA,32,13,23,24,0,0,0,92,NOK,32,32,19,24,0,0,0,107,20060104
2006,PHI,28,17,16,24,0,0,0,85,PHO,29,15,35,26,0,0,0,105,20060104
2006,POR,22,20,22,11,0,0,0,75,SAS,28,25,25,28,0,0,0,106,20060104
2006,ORL,22,20,26,29,0,0,0,97,TOR,28,33,26,34,0,0,0,121,20060104
2006,HOU,24,25,22,19,0,0,0,90,CLE,18,17,25,21,0,0,0,81,20060105
2006,IND,34,22,17,26,0,0,0,99,GSW,14,27,23,25,0,0,0,89,20060105
2006,ATL,27,16,36,24,0,0,0,103,BOS,24,26,29,19,0,0,0,98,20060106
2006,DAL,19,33,26,22,14,0,0,114,DEN,21,31,25,23,12,0,0,112,20060106
2006,SEA,21,23,21,20,0,0,0,85,DET,26,19,23,29,0,0,0,97,20060106
2006,PHI,22,30,23,18,0,0,0,93,LAL,37,30,27,25,0,0,0,119,20060106
2006,UTA,14,16,19,16,0,0,0,65,MEM,28,17,16,26,0,0,0,87,20060106
2006,CHI,26,25,26,28,0,0,0,105,MIL,18,33,25,15,0,0,0,91,20060106
2006,ORL,27,20,16,43,0,0,0,106,NJN,30,25,28,30,0,0,0,113,20060106
2006,POR,13,26,24,17,0,0,0,80,NOK,30,23,11,26,0,0,0,90,20060106
2006,WAS,30,21,17,24,0,0,0,92,NYK,25,27,28,33,0,0,0,113,20060106
2006,MIA,25,25,21,22,0,0,0,93,PHO,47,25,17,22,0,0,0,111,20060106
2006,LAC,28,35,26,25,0,0,0,114,SAC,24,43,24,27,0,0,0,118,20060106
2006,MIN,22,17,17,21,0,0,0,77,SAS,22,17,23,21,0,0,0,83,20060106
2006,HOU,20,24,23,25,0,0,0,92,TOR,21,27,29,35,0,0,0,112,20060106
2006,NOK,24,29,19,21,0,0,0,93,ATL,27,30,25,19,0,0,0,101,20060107
2006,MEM,23,21,15,23,0,0,0,82,CHI,30,24,30,27,0,0,0,111,20060107
2006,MIL,23,17,25,23,0,0,0,88,CLE,16,28,20,32,0,0,0,96,20060107
2006,MIN,21,20,22,16,0,0,0,79,DAL,22,16,19,26,0,0,0,83,20060107
2006,UTA,16,20,19,27,12,0,0,94,DET,30,14,21,17,8,0,0,90,20060107
2006,LAL,29,21,28,34,0,0,0,112,LAC,18,37,27,27,0,0,0,109,20060107
2006,CHA,31,19,10,32,0,0,0,92,ORL,27,22,33,26,0,0,0,108,20060107
2006,SAS,20,20,20,26,0,0,0,86,PHO,24,18,23,26,0,0,0,91,20060107
2006,BOS,28,23,25,26,0,0,0,102,WAS,26,19,37,21,0,0,0,103,20060107
2006,DEN,16,24,27,25,0,0,0,92,HOU,20,17,25,28,0,0,0,90,20060108
2006,SEA,35,27,27,27,0,0,0,116,NYK,25,36,30,29,0,0,0,120,20060108
2006,MIA,35,29,34,20,0,0,0,118,POR,29,22,20,18,0,0,0,89,20060108
2006,IND,25,35,31,17,0,0,0,108,SAC,20,19,22,22,0,0,0,83,20060108
2006,NJN,29,19,28,29,0,0,0,105,TOR,23,28,22,31,0,0,0,104,20060108
2006,DAL,23,28,28,25,0,0,0,104,BOS,25,28,21,28,0,0,0,102,20060109
2006,TOR,37,10,29,28,0,0,0,104,CHI,33,30,21,29,0,0,0,113,20060109
2006,IND,22,23,20,25,0,0,0,90,LAL,24,23,17,32,0,0,0,96,20060109
2006,SEA,26,21,26,25,0,0,0,98,PHI,22,27,36,22,0,0,0,107,20060109
2006,UTA,24,23,22,28,0,0,0,97,WAS,18,15,20,36,0,0,0,89,20060109
2006,BOS,29,24,21,24,0,0,0,98,ATL,32,30,19,13,0,0,0,94,20060110
2006,HOU,23,22,18,27,9,7,0,106,CHA,24,25,15,26,9,12,0,111,20060110
2006,NYK,20,25,22,25,0,0,0,92,CLE,23,21,28,12,0,0,0,84,20060110
2006,PHO,25,28,32,21,11,8,12,137,DEN,26,29,24,27,11,8,14,139,20060110
2006,ORL,27,12,18,16,0,0,0,73,LAC,18,26,24,22,0,0,0,90,20060110
2006,SAC,30,21,17,17,0,0,0,85,MEM,18,34,27,20,0,0,0,99,20060110
2006,MIN,21,25,17,29,0,0,0,92,MIL,14,34,20,27,0,0,0,95,20060110
2006,DET,24,18,32,22,0,0,0,96,NOK,25,20,19,22,0,0,0,86,20060110
2006,NJN,22,19,24,26,0,0,0,91,SAS,27,22,21,26,0,0,0,96,20060110
2006,MIA,26,27,29,28,0,0,0,110,GSW,26,17,24,29,0,0,0,96,20060111
2006,SAC,18,25,23,22,0,0,0,88,HOU,13,23,21,23,0,0,0,80,20060111
2006,MIL,25,24,17,22,0,0,0,88,IND,31,30,20,31,0,0,0,112,20060111
2006,CHI,26,16,21,30,0,0,0,93,MIN,28,15,23,33,0,0,0,99,20060111
2006,DAL,21,27,27,30,10,0,0,115,NYK,35,28,23,19,12,0,0,117,20060111
2006,UTA,29,19,27,35,0,0,0,110,PHI,24,27,23,28,0,0,0,102,20060111
2006,LAL,24,34,21,24,0,0,0,103,POR,31,28,30,24,0,0,0,113,20060111
2006,ORL,21,26,19,38,0,0,0,104,SEA,31,25,28,29,0,0,0,113,20060111
2006,CHA,27,18,18,23,0,0,0,86,TOR,20,13,30,32,0,0,0,95,20060111
2006,ATL,15,21,17,19,0,0,0,72,WAS,26,25,21,31,0,0,0,103,20060111
2006,CLE,25,25,17,31,0,0,0,98,LAL,28,18,22,31,0,0,0,99,20060112
2006,GSW,22,32,19,26,0,0,0,99,PHO,29,35,28,20,0,0,0,112,20060112
2006,DET,28,20,21,14,0,0,0,83,SAS,15,21,15,17,0,0,0,68,20060112
2006,MIL,31,26,22,24,0,0,0,103,CHA,15,31,32,24,0,0,0,102,20060113
2006,WAS,16,24,25,29,0,0,0,94,IND,18,21,24,22,0,0,0,85,20060113
2006,NJN,18,11,17,23,0,0,0,69,MEM,18,29,18,16,0,0,0,81,20060113
2006,DEN,19,29,18,23,0,0,0,89,MIN,25,24,30,24,0,0,0,103,20060113
2006,SAC,25,14,14,23,0,0,0,76,NOK,28,26,17,19,0,0,0,90,20060113
2006,ATL,22,25,26,21,0,0,0,94,NYK,27,23,25,30,0,0,0,105,20060113
2006,BOS,30,35,20,16,8,12,3,124,PHI,34,23,18,26,8,12,4,125,20060113
2006,ORL,31,30,22,25,0,0,0,108,POR,32,29,25,27,0,0,0,113,20060113
2006,MIA,32,39,22,24,0,0,0,117,SEA,38,18,22,26,0,0,0,104,20060113
2006,WAS,20,21,35,23,15,0,0,114,ATL,17,23,35,24,7,0,0,106,20060114
2006,IND,20,23,28,20,0,0,0,91,CHI,32,19,17,21,0,0,0,89,20060114
2006,NJN,19,25,13,20,0,0,0,77,DAL,32,35,26,17,0,0,0,110,20060114
2006,CHA,21,22,27,21,0,0,0,91,DET,30,30,23,31,0,0,0,114,20060114
2006,LAL,34,25,25,26,0,0,0,110,GSW,28,32,25,19,0,0,0,104,20060114
2006,NOK,18,13,28,27,0,0,0,86,HOU,13,23,24,20,0,0,0,80,20060114
2006,SEA,19,21,18,14,0,0,0,72,LAC,23,27,26,22,0,0,0,98,20060114
2006,DEN,25,27,20,28,0,0,0,100,MIL,19,16,30,28,0,0,0,93,20060114
2006,CLE,31,26,21,28,0,0,0,106,PHO,33,26,25,31,0,0,0,115,20060114
2006,MEM,20,13,21,25,0,0,0,79,SAS,21,23,17,19,0,0,0,80,20060114
2006,MIA,26,22,25,27,0,0,0,100,UTA,28,22,20,24,0,0,0,94,20060114
2006,CLE,30,16,21,20,0,0,0,87,POR,27,24,20,18,0,0,0,89,20060115
2006,ORL,22,20,20,38,0,0,0,100,SAC,21,25,28,30,0,0,0,104,20060115
2006,NYK,26,27,26,24,0,0,0,103,TOR,35,31,31,32,0,0,0,129,20060115
2006,HOU,21,18,26,18,0,0,0,83,ATL,20,29,22,23,0,0,0,94,20060116
2006,NOK,25,41,22,19,0,0,0,107,CHA,25,20,24,23,0,0,0,92,20060116
2006,DEN,22,21,34,20,0,0,0,97,CHI,31,22,23,18,0,0,0,94,20060116
2006,MIL,25,20,28,22,0,0,0,95,DAL,27,31,31,25,0,0,0,114,20060116
2006,BOS,22,18,25,19,0,0,0,84,DET,15,26,32,21,0,0,0,94,20060116
2006,SEA,21,25,23,24,0,0,0,93,GSW,27,28,30,24,0,0,0,109,20060116
2006,UTA,18,20,26,23,6,0,0,93,LAC,25,21,26,15,15,0,0,102,20060116
2006,MIA,20,22,26,24,0,0,0,92,LAL,26,31,20,23,0,0,0,100,20060116
2006,SAS,27,14,30,22,0,0,0,93,MEM,19,23,22,19,0,0,0,83,20060116
2006,IND,19,24,22,27,0,0,0,92,NJN,31,27,19,20,0,0,0,97,20060116
2006,MIN,25,27,22,22,0,0,0,96,NYK,23,24,18,25,0,0,0,90,20060116
2006,PHI,24,21,17,14,0,0,0,76,WAS,31,16,35,22,0,0,0,104,20060116
2006,PHO,23,20,22,25,0,0,0,90,SAC,32,33,27,27,0,0,0,119,20060117
2006,TOR,22,25,25,26,0,0,0,98,UTA,27,27,33,24,0,0,0,111,20060117
2006,DET,18,41,23,35,0,0,0,117,ATL,19,21,20,29,0,0,0,89,20060118
2006,MIN,32,23,18,23,0,0,0,96,BOS,22,24,23,34,0,0,0,103,20060118
2006,NYK,20,26,18,28,12,0,0,104,CHI,23,23,19,27,14,0,0,106,20060118
2006,CLE,14,29,27,19,0,0,0,89,DEN,28,20,23,19,0,0,0,90,20060118
2006,DAL,19,30,33,21,0,0,0,103,HOU,14,20,16,26,0,0,0,76,20060118
2006,CHA,29,23,13,27,0,0,0,92,IND,21,27,25,25,0,0,0,98,20060118
2006,PHO,30,37,29,16,0,0,0,112,LAC,24,24,32,22,0,0,0,102,20060118
2006,MEM,20,19,23,17,0,0,0,79,NOK,21,27,14,25,0,0,0,87,20060118
2006,WAS,27,24,18,29,0,0,0,98,ORL,23,21,29,33,0,0,0,106,20060118
2006,NJN,30,18,29,24,0,0,0,101,PHI,20,22,27,21,0,0,0,90,20060118
2006,TOR,24,25,17,28,0,0,0,94,POR,27,25,27,17,0,0,0,96,20060118
2006,MIL,20,20,27,25,0,0,0,92,SAS,20,21,28,26,0,0,0,95,20060118
2006,DET,28,20,26,31,0,0,0,105,NYK,13,20,18,28,0,0,0,79,20060119
2006,LAL,31,21,24,28,5,0,0,109,SAC,27,27,20,30,14,0,0,118,20060119
2006,MIL,20,34,25,39,0,0,0,118,ATL,23,23,23,33,0,0,0,102,20060120
2006,NJN,25,19,30,22,0,0,0,96,BOS,31,22,24,22,0,0,0,99,20060120
2006,ORL,27,28,28,21,0,0,0,104,CHA,21,22,22,28,0,0,0,93,20060120
2006,HOU,14,28,23,25,10,9,0,109,CHI,25,25,20,20,10,8,0,108,20060120
2006,UTA,16,22,20,25,0,0,0,83,DEN,23,36,24,30,0,0,0,113,20060120
2006,CLE,26,17,12,24,0,0,0,79,GSW,26,28,21,24,0,0,0,99,20060120
2006,DAL,37,26,18,20,0,0,0,101,LAC,21,18,26,16,0,0,0,81,20060120
2006,SAS,20,29,25,27,0,0,0,101,MIA,18,20,28,28,0,0,0,94,20060120
2006,IND,17,20,19,29,0,0,0,85,MIN,28,18,21,23,0,0,0,90,20060120
2006,MEM,16,23,29,11,7,0,0,86,PHI,25,22,17,15,10,0,0,89,20060120
2006,LAL,22,21,19,31,0,0,0,93,PHO,21,28,28,29,0,0,0,106,20060120
2006,TOR,30,29,29,33,0,0,0,121,SEA,31,32,25,25,0,0,0,113,20060120
2006,NOK,21,33,20,25,0,0,0,99,WAS,32,26,26,26,0,0,0,110,20060120
2006,CHI,20,30,25,26,0,0,0,101,IND,27,24,13,25,0,0,0,89,20060121
2006,CHA,27,20,18,26,0,0,0,91,MIL,21,23,34,23,0,0,0,101,20060121
2006,BOS,25,18,19,21,0,0,0,83,NJN,31,30,30,12,0,0,0,103,20060121
2006,NOK,33,23,31,22,0,0,0,109,NYK,30,21,20,27,0,0,0,98,20060121
2006,SAC,20,30,9,15,4,0,0,78,ORL,21,18,17,18,9,0,0,83,20060121
2006,CLE,20,25,28,35,0,0,0,108,UTA,28,19,20,23,0,0,0,90,20060121
2006,HOU,26,20,31,20,0,0,0,97,DET,29,26,23,21,0,0,0,99,20060122
2006,GSW,27,25,19,21,0,0,0,92,LAC,37,26,20,22,0,0,0,105,20060122
2006,TOR,36,27,22,19,0,0,0,104,LAL,29,20,42,31,0,0,0,122,20060122
2006,SAC,24,34,26,15,0,0,0,99,MIA,37,23,29,30,0,0,0,119,20060122
2006,PHI,14,17,24,31,0,0,0,86,MIN,22,20,25,17,0,0,0,84,20060122
2006,SEA,35,27,34,30,12,14,0,152,PHO,27,29,35,35,12,11,0,149,20060122
2006,DAL,22,17,26,14,16,0,0,95,POR,15,26,19,19,10,0,0,89,20060122
2006,DEN,22,25,18,24,0,0,0,89,SAS,16,32,18,19,0,0,0,85,20060122
2006,MEM,19,22,30,22,0,0,0,93,WAS,27,17,20,18,0,0,0,82,20060122
2006,IND,24,32,15,23,0,0,0,94,ATL,24,24,27,29,0,0,0,104,20060123
2006,NOK,22,17,16,23,0,0,0,78,BOS,25,17,36,13,0,0,0,91,20060123
2006,TOR,22,32,19,28,0,0,0,101,DEN,26,26,25,30,0,0,0,107,20060123
2006,LAC,25,21,20,30,0,0,0,96,GSW,29,25,22,17,0,0,0,93,20060123
2006,HOU,23,25,26,23,0,0,0,97,MIL,28,19,24,9,0,0,0,80,20060123
2006,NJN,14,14,22,28,0,0,0,78,UTA,22,18,23,26,0,0,0,89,20060123
2006,IND,18,20,13,15,0,0,0,66,CLE,22,20,27,27,0,0,0,96,20060124
2006,MEM,30,17,14,21,0,0,0,82,MIA,29,19,27,19,0,0,0,94,20060124
2006,DET,19,26,33,29,0,0,0,107,MIN,18,28,13,24,0,0,0,83,20060124
2006,PHO,26,27,30,19,0,0,0,102,ORL,25,33,26,27,0,0,0,111,20060124
2006,SAC,21,22,31,29,0,0,0,103,PHI,28,22,31,28,0,0,0,109,20060124
2006,CHA,18,18,17,23,0,0,0,76,SAS,26,25,22,31,0,0,0,104,20060124
2006,CLE,24,32,20,30,0,0,0,106,ATL,32,23,27,15,0,0,0,97,20060125
2006,WAS,19,18,23,29,0,0,0,89,BOS,29,10,23,25,0,0,0,87,20060125
2006,MIL,27,17,21,27,10,0,0,102,DET,24,26,24,18,14,0,0,106,20060125
2006,DAL,18,31,25,28,0,0,0,102,GSW,27,28,23,15,0,0,0,93,20060125
2006,CHA,18,26,14,20,0,0,0,78,HOU,24,27,31,20,0,0,0,102,20060125
2006,NJN,16,16,24,21,0,0,0,77,LAC,27,16,29,18,0,0,0,90,20060125
2006,MIN,14,24,27,22,0,0,0,87,MEM,29,33,20,25,0,0,0,107,20060125
2006,SAS,23,19,24,18,0,0,0,84,NOK,11,21,12,24,0,0,0,68,20060125
2006,SAC,23,25,21,20,17,0,0,106,NYK,27,20,17,25,13,0,0,102,20060125
2006,DEN,27,20,24,26,0,0,0,97,POR,33,23,15,23,0,0,0,94,20060125
2006,CHI,28,28,21,27,0,0,0,104,TOR,16,25,25,22,0,0,0,88,20060125
2006,SEA,28,27,27,31,0,0,0,113,UTA,18,21,25,30,0,0,0,94,20060125
2006,PHO,30,36,24,17,0,0,0,107,MIA,20,27,25,26,0,0,0,98,20060126
2006,ORL,28,28,21,26,16,0,0,119,PHI,32,15,27,29,12,0,0,115,20060126
2006,DAL,21,32,27,24,0,0,0,104,SEA,34,19,23,21,0,0,0,97,20060126
2006,PHO,22,35,23,30,0,0,0,110,ATL,31,19,30,26,0,0,0,106,20060127
2006,SAC,25,18,19,12,0,0,0,74,BOS,24,17,24,19,0,0,0,84,20060127
2006,MIA,14,16,30,31,0,0,0,91,CHA,20,15,25,25,0,0,0,85,20060127
2006,WAS,16,26,15,22,0,0,0,79,CHI,28,19,20,23,0,0,0,90,20060127
2006,LAC,31,25,24,25,0,0,0,105,DEN,26,28,12,21,0,0,0,87,20060127
2006,MEM,24,22,22,21,0,0,0,89,DET,21,23,20,31,0,0,0,95,20060127
2006,MIN,25,29,11,31,0,0,0,96,HOU,27,15,20,30,0,0,0,92,20060127
2006,CLE,27,20,20,26,0,0,0,93,IND,20,23,18,28,0,0,0,89,20060127
2006,GSW,28,19,26,21,11,0,0,105,LAL,31,24,11,28,12,0,0,106,20060127
2006,TOR,24,20,12,31,0,0,0,87,MIL,27,27,25,29,0,0,0,108,20060127
2006,ORL,19,14,25,36,0,0,0,94,NYK,27,27,22,21,0,0,0,97,20060127
2006,NJN,14,20,27,22,0,0,0,83,POR,28,20,22,18,0,0,0,88,20060127
2006,ATL,15,24,33,27,0,0,0,99,CHI,31,31,24,25,0,0,0,111,20060128
2006,UTA,18,24,23,24,0,0,0,89,DAL,25,26,22,30,0,0,0,103,20060128
2006,POR,12,32,23,16,0,0,0,83,GSW,26,29,23,20,0,0,0,98,20060128
2006,DEN,23,18,17,21,0,0,0,79,LAC,28,31,27,26,0,0,0,112,20060128
2006,NOK,20,25,22,28,0,0,0,95,MEM,25,20,20,21,0,0,0,86,20060128
2006,NYK,22,17,19,18,0,0,0,76,PHI,19,34,17,21,0,0,0,91,20060128
2006,MIN,18,24,25,21,0,0,0,88,SAS,19,28,26,29,0,0,0,102,20060128
2006,NJN,27,20,29,28,0,0,0,104,SEA,24,30,29,30,0,0,0,113,20060128
2006,CHA,30,22,21,24,0,0,0,97,WAS,31,26,25,25,0,0,0,107,20060128
2006,PHO,32,28,27,19,0,0,0,106,CLE,22,29,33,29,0,0,0,113,20060129
2006,LAL,16,31,16,30,0,0,0,93,DET,25,31,28,18,0,0,0,102,20060129
2006,MIA,23,22,33,23,0,0,0,101,HOU,16,25,20,34,0,0,0,95,20060129
2006,BOS,16,18,22,23,0,0,0,79,MIL,14,26,17,26,0,0,0,83,20060129
2006,PHI,21,23,21,24,0,0,0,89,ORL,17,28,19,17,0,0,0,81,20060129
2006,SAC,29,26,29,28,11,0,0,123,TOR,28,32,28,24,12,0,0,124,20060129
2006,NYK,29,24,16,32,0,0,0,101,ATL,30,31,31,28,0,0,0,120,20060130
2006,CLE,32,24,27,20,0,0,0,103,CHA,20,19,18,34,0,0,0,91,20060130
2006,HOU,24,15,16,22,0,0,0,77,MEM,21,22,25,18,0,0,0,86,20060130
2006,LAC,33,29,22,30,0,0,0,114,MIA,42,25,19,32,0,0,0,118,20060130
2006,BOS,28,14,21,22,0,0,0,85,MIN,30,31,25,24,0,0,0,110,20060130
2006,MIL,17,22,35,19,0,0,0,93,NOK,21,22,27,24,0,0,0,94,20060130
2006,POR,31,27,26,32,0,0,0,116,SEA,32,25,25,29,0,0,0,111,20060130
2006,SAS,20,19,20,20,0,0,0,79,UTA,22,11,22,15,0,0,0,70,20060130
2006,CHI,18,16,34,26,0,0,0,94,DAL,32,26,20,20,0,0,0,98,20060131
2006,DET,21,21,20,22,0,0,0,84,NJN,22,24,21,24,0,0,0,91,20060131
2006,LAL,31,29,37,33,0,0,0,130,NYK,24,20,28,25,0,0,0,97,20060131
2006,PHO,29,31,27,36,0,0,0,123,PHI,21,24,23,31,0,0,0,99,20060131
2006,DEN,21,22,26,22,0,0,0,91,SAC,18,34,22,24,0,0,0,98,20060131
2006,IND,14,27,13,25,0,0,0,79,WAS,22,26,15,21,0,0,0,84,20060131
2006,PHO,26,33,16,27,0,0,0,102,BOS,16,22,31,25,0,0,0,94,20060201
2006,ATL,25,20,29,28,0,0,0,102,CHA,25,15,23,29,0,0,0,92,20060201
2006,NJN,15,20,27,23,0,0,0,85,CLE,17,17,28,29,0,0,0,91,20060201
2006,MIN,22,15,15,22,0,0,0,74,DET,21,26,23,20,0,0,0,90,20060201
2006,MIL,27,14,25,18,0,0,0,84,HOU,15,34,28,9,0,0,0,86,20060201
2006,LAL,21,16,25,17,0,0,0,79,IND,24,28,30,23,0,0,0,105,20060201
2006,DAL,30,17,12,22,0,0,0,81,MEM,19,26,22,13,0,0,0,80,20060201
2006,CHI,23,19,29,24,0,0,0,95,NOK,22,31,23,24,0,0,0,100,20060201
2006,LAC,25,34,23,24,0,0,0,106,ORL,20,29,24,21,0,0,0,94,20060201
2006,SAS,25,17,20,24,0,0,0,86,POR,17,22,16,27,0,0,0,82,20060201
2006,GSW,38,24,9,36,0,0,0,107,SEA,28,28,29,26,0,0,0,111,20060201
2006,WAS,22,26,21,43,0,0,0,112,TOR,25,25,31,36,0,0,0,117,20060201
2006,DEN,27,27,13,23,0,0,0,90,UTA,34,15,26,28,0,0,0,103,20060201
2006,SAS,21,23,27,18,0,0,0,89,GSW,28,18,26,14,0,0,0,86,20060202
2006,CLE,15,18,31,9,0,0,0,73,MIA,24,28,23,26,0,0,0,101,20060202
2006,ORL,29,21,24,20,0,0,0,94,ATL,25,24,25,22,0,0,0,96,20060203
2006,LAC,26,27,24,21,0,0,0,98,BOS,25,21,20,15,0,0,0,81,20060203
2006,LAL,25,28,31,18,0,0,0,102,CHA,40,21,27,24,0,0,0,112,20060203
2006,SEA,24,19,14,20,0,0,0,77,HOU,21,27,25,27,0,0,0,100,20060203
2006,DET,29,20,19,19,0,0,0,87,PHI,18,24,18,20,0,0,0,80,20060203
2006,MIN,22,21,18,24,0,0,0,85,POR,22,24,19,24,0,0,0,89,20060203
2006,NYK,17,30,24,19,0,0,0,90,TOR,30,34,20,20,0,0,0,104,20060203
2006,SAC,22,23,22,12,0,0,0,79,UTA,18,21,16,34,0,0,0,89,20060203
2006,PHI,23,27,24,26,0,0,0,100,CLE,32,20,17,26,0,0,0,95,20060204
2006,SEA,20,31,23,17,0,0,0,91,DAL,32,22,28,28,0,0,0,110,20060204
2006,POR,30,25,29,20,0,0,0,104,DEN,28,25,23,29,0,0,0,105,20060204
2006,MIN,24,13,22,18,0,0,0,77,GSW,29,27,29,24,0,0,0,109,20060204
2006,DET,23,27,14,21,0,0,0,85,IND,20,31,23,19,0,0,0,93,20060204
2006,MEM,21,21,22,14,0,0,0,78,MIL,33,8,25,22,0,0,0,88,20060204
2006,MIA,24,27,19,22,0,0,0,92,NJN,33,22,22,28,0,0,0,105,20060204
2006,LAL,26,20,23,21,0,0,0,90,NOK,29,29,25,23,0,0,0,106,20060204
2006,BOS,20,22,27,22,0,0,0,91,ORL,31,17,23,29,0,0,0,100,20060204
2006,CHI,25,25,20,31,0,0,0,101,PHO,27,25,38,28,0,0,0,118,20060204
2006,ATL,15,18,38,14,0,0,0,85,WAS,24,22,32,20,0,0,0,98,20060204
2006,HOU,24,21,24,24,0,0,0,93,NYK,20,22,24,23,0,0,0,89,20060205
2006,UTA,25,15,18,20,0,0,0,78,SAC,32,14,19,31,0,0,0,96,20060205
2006,LAC,26,24,27,24,14,0,0,115,TOR,22,35,20,24,12,0,0,113,20060205
2006,SEA,22,32,18,34,0,0,0,106,CHA,34,33,30,22,0,0,0,119,20060206
2006,MIL,15,22,26,23,0,0,0,86,CLE,15,29,22,23,0,0,0,89,20060206
2006,DEN,25,33,15,41,0,0,0,114,GSW,28,24,35,35,0,0,0,122,20060206
2006,BOS,26,15,33,24,0,0,0,98,MIA,32,23,28,31,0,0,0,114,20060206
2006,NOK,20,31,20,20,0,0,0,91,NJN,25,14,29,31,0,0,0,99,20060206
2006,HOU,20,24,22,21,0,0,0,87,PHI,27,9,27,18,0,0,0,81,20060206
2006,MIN,24,30,20,29,0,0,0,103,PHO,28,24,28,21,0,0,0,101,20060206
2006,CHI,28,20,24,21,14,0,0,107,UTA,23,21,27,22,16,0,0,109,20060206
2006,ORL,15,24,23,20,0,0,0,82,WAS,27,23,18,26,0,0,0,94,20060206
2006,DET,34,26,21,17,0,0,0,98,ATL,24,33,20,22,0,0,0,99,20060207
2006,LAL,10,28,30,19,0,0,0,87,DAL,27,22,27,26,0,0,0,102,20060207
2006,LAC,18,18,24,25,0,0,0,85,NYK,19,21,21,21,0,0,0,82,20060207
2006,MEM,23,26,17,30,0,0,0,96,SAC,34,21,19,30,0,0,0,104,20060207
2006,PHI,29,32,17,14,0,0,0,92,CHA,31,18,27,24,0,0,0,100,20060208
2006,CHI,33,25,28,24,0,0,0,110,DEN,20,29,22,36,0,0,0,107,20060208
2006,LAC,25,15,26,21,0,0,0,87,DET,18,30,23,26,0,0,0,97,20060208
2006,LAL,17,27,26,19,0,0,0,89,HOU,17,16,29,16,0,0,0,78,20060208
2006,POR,12,21,15,21,0,0,0,69,IND,28,13,25,35,0,0,0,101,20060208
2006,ORL,22,19,20,18,4,6,0,89,MIL,15,30,17,17,4,11,0,94,20060208
2006,CLE,22,23,31,21,0,0,0,97,MIN,30,20,21,20,0,0,0,91,20060208
2006,NYK,24,16,22,21,0,0,0,83,NJN,24,29,31,12,0,0,0,96,20060208
2006,SEA,20,27,26,29,0,0,0,102,NOK,26,21,30,32,0,0,0,109,20060208
2006,MEM,21,25,29,27,0,0,0,102,PHO,22,42,27,17,0,0,0,108,20060208
2006,SAS,30,24,28,32,11,0,0,125,TOR,21,23,32,38,4,0,0,118,20060208
2006,GSW,35,27,26,36,0,0,0,124,WAS,32,30,29,38,0,0,0,129,20060208
2006,MIA,21,17,25,13,0,0,0,76,DAL,29,22,38,23,0,0,0,112,20060209
2006,CHI,15,17,17,31,0,0,0,80,SAC,24,27,26,21,0,0,0,98,20060209
2006,POR,20,22,19,22,0,0,0,83,BOS,30,22,39,24,0,0,0,115,20060210
2006,TOR,23,13,34,18,0,0,0,88,CHA,11,26,17,19,0,0,0,73,20060210
2006,DAL,21,31,21,31,0,0,0,104,DEN,34,28,30,21,0,0,0,113,20060210
2006,GSW,24,12,39,20,0,0,0,95,IND,32,18,32,25,0,0,0,107,20060210
2006,MEM,27,27,21,12,0,0,0,87,LAC,26,19,22,24,0,0,0,91,20060210
2006,UTA,23,27,25,19,0,0,0,94,MIN,18,21,25,16,0,0,0,80,20060210
2006,SAS,22,17,20,24,0,0,0,83,NJN,16,26,10,21,0,0,0,73,20060210
2006,NYK,32,27,21,20,0,0,0,100,NOK,25,32,30,24,0,0,0,111,20060210
2006,DET,20,18,24,22,0,0,0,84,ORL,18,19,17,19,0,0,0,73,20060210
2006,SAC,21,27,28,28,0,0,0,104,PHO,33,30,30,19,0,0,0,112,20060210
2006,ATL,28,16,34,13,0,0,0,91,SEA,26,26,24,23,0,0,0,99,20060210
2006,CLE,32,19,20,18,0,0,0,89,WAS,28,21,25,27,0,0,0,101,20060210
2006,GSW,29,19,27,24,0,0,0,99,CLE,23,24,24,20,0,0,0,91,20060211
2006,UTA,16,19,23,30,0,0,0,88,HOU,20,27,33,22,0,0,0,102,20060211
2006,MEM,34,18,23,25,0,0,0,100,LAL,27,25,26,21,0,0,0,99,20060211
2006,CHA,25,28,20,20,0,0,0,93,MIL,27,22,25,25,0,0,0,99,20060211
2006,NOK,14,33,29,24,0,0,0,100,MIN,23,30,14,27,0,0,0,94,20060211
2006,ORL,16,29,26,23,0,0,0,94,BOS,28,19,25,30,0,0,0,102,20060212
2006,NYK,22,24,14,23,0,0,0,83,HOU,22,25,22,21,0,0,0,90,20060212
2006,SAS,25,18,19,30,0,0,0,92,IND,21,17,24,26,0,0,0,88,20060212
2006,CHI,29,22,25,21,0,0,0,97,LAC,25,25,17,24,0,0,0,91,20060212
2006,DET,24,35,25,14,0,0,0,98,MIA,24,25,22,29,0,0,0,100,20060212
2006,MIL,20,23,16,20,0,0,0,79,NJN,26,29,17,22,0,0,0,94,20060212
2006,ATL,23,17,21,23,0,0,0,84,SAC,25,23,30,31,0,0,0,109,20060212
2006,DEN,25,28,27,22,18,0,0,120,SEA,20,29,25,28,10,0,0,112,20060212
2006,POR,18,20,21,22,0,0,0,81,TOR,31,21,33,29,0,0,0,114,20060212
2006,PHI,24,22,19,32,0,0,0,97,WAS,22,30,32,23,0,0,0,107,20060212
2006,POR,23,25,16,27,0,0,0,91,CHA,18,23,21,21,0,0,0,83,20060213
2006,SAS,19,25,18,25,0,0,0,87,CLE,18,27,26,30,0,0,0,101,20060213
2006,NYK,25,19,15,13,0,0,0,72,DAL,35,24,23,18,0,0,0,100,20060213
2006,MEM,23,24,11,23,0,0,0,81,GSW,22,18,25,14,0,0,0,79,20060213
2006,UTA,13,19,29,27,0,0,0,88,LAL,21,29,24,20,0,0,0,94,20060213
2006,TOR,27,26,24,21,0,0,0,98,MIN,24,24,22,24,0,0,0,94,20060213
2006,WAS,30,23,21,22,0,0,0,96,NOK,18,18,35,26,0,0,0,97,20060213
2006,SAC,23,17,29,21,15,0,0,105,CHI,26,11,31,22,11,0,0,101,20060214
2006,NJN,20,19,11,21,0,0,0,71,DET,25,20,26,14,0,0,0,85,20060214
2006,HOU,30,31,33,34,0,0,0,128,LAC,30,19,28,20,0,0,0,97,20060214
2006,ORL,21,31,22,19,0,0,0,93,MIA,32,29,23,23,0,0,0,107,20060214
2006,SEA,19,25,20,27,0,0,0,91,MIL,27,32,25,22,0,0,0,106,20060214
2006,CLE,30,20,21,22,9,11,0,113,BOS,23,20,22,28,9,7,0,109,20060215
2006,NJN,31,17,28,19,0,0,0,95,CHA,16,32,25,21,0,0,0,94,20060215
2006,WAS,29,20,23,25,0,0,0,97,DAL,29,27,20,27,0,0,0,103,20060215
2006,PHO,31,32,31,22,0,0,0,116,DEN,21,28,20,32,0,0,0,101,20060215
2006,LAC,19,21,16,25,0,0,0,81,GSW,29,23,20,16,0,0,0,88,20060215
2006,MIL,25,14,19,19,0,0,0,77,IND,23,17,27,21,0,0,0,88,20060215
2006,ATL,23,30,30,31,0,0,0,114,LAL,33,24,27,26,0,0,0,110,20060215
2006,SAC,19,28,18,13,0,0,0,78,MEM,23,19,24,18,0,0,0,84,20060215
2006,SEA,28,22,23,19,0,0,0,92,MIN,28,24,28,22,0,0,0,102,20060215
2006,POR,21,13,23,29,0,0,0,86,NOK,28,24,27,23,0,0,0,102,20060215
2006,TOR,32,17,20,27,0,0,0,96,NYK,23,24,25,26,0,0,0,98,20060215
2006,MIA,31,20,29,30,0,0,0,110,ORL,22,23,14,41,0,0,0,100,20060215
2006,SAS,20,21,24,29,6,0,0,100,PHI,17,26,18,33,9,0,0,103,20060215
2006,PHI,22,24,16,22,0,0,0,84,CHI,38,19,35,25,0,0,0,117,20060216
2006,HOU,18,13,22,22,0,0,0,75,PHO,31,32,35,11,0,0,0,109,20060216
2006,ORL,19,21,23,29,0,0,0,92,CLE,25,21,28,31,0,0,0,105,20060221
2006,LAC,25,25,23,18,0,0,0,91,DAL,31,24,26,12,0,0,0,93,20060221
2006,CHA,31,26,16,11,0,0,0,84,DEN,31,14,30,25,0,0,0,100,20060221
2006,ATL,20,23,20,24,0,0,0,87,DET,23,22,29,23,0,0,0,97,20060221
2006,NOK,21,22,17,15,0,0,0,75,IND,23,27,26,21,0,0,0,97,20060221
2006,POR,21,19,15,27,0,0,0,82,LAL,29,15,23,32,0,0,0,99,20060221
2006,TOR,19,31,21,17,0,0,0,88,MEM,22,21,29,22,0,0,0,94,20060221
2006,NJN,12,22,32,23,0,0,0,89,MIL,24,19,28,14,0,0,0,85,20060221
2006,GSW,17,21,15,24,0,0,0,77,SAC,24,30,27,21,0,0,0,102,20060221
2006,SEA,20,19,25,14,0,0,0,78,SAS,27,19,32,25,0,0,0,103,20060221
2006,BOS,21,22,37,23,0,0,0,103,UTA,26,21,17,19,0,0,0,83,20060221
2006,MIN,32,9,22,15,0,0,0,78,WAS,15,31,24,20,0,0,0,90,20060221
2006,SEA,30,29,27,28,0,0,0,114,ATL,26,35,26,22,0,0,0,109,20060222
2006,MIL,19,33,24,15,0,0,0,91,CHI,28,20,26,23,0,0,0,97,20060222
2006,LAC,27,18,31,26,0,0,0,102,HOU,28,31,21,26,0,0,0,106,20060222
2006,ORL,29,27,14,23,0,0,0,93,NJN,25,21,23,27,0,0,0,96,20060222
2006,UTA,12,23,22,25,0,0,0,82,NOK,23,18,24,11,0,0,0,76,20060222
2006,MIA,26,31,24,22,0,0,0,103,NYK,18,20,24,21,0,0,0,83,20060222
2006,CLE,21,28,31,27,0,0,0,107,PHI,28,31,28,29,0,0,0,116,20060222
2006,BOS,24,20,21,29,0,0,0,94,PHO,31,22,26,24,0,0,0,103,20060222
2006,CHA,29,31,24,26,0,0,0,110,POR,24,31,30,21,0,0,0,106,20060222
2006,MEM,31,25,20,11,0,0,0,87,DAL,22,25,34,16,0,0,0,97,20060223
2006,IND,19,22,18,24,0,0,0,83,DET,23,23,21,21,0,0,0,88,20060223
2006,SAC,22,25,25,13,0,0,0,85,LAL,28,27,22,29,0,0,0,106,20060223
2006,DET,25,25,22,23,0,0,0,95,CHI,18,21,31,17,0,0,0,87,20060224
2006,WAS,31,20,25,26,0,0,0,102,CLE,22,32,18,22,0,0,0,94,20060224
2006,GSW,21,24,23,20,0,0,0,88,HOU,23,29,24,15,0,0,0,91,20060224
2006,ATL,27,20,28,29,13,0,0,117,IND,22,25,30,27,8,0,0,112,20060224
2006,LAL,14,30,18,21,0,0,0,83,LAC,22,26,33,21,0,0,0,102,20060224
2006,SAS,12,23,22,26,0,0,0,83,MEM,23,15,11,31,0,0,0,80,20060224
2006,PHI,30,34,30,22,0,0,0,116,MIL,28,24,28,31,0,0,0,111,20060224
2006,DEN,28,21,26,13,14,0,0,102,MIN,22,28,17,21,13,0,0,101,20060224
2006,NJN,25,19,29,21,0,0,0,94,NYK,15,20,20,35,0,0,0,90,20060224
2006,SEA,17,32,22,18,0,0,0,89,ORL,27,31,18,26,0,0,0,102,20060224
2006,BOS,25,25,28,24,0,0,0,102,POR,23,29,21,23,0,0,0,96,20060224
2006,MIL,22,24,21,32,0,0,0,99,ATL,30,21,17,21,0,0,0,89,20060225
2006,TOR,32,35,24,14,8,0,0,113,DAL,22,29,23,31,10,0,0,115,20060225
2006,SEA,27,26,35,18,0,0,0,106,MIA,39,29,25,22,0,0,0,115,20060225
2006,CHI,29,30,15,28,0,0,0,102,PHI,28,29,24,27,0,0,0,108,20060225
2006,CHA,37,37,28,19,0,0,0,121,PHO,37,31,40,28,0,0,0,136,20060225
2006,GSW,14,21,22,18,0,0,0,75,SAS,28,26,20,18,0,0,0,92,20060225
2006,NOK,26,31,25,18,0,0,0,100,UTA,23,29,20,23,0,0,0,95,20060225
2006,NYK,27,18,21,23,0,0,0,89,WAS,38,33,22,17,0,0,0,110,20060225
2006,CLE,17,16,19,26,0,0,0,78,DET,25,19,23,23,0,0,0,90,20060226
2006,BOS,24,30,37,21,0,0,0,112,LAL,25,33,24,29,0,0,0,111,20060226
2006,MEM,24,30,18,27,0,0,0,99,MIN,30,28,23,24,0,0,0,105,20060226
2006,IND,21,36,18,26,0,0,0,101,NJN,22,22,26,21,0,0,0,91,20060226
2006,HOU,22,22,23,22,0,0,0,89,ORL,17,22,13,32,0,0,0,84,20060226
2006,NOK,16,27,18,27,0,0,0,88,POR,21,22,18,14,0,0,0,75,20060226
2006,NJN,24,13,33,24,8,0,0,102,ATL,22,24,27,21,10,0,0,104,20060227
2006,DET,23,21,20,20,0,0,0,84,CLE,19,23,21,9,0,0,0,72,20060227
2006,PHI,20,25,24,23,0,0,0,92,DAL,37,18,29,20,0,0,0,104,20060227
2006,MIL,34,35,20,21,0,0,0,110,DEN,28,17,26,18,0,0,0,89,20060227
2006,UTA,20,29,27,29,12,0,0,117,GSW,20,19,31,35,3,0,0,108,20060227
2006,PHO,19,33,30,29,0,0,0,111,HOU,25,24,23,22,0,0,0,94,20060227
2006,CHA,25,19,19,24,0,0,0,87,LAC,29,30,20,16,0,0,0,95,20060227
2006,WAS,32,20,22,24,0,0,0,98,MEM,23,18,38,29,0,0,0,108,20060227
2006,TOR,31,18,28,17,0,0,0,94,MIA,21,32,21,27,0,0,0,101,20060227
2006,POR,26,19,20,26,0,0,0,91,SAC,30,30,28,27,0,0,0,115,20060227
2006,NYK,23,29,18,23,0,0,0,93,SAS,36,25,39,21,0,0,0,121,20060227
2006,MIN,26,23,21,30,0,0,0,100,CHI,31,23,30,27,0,0,0,111,20060228
2006,ORL,22,19,23,23,0,0,0,87,LAL,24,20,38,20,0,0,0,102,20060228
2006,NOK,23,27,18,36,0,0,0,104,SEA,25,35,29,25,0,0,0,114,20060228
2006,MIA,26,20,27,30,0,0,0,103,BOS,28,20,20,28,0,0,0,96,20060301
2006,SAC,18,25,35,19,0,0,0,97,CLE,29,18,26,17,0,0,0,90,20060301
2006,DET,30,26,16,15,0,0,0,87,DEN,24,31,27,16,0,0,0,98,20060301
2006,ORL,24,26,20,24,0,0,0,94,GSW,26,22,16,34,0,0,0,98,20060301
2006,PHI,22,25,26,33,0,0,0,106,HOU,21,24,32,24,0,0,0,101,20060301
2006,NOK,30,21,8,8,0,0,0,67,LAC,25,22,21,21,0,0,0,89,20060301
2006,NYK,24,25,23,27,0,0,0,99,MEM,20,27,27,27,0,0,0,101,20060301
2006,NJN,23,22,22,23,0,0,0,90,MIN,22,32,18,28,0,0,0,100,20060301
2006,MIL,23,27,27,33,0,0,0,110,PHO,28,34,35,26,0,0,0,123,20060301
2006,LAL,21,19,23,30,0,0,0,93,POR,18,29,30,22,0,0,0,99,20060301
2006,ATL,30,20,31,24,8,0,0,113,TOR,24,28,27,26,6,0,0,111,20060301
2006,CHA,28,27,26,23,0,0,0,104,UTA,24,23,20,22,0,0,0,89,20060301
2006,IND,22,22,22,33,0,0,0,99,WAS,30,23,19,21,0,0,0,93,20060301
2006,CLE,26,29,20,17,0,0,0,92,CHI,17,20,23,31,0,0,0,91,20060302
2006,DAL,22,16,26,25,0,0,0,89,SAS,14,22,32,30,0,0,0,98,20060302
2006,SAC,26,24,21,31,0,0,0,102,ATL,24,23,22,24,0,0,0,93,20060303
2006,IND,29,26,23,20,0,0,0,98,BOS,26,26,29,18,0,0,0,99,20060303
2006,CHA,16,21,15,24,0,0,0,76,DAL,18,18,34,20,0,0,0,90,20060303
2006,LAL,30,29,29,18,0,0,0,106,GSW,31,18,21,24,0,0,0,94,20060303
2006,DEN,24,20,20,14,0,0,0,78,HOU,16,30,27,16,0,0,0,89,20060303
2006,CHI,30,22,26,30,0,0,0,108,NYK,27,29,29,16,0,0,0,101,20060303
2006,WAS,23,31,32,27,0,0,0,113,PHI,29,28,31,31,0,0,0,119,20060303
2006,ORL,19,37,40,22,0,0,0,118,PHO,27,31,34,31,0,0,0,123,20060303
2006,DET,21,29,21,27,0,0,0,98,SEA,24,23,22,27,0,0,0,96,20060303
2006,LAC,18,25,26,34,0,0,0,103,UTA,27,26,22,30,0,0,0,105,20060303
2006,ORL,28,21,24,21,0,0,0,94,DEN,33,20,29,28,0,0,0,110,20060304
2006,DET,29,29,20,16,0,0,0,94,LAL,32,19,29,25,0,0,0,105,20060304
2006,ATL,27,21,25,20,0,0,0,93,MIA,15,18,29,33,0,0,0,95,20060304
2006,NYK,34,28,12,29,0,0,0,103,MIL,21,27,24,26,0,0,0,98,20060304
2006,TOR,15,24,30,20,11,0,0,100,NJN,18,25,21,25,16,0,0,105,20060304
2006,POR,24,21,20,16,0,0,0,81,SAS,21,26,22,32,0,0,0,101,20060304
2006,CHI,18,24,18,12,0,0,0,72,CLE,21,19,23,28,0,0,0,91,20060305
2006,PHO,24,27,30,34,0,0,0,115,DAL,31,31,27,18,0,0,0,107,20060305
2006,POR,12,28,22,22,0,0,0,84,HOU,25,14,37,26,0,0,0,102,20060305
2006,MEM,25,26,26,25,0,0,0,102,LAC,30,22,16,18,0,0,0,86,20060305
2006,GSW,20,23,32,15,0,0,0,90,MIN,26,24,23,30,0,0,0,103,20060305
2006,IND,20,25,32,17,0,0,0,94,PHI,18,28,25,22,0,0,0,93,20060305
2006,UTA,21,26,21,13,0,0,0,81,SEA,27,34,30,22,0,0,0,113,20060305
2006,BOS,29,23,25,28,0,0,0,105,TOR,31,20,31,29,0,0,0,111,20060305
2006,SAC,28,18,31,30,0,0,0,107,WAS,33,25,28,31,0,0,0,117,20060305
2006,MIA,24,28,15,31,8,0,0,106,CHA,35,24,16,23,7,0,0,105,20060306
2006,MEM,17,23,27,34,0,0,0,101,DEN,25,32,32,26,0,0,0,115,20060306
2006,SAS,21,22,36,24,0,0,0,103,LAL,27,18,19,32,0,0,0,96,20060306
2006,SAC,26,32,27,24,0,0,0,109,NJN,26,22,20,16,0,0,0,84,20060306
2006,PHO,30,19,22,30,0,0,0,101,NOK,33,28,18,9,0,0,0,88,20060306
2006,ORL,15,22,26,22,0,0,0,85,UTA,25,22,31,12,0,0,0,90,20060306
2006,GSW,32,22,26,26,0,0,0,106,ATL,24,28,27,34,0,0,0,113,20060307
2006,NJN,12,32,22,21,0,0,0,87,CHI,24,18,26,27,0,0,0,95,20060307
2006,TOR,26,27,23,23,0,0,0,99,CLE,31,28,27,20,0,0,0,106,20060307
2006,POR,23,20,19,25,0,0,0,87,DAL,17,20,23,33,0,0,0,93,20060307
2006,NYK,12,32,31,32,0,0,0,107,IND,18,27,27,20,0,0,0,92,20060307
2006,SAS,21,22,16,26,0,0,0,85,LAC,19,23,27,29,0,0,0,98,20060307
2006,HOU,16,20,25,32,0,0,0,93,MIN,25,13,29,20,0,0,0,87,20060307
2006,BOS,26,31,23,24,12,0,0,116,WAS,25,29,36,14,11,0,0,115,20060307
2006,PHI,26,24,21,30,0,0,0,101,BOS,31,13,26,34,0,0,0,104,20060308
2006,GSW,30,34,17,20,0,0,0,101,CHA,34,21,21,28,0,0,0,104,20060308
2006,CHI,24,24,16,37,0,0,0,101,DET,17,24,27,38,0,0,0,106,20060308
2006,IND,31,29,28,11,0,0,0,99,HOU,27,24,28,24,0,0,0,103,20060308
2006,WAS,22,35,34,21,0,0,0,112,MIA,26,26,34,32,0,0,0,118,20060308
2006,SAC,35,34,21,33,0,0,0,123,MIL,33,24,25,34,0,0,0,116,20060308
2006,LAL,28,30,23,32,0,0,0,113,NOK,24,28,28,27,0,0,0,107,20060308
2006,MEM,25,19,31,24,0,0,0,99,SEA,16,21,19,18,0,0,0,74,20060308
2006,CLE,19,31,20,28,0,0,0,98,TOR,28,14,31,24,0,0,0,97,20060308
2006,MIN,24,26,18,25,0,0,0,93,UTA,24,25,21,26,0,0,0,96,20060308
2006,DEN,23,22,27,25,0,0,0,97,PHI,22,32,25,14,0,0,0,93,20060309
2006,SAS,38,26,25,28,0,0,0,117,PHO,29,21,21,22,0,0,0,93,20060309
2006,DAL,25,29,25,30,0,0,0,109,POR,19,21,23,29,0,0,0,92,20060309
2006,MIL,20,19,29,24,0,0,0,92,BOS,24,22,24,16,0,0,0,86,20060310
2006,LAC,21,26,28,32,0,0,0,107,CHI,22,23,25,26,0,0,0,96,20060310
2006,GSW,29,26,29,27,0,0,0,111,MIA,21,32,28,25,0,0,0,106,20060310
2006,IND,28,28,19,17,0,0,0,92,NOK,24,24,26,16,0,0,0,90,20060310
2006,CLE,28,16,16,13,0,0,0,73,ORL,21,32,23,26,0,0,0,102,20060310
2006,MEM,26,24,18,25,0,0,0,93,SAC,24,25,29,27,0,0,0,105,20060310
2006,LAL,22,29,23,26,0,0,0,100,SAS,24,13,23,32,0,0,0,92,20060310
2006,MIN,26,29,19,22,0,0,0,96,SEA,22,26,24,35,0,0,0,107,20060310
2006,DEN,25,25,26,32,0,0,0,108,TOR,26,21,21,29,0,0,0,97,20060310
2006,CHI,27,20,26,22,0,0,0,95,ATL,20,19,24,27,0,0,0,90,20060311
2006,NYK,25,33,24,27,0,0,0,109,CHA,33,27,35,21,0,0,0,116,20060311
2006,LAC,27,30,19,30,0,0,0,106,MIL,20,25,27,26,0,0,0,98,20060311
2006,GSW,28,19,20,25,0,0,0,92,ORL,30,26,26,21,0,0,0,103,20060311
2006,MIN,29,25,22,26,0,0,0,102,PHO,28,20,30,32,0,0,0,110,20060311
2006,DAL,29,22,17,22,0,0,0,90,UTA,19,21,23,24,0,0,0,87,20060311
2006,DET,28,25,23,16,0,0,0,92,WAS,28,31,33,18,0,0,0,110,20060311
2006,DEN,30,28,28,15,0,0,0,101,BOS,29,27,30,20,0,0,0,106,20060312
2006,CHA,19,20,23,16,0,0,0,78,DET,21,29,26,18,0,0,0,94,20060312
2006,SEA,34,30,25,31,0,0,0,120,LAL,31,24,30,28,0,0,0,113,20060312
2006,PHI,26,24,20,24,0,0,0,94,MEM,17,27,29,18,0,0,0,91,20060312
2006,CLE,27,24,21,20,0,0,0,92,MIA,20,26,19,33,0,0,0,98,20060312
2006,NJN,24,22,24,25,0,0,0,95,NOK,17,21,19,27,0,0,0,84,20060312
2006,PHO,23,23,33,22,0,0,0,101,POR,22,28,30,31,0,0,0,111,20060312
2006,DAL,23,20,17,20,0,0,0,80,SAC,22,30,11,22,0,0,0,85,20060312
2006,HOU,22,20,11,28,0,0,0,81,SAS,25,13,26,24,0,0,0,88,20060312
2006,IND,23,28,24,14,0,0,0,89,TOR,23,21,29,20,0,0,0,93,20060312
2006,NJN,20,27,21,22,0,0,0,90,HOU,26,15,14,22,0,0,0,77,20060313
2006,ORL,23,15,24,21,0,0,0,83,IND,24,20,22,31,0,0,0,97,20060313
2006,MIN,23,31,18,15,0,0,0,87,LAC,24,24,21,26,0,0,0,95,20060313
2006,ATL,18,24,22,23,0,0,0,87,MIL,25,21,30,12,0,0,0,88,20060313
2006,DEN,29,32,25,22,0,0,0,108,NYK,28,28,15,25,0,0,0,96,20060313
2006,WAS,26,33,31,29,0,0,0,119,CHA,24,25,34,31,0,0,0,114,20060314
2006,POR,18,19,12,17,0,0,0,66,CHI,24,22,28,21,0,0,0,95,20060314
2006,CLE,22,31,8,26,0,0,0,87,DAL,19,15,27,30,0,0,0,91,20060314
2006,BOS,16,18,20,22,0,0,0,76,MEM,23,27,22,21,0,0,0,93,20060314
2006,UTA,14,26,22,21,0,0,0,83,MIA,41,21,39,20,0,0,0,121,20060314
2006,TOR,28,26,24,33,0,0,0,111,PHI,30,23,32,12,0,0,0,97,20060314
2006,LAL,31,19,28,20,0,0,0,98,SAC,24,30,29,31,0,0,0,114,20060314
2006,NOK,26,18,21,16,0,0,0,81,SAS,31,26,22,17,0,0,0,96,20060314
2006,PHO,36,31,35,27,0,0,0,129,SEA,28,33,29,30,0,0,0,120,20060314
2006,DAL,28,29,22,16,0,0,0,95,HOU,19,26,19,17,0,0,0,81,20060315
2006,DEN,32,29,21,19,0,0,0,101,IND,21,26,27,25,0,0,0,99,20060315
2006,MIN,26,20,17,26,0,0,0,89,LAL,17,23,27,25,0,0,0,92,20060315
2006,CHI,18,24,24,22,0,0,0,88,MIL,32,27,20,25,0,0,0,104,20060315
2006,POR,24,16,20,5,0,0,0,65,NJN,23,19,15,21,0,0,0,78,20060315
2006,ATL,15,24,34,24,12,8,0,117,NYK,22,22,21,32,12,12,0,121,20060315
2006,UTA,14,30,30,25,9,0,0,108,ORL,23,22,33,21,15,0,0,114,20060315
2006,LAC,22,32,17,24,0,0,0,95,PHO,36,37,27,26,0,0,0,126,20060315
2006,DET,27,28,22,28,0,0,0,105,TOR,22,25,22,29,0,0,0,98,20060315
2006,CHA,11,31,30,27,0,0,0,99,WAS,27,23,30,27,0,0,0,107,20060315
2006,MIN,32,23,14,28,0,0,0,97,GSW,25,27,23,30,0,0,0,105,20060316
2006,BOS,38,25,16,25,0,0,0,104,MIA,24,21,30,32,0,0,0,107,20060316
2006,PHI,30,23,26,19,0,0,0,98,SEA,28,22,23,29,0,0,0,102,20060316
2006,UTA,31,24,30,26,0,0,0,111,ATL,35,19,24,23,0,0,0,101,20060317
2006,POR,22,21,19,22,0,0,0,84,CLE,25,28,26,20,0,0,0,99,20060317
2006,SAC,36,16,24,17,0,0,0,93,IND,20,21,34,23,0,0,0,98,20060317
2006,PHI,21,23,22,23,0,0,0,89,LAC,27,25,30,17,0,0,0,99,20060317
2006,DEN,29,28,24,21,0,0,0,102,MEM,31,34,31,20,0,0,0,116,20060317
2006,LAL,23,25,16,25,0,0,0,89,NJN,25,18,26,23,0,0,0,92,20060317
2006,DET,29,27,17,30,0,0,0,103,NYK,26,23,24,32,0,0,0,105,20060317
2006,BOS,20,17,24,16,0,0,0,77,ORL,20,22,17,25,0,0,0,84,20060317
2006,PHO,25,31,22,24,0,0,0,102,SAS,26,29,27,26,0,0,0,108,20060317
2006,MIL,27,22,28,19,0,0,0,96,TOR,27,19,20,31,0,0,0,97,20060317
2006,DAL,27,25,29,23,0,0,0,104,WAS,24,26,19,25,0,0,0,94,20060317
2006,DET,29,23,37,19,0,0,0,108,CHA,23,32,29,19,0,0,0,103,20060318
2006,MIA,28,20,21,16,0,0,0,85,CHI,24,23,21,16,0,0,0,84,20060318
2006,SAS,11,28,21,32,0,0,0,92,HOU,17,16,20,24,0,0,0,77,20060318
2006,POR,22,26,26,19,0,0,0,93,MIL,27,23,25,22,0,0,0,97,20060318
2006,DEN,34,24,24,27,0,0,0,109,NOK,16,26,22,30,0,0,0,94,20060318
2006,ORL,32,26,16,22,11,0,0,107,ATL,28,30,20,18,12,0,0,108,20060319
2006,LAL,30,33,18,14,0,0,0,95,CLE,18,31,21,26,0,0,0,96,20060319
2006,PHI,25,21,21,22,0,0,0,89,GSW,27,22,22,27,0,0,0,98,20060319
2006,BOS,24,29,19,31,0,0,0,103,IND,36,17,18,17,0,0,0,88,20060319
2006,UTA,25,20,17,22,0,0,0,84,MEM,16,18,33,23,0,0,0,90,20060319
2006,SAC,19,16,29,25,0,0,0,89,MIN,19,21,27,28,0,0,0,95,20060319
2006,DAL,10,22,29,28,0,0,0,89,NJN,29,24,24,23,0,0,0,100,20060319
2006,MIA,29,20,29,33,0,0,0,111,NYK,23,23,23,31,0,0,0,100,20060319
2006,CHI,19,21,32,32,0,0,0,104,WAS,29,31,29,24,0,0,0,113,20060319
2006,LAL,32,24,26,23,0,0,0,105,BOS,26,14,34,23,0,0,0,97,20060320
2006,ATL,20,14,26,24,0,0,0,84,DET,30,23,19,19,0,0,0,91,20060320
2006,LAC,24,22,27,26,0,0,0,99,HOU,28,17,25,21,0,0,0,91,20060320
2006,MIL,23,28,31,18,0,0,0,100,POR,24,27,16,26,0,0,0,93,20060320
2006,ORL,26,25,28,23,0,0,0,102,CHA,32,37,16,23,0,0,0,108,20060321
2006,HOU,20,14,22,16,0,0,0,72,DAL,20,31,21,16,0,0,0,88,20060321
2006,IND,22,14,24,15,0,0,0,75,MEM,22,28,34,21,0,0,0,105,20060321
2006,MIA,30,27,13,26,0,0,0,96,MIN,22,28,32,18,0,0,0,100,20060321
2006,LAC,23,26,33,26,0,0,0,108,NOK,33,30,27,30,0,0,0,120,20060321
2006,TOR,23,32,31,28,0,0,0,114,NYK,22,31,23,33,0,0,0,109,20060321
2006,SEA,29,31,22,14,0,0,0,96,SAC,23,35,30,17,0,0,0,105,20060321
2006,GSW,23,24,23,26,0,0,0,96,SAS,25,26,21,35,0,0,0,107,20060321
2006,PHO,28,31,21,19,0,0,0,99,UTA,26,21,36,24,0,0,0,107,20060321
2006,NJN,27,20,24,41,0,0,0,112,WAS,22,23,25,30,0,0,0,100,20060321
2006,TOR,27,25,25,19,0,0,0,96,BOS,30,31,20,29,0,0,0,110,20060322
2006,CHA,22,24,32,26,14,0,0,118,CLE,34,21,25,24,16,0,0,120,20060322
2006,SAS,20,21,30,21,0,0,0,92,DEN,24,31,17,32,0,0,0,104,20060322
2006,MIA,21,22,16,14,0,0,0,73,DET,19,16,25,22,0,0,0,82,20060322
2006,CHI,27,21,22,15,0,0,0,85,IND,14,27,26,28,0,0,0,95,20060322
2006,SAC,14,26,18,22,0,0,0,80,LAL,30,23,19,15,0,0,0,87,20060322
2006,NYK,17,30,22,18,0,0,0,87,ORL,29,30,33,19,0,0,0,111,20060322
2006,ATL,24,24,26,32,0,0,0,106,PHI,32,35,29,19,0,0,0,115,20060322
2006,MIL,24,30,21,30,0,0,0,105,SEA,28,27,28,31,0,0,0,114,20060322
2006,GSW,26,31,35,30,0,0,0,122,DAL,28,26,31,36,0,0,0,121,20060323
2006,LAC,18,18,19,30,0,0,0,85,MEM,26,17,22,30,0,0,0,95,20060323
2006,MIN,29,21,16,16,0,0,0,82,NJN,20,20,24,22,0,0,0,86,20060323
2006,HOU,22,23,26,22,0,0,0,93,NOK,23,31,10,28,0,0,0,92,20060323
2006,POR,34,29,15,30,0,0,0,108,PHO,40,36,24,25,0,0,0,125,20060323
2006,WAS,24,26,28,31,0,0,0,109,UTA,23,18,26,30,0,0,0,97,20060323
2006,NOK,28,18,19,17,0,0,0,82,CHI,15,35,19,27,0,0,0,96,20060324
2006,BOS,21,17,21,23,0,0,0,82,CLE,16,22,20,36,0,0,0,94,20060324
2006,SEA,27,28,24,25,0,0,0,104,DEN,27,30,32,28,0,0,0,117,20060324
2006,DET,15,27,18,15,0,0,0,75,IND,20,16,13,23,0,0,0,72,20060324
2006,MIL,22,35,16,23,0,0,0,96,LAL,35,18,26,22,0,0,0,101,20060324
2006,CHA,28,20,20,25,0,0,0,93,MIA,33,31,28,22,0,0,0,114,20060324
2006,MEM,22,25,23,21,0,0,0,91,NYK,18,13,17,27,0,0,0,75,20060324
2006,ORL,25,25,23,29,0,0,0,102,PHI,19,22,21,24,0,0,0,86,20060324
2006,SAS,15,36,19,28,0,0,0,98,POR,13,22,23,21,0,0,0,79,20060324
2006,MIN,8,27,26,16,0,0,0,77,TOR,24,30,25,18,0,0,0,97,20060324
2006,DAL,24,27,25,22,0,0,0,98,ATL,10,25,26,22,0,0,0,83,20060325
2006,WAS,20,27,24,30,0,0,0,101,LAC,32,31,31,22,0,0,0,116,20060325
2006,DEN,27,21,27,21,0,0,0,96,PHO,30,27,22,28,0,0,0,107,20060325
2006,SAC,29,18,24,20,0,0,0,91,UTA,19,27,20,23,0,0,0,89,20060325
2006,CHI,25,21,22,33,0,0,0,101,BOS,31,22,25,19,0,0,0,97,20060326
2006,NJN,23,15,18,23,0,0,0,79,DET,10,25,21,18,0,0,0,74,20060326
2006,CLE,21,24,19,27,13,0,0,104,HOU,22,25,20,24,11,0,0,102,20060326
2006,PHI,25,20,12,22,0,0,0,79,IND,23,29,24,16,0,0,0,92,20060326
2006,NOK,29,31,15,19,0,0,0,94,LAL,28,34,21,22,0,0,0,105,20060326
2006,CHA,19,24,29,23,0,0,0,95,MEM,27,20,26,29,0,0,0,102,20060326
2006,TOR,22,32,32,23,7,0,0,116,MIL,27,30,26,26,16,0,0,125,20060326
2006,NYK,14,21,26,33,0,0,0,94,MIN,30,25,25,18,0,0,0,98,20060326
2006,ATL,23,19,24,35,0,0,0,101,ORL,25,24,28,31,0,0,0,108,20060326
2006,LAC,29,19,26,23,0,0,0,97,POR,11,24,14,34,0,0,0,83,20060326
2006,GSW,23,22,24,21,0,0,0,90,SAC,14,26,14,29,0,0,0,83,20060326
2006,SAS,28,18,28,28,0,0,0,102,SEA,20,22,32,32,0,0,0,106,20060326
2006,WAS,27,28,25,36,0,0,0,116,GSW,20,19,30,29,0,0,0,98,20060327
2006,IND,29,24,18,20,0,0,0,91,MIA,28,14,29,25,0,0,0,96,20060327
2006,PHO,18,13,14,27,0,0,0,72,NJN,20,30,33,27,0,0,0,110,20060327
2006,NOK,31,21,16,12,0,0,0,80,UTA,27,28,29,20,0,0,0,104,20060327
2006,ATL,31,29,33,24,0,0,0,117,CHA,35,30,28,32,0,0,0,125,20060328
2006,ORL,27,22,24,24,0,0,0,97,CHI,33,24,25,11,0,0,0,93,20060328
2006,DAL,24,26,19,21,0,0,0,90,DET,23,29,20,25,0,0,0,97,20060328
2006,SAS,25,23,23,27,0,0,0,98,LAC,19,23,19,26,0,0,0,87,20060328
2006,SEA,28,31,17,22,0,0,0,98,MEM,27,22,31,17,0,0,0,97,20060328
2006,PHO,23,39,26,22,0,0,0,110,MIL,25,33,46,28,0,0,0,132,20060328
2006,WAS,27,25,24,21,0,0,0,97,SAC,20,31,14,19,0,0,0,84,20060328
2006,IND,21,26,22,24,0,0,0,93,ATL,26,18,26,24,0,0,0,94,20060329
2006,DAL,24,25,16,29,0,0,0,94,CLE,22,26,35,24,0,0,0,107,20060329
2006,UTA,33,23,27,32,0,0,0,115,DEN,31,14,30,29,0,0,0,104,20060329
2006,NOK,22,22,22,20,0,0,0,86,GSW,29,16,22,18,0,0,0,85,20060329
2006,SEA,10,22,30,25,0,0,0,87,HOU,29,35,27,24,0,0,0,115,20060329
2006,ORL,26,27,21,17,0,0,0,91,MIN,25,24,29,25,0,0,0,103,20060329
2006,MEM,18,13,21,22,0,0,0,74,NJN,27,23,17,19,0,0,0,86,20060329
2006,BOS,40,31,33,19,0,0,0,123,NYK,28,23,23,24,0,0,0,98,20060329
2006,DET,24,27,24,26,0,0,0,101,PHI,19,26,23,23,0,0,0,91,20060329
2006,SAC,29,29,24,24,0,0,0,106,POR,20,21,24,25,0,0,0,90,20060329
2006,MIA,19,22,24,33,0,0,0,98,TOR,31,26,17,20,0,0,0,94,20060329
2006,PHO,30,28,34,22,0,0,0,114,IND,20,24,34,26,0,0,0,104,20060330
2006,SAS,25,16,35,20,0,0,0,96,LAL,21,19,18,27,0,0,0,85,20060330
2006,NJN,19,25,22,25,0,0,0,91,ATL,27,18,19,24,0,0,0,88,20060331
2006,CHI,33,34,16,30,0,0,0,113,CHA,25,18,27,37,0,0,0,107,20060331
2006,MIN,26,28,22,18,0,0,0,94,DEN,27,28,20,31,0,0,0,106,20060331
2006,MIL,27,32,22,24,0,0,0,105,DET,22,23,33,34,0,0,0,112,20060331
2006,SAC,25,29,16,26,0,0,0,96,GSW,32,13,19,29,0,0,0,93,20060331
2006,WAS,28,22,24,29,0,0,0,103,HOU,30,32,21,22,0,0,0,105,20060331
2006,UTA,19,33,17,22,0,0,0,91,LAC,29,24,29,24,0,0,0,106,20060331
2006,MEM,18,25,29,30,0,0,0,102,NOK,26,18,27,36,0,0,0,107,20060331
2006,PHI,31,22,30,34,0,0,0,117,NYK,33,27,20,32,0,0,0,112,20060331
2006,DAL,27,17,26,29,0,0,0,99,ORL,29,27,31,21,0,0,0,108,20060331
2006,LAL,23,29,29,25,0,0,0,106,SEA,28,28,17,20,0,0,0,93,20060331
2006,PHO,39,31,34,36,0,0,0,140,TOR,28,32,37,29,0,0,0,126,20060331
2006,BOS,28,27,19,20,0,0,0,94,CHI,19,28,27,26,0,0,0,100,20060401
2006,MIA,24,29,20,26,0,0,0,99,CLE,26,18,25,37,0,0,0,106,20060401
2006,IND,21,26,25,17,0,0,0,89,MIL,19,22,33,22,0,0,0,96,20060401
2006,UTA,25,29,27,21,0,0,0,102,POR,22,19,29,19,0,0,0,89,20060401
2006,WAS,17,16,39,27,0,0,0,99,SAS,19,21,27,39,0,0,0,106,20060401
2006,CLE,28,25,23,25,0,0,0,101,CHA,23,26,21,27,0,0,0,97,20060402
2006,DEN,18,22,18,21,0,0,0,79,DAL,29,15,29,30,0,0,0,103,20060402
2006,PHO,29,34,21,18,0,0,0,102,DET,22,27,32,28,0,0,0,109,20060402
2006,HOU,29,23,18,18,0,0,0,88,LAL,27,24,37,16,0,0,0,104,20060402
2006,ATL,16,26,18,27,0,0,0,87,MEM,26,23,29,20,0,0,0,98,20060402
2006,GSW,32,19,18,23,12,0,0,104,MIN,21,33,18,20,14,0,0,106,20060402
2006,MIA,18,21,19,20,0,0,0,78,NJN,19,23,32,16,0,0,0,90,20060402
2006,NYK,26,24,26,19,0,0,0,95,PHI,31,30,28,25,0,0,0,114,20060402
2006,LAC,18,25,35,18,0,0,0,96,SAC,30,22,31,23,0,0,0,106,20060402
2006,POR,19,16,20,28,0,0,0,83,SEA,34,33,24,31,0,0,0,122,20060402
2006,NOK,25,28,27,15,5,20,0,120,TOR,19,23,30,23,5,13,0,113,20060402
2006,MIN,22,25,24,21,0,0,0,92,CHA,25,28,17,27,0,0,0,97,20060404
2006,IND,25,30,26,15,0,0,0,96,CHI,32,22,17,31,0,0,0,102,20060404
2006,PHI,26,24,30,11,0,0,0,91,CLE,30,39,30,25,0,0,0,124,20060404
2006,SAC,22,19,35,25,0,0,0,101,DAL,26,37,38,26,0,0,0,127,20060404
2006,NOK,23,23,18,29,0,0,0,93,DET,26,26,25,24,0,0,0,101,20060404
2006,DEN,38,39,16,16,0,0,0,109,LAC,29,28,31,23,0,0,0,111,20060404
2006,GSW,20,9,26,20,0,0,0,75,MEM,22,27,26,25,0,0,0,100,20060404
2006,MIL,14,29,26,20,0,0,0,89,MIA,31,24,34,26,0,0,0,115,20060404
2006,ATL,15,22,20,37,0,0,0,94,NJN,23,22,33,18,0,0,0,96,20060404
2006,HOU,21,20,25,21,0,0,0,87,SEA,32,24,22,26,0,0,0,104,20060404
2006,BOS,31,32,26,35,0,0,0,124,TOR,31,30,29,30,0,0,0,120,20060404
2006,SAS,37,13,22,23,0,0,0,95,UTA,21,11,30,24,0,0,0,86,20060404
2006,NYK,19,20,24,27,0,0,0,90,WAS,30,31,24,20,0,0,0,105,20060404
2006,MIN,32,8,27,32,0,0,0,99,ATL,19,28,18,36,0,0,0,101,20060405
2006,WAS,32,22,25,29,0,0,0,108,BOS,26,24,28,13,0,0,0,91,20060405
2006,TOR,21,29,31,22,0,0,0,103,IND,29,25,32,25,0,0,0,111,20060405
2006,GSW,24,26,32,21,6,0,0,109,NOK,27,28,27,21,11,0,0,114,20060405
2006,CLE,14,23,20,37,0,0,0,94,NYK,22,26,26,22,0,0,0,96,20060405
2006,MIL,22,20,28,35,0,0,0,105,ORL,27,23,28,30,0,0,0,108,20060405
2006,CHI,32,16,23,28,0,0,0,99,PHI,18,25,17,32,0,0,0,92,20060405
2006,LAC,29,30,29,31,0,0,0,119,PHO,35,20,16,34,0,0,0,105,20060405
2006,HOU,17,22,23,13,0,0,0,75,POR,17,26,16,17,0,0,0,76,20060405
2006,SAC,26,30,25,16,0,0,0,97,SAS,22,21,22,22,0,0,0,87,20060405
2006,LAL,23,26,28,22,9,0,0,108,DEN,39,19,27,14,11,0,0,110,20060406
2006,DET,20,22,28,25,0,0,0,95,MIA,21,20,20,21,0,0,0,82,20060406
2006,CHA,25,26,23,28,0,0,0,102,NJN,33,18,34,28,0,0,0,113,20060406
2006,WAS,32,21,22,26,0,0,0,101,ATL,28,27,25,34,0,0,0,114,20060407
2006,HOU,25,30,18,27,0,0,0,100,GSW,19,26,31,17,0,0,0,93,20060407
2006,SAC,21,23,28,24,0,0,0,96,LAC,25,25,19,24,0,0,0,93,20060407
2006,MIL,27,18,27,18,0,0,0,90,MEM,24,34,21,21,0,0,0,100,20060407
2006,UTA,22,28,29,24,0,0,0,103,MIN,19,23,34,19,0,0,0,95,20060407
2006,TOR,19,28,19,23,0,0,0,89,NOK,29,24,21,21,0,0,0,95,20060407
2006,IND,18,28,26,24,0,0,0,96,NYK,21,28,19,30,0,0,0,98,20060407
2006,DET,23,16,27,21,0,0,0,87,ORL,27,27,13,22,0,0,0,89,20060407
2006,BOS,30,25,26,28,0,0,0,109,PHI,34,25,17,23,0,0,0,99,20060407
2006,LAL,27,25,27,17,0,0,0,96,PHO,31,33,16,27,0,0,0,107,20060407
2006,SEA,26,32,30,33,0,0,0,121,POR,29,23,21,35,0,0,0,108,20060407
2006,DAL,26,25,20,21,0,0,0,92,SAS,27,26,12,21,0,0,0,86,20060407
2006,PHI,25,22,25,17,0,0,0,89,CHI,21,16,12,26,0,0,0,75,20060408
2006,NOK,19,20,21,17,0,0,0,77,DAL,29,27,22,23,0,0,0,101,20060408
2006,GSW,20,20,28,24,0,0,0,92,DEN,26,26,19,24,0,0,0,95,20060408
2006,CLE,27,24,21,36,0,0,0,108,NJN,26,30,22,24,0,0,0,102,20060408
2006,POR,25,25,22,21,0,0,0,93,UTA,32,24,27,27,0,0,0,110,20060408
2006,MIA,19,37,19,24,0,0,0,99,WAS,29,22,12,23,0,0,0,86,20060408
2006,NYK,23,20,27,31,0,0,0,101,BOS,28,24,24,10,0,0,0,86,20060409
2006,IND,20,15,17,21,0,0,0,73,DET,19,26,27,26,0,0,0,98,20060409
2006,LAC,24,21,24,14,0,0,0,83,LAL,20,30,22,28,0,0,0,100,20060409
2006,ORL,27,29,19,18,0,0,0,93,MIA,18,25,23,18,0,0,0,84,20060409
2006,NJN,31,18,27,19,0,0,0,95,MIL,12,30,18,23,0,0,0,83,20060409
2006,ATL,24,18,23,18,0,0,0,83,MIN,24,19,21,20,0,0,0,84,20060409
2006,HOU,16,19,24,18,0,0,0,77,SAC,20,29,15,22,0,0,0,86,20060409
2006,MEM,22,21,22,16,0,0,0,81,SAS,20,23,20,20,0,0,0,83,20060409
2006,PHO,31,25,35,23,0,0,0,114,SEA,28,29,30,29,0,0,0,116,20060409
2006,CHA,23,27,20,24,0,0,0,94,TOR,22,24,20,22,0,0,0,88,20060409
2006,NYK,24,22,16,20,0,0,0,82,IND,24,24,24,29,0,0,0,101,20060410
2006,DAL,17,33,11,14,0,0,0,75,LAC,26,14,13,20,0,0,0,73,20060410
2006,CLE,23,29,29,22,0,0,0,103,NOK,26,37,12,26,0,0,0,101,20060410
2006,ATL,26,21,18,23,0,0,0,88,ORL,21,31,26,27,0,0,0,105,20060410
2006,WAS,19,35,24,19,0,0,0,97,PHI,27,23,27,28,0,0,0,105,20060410
2006,DEN,28,28,28,26,0,0,0,110,POR,19,33,17,29,0,0,0,98,20060410
2006,HOU,17,18,26,22,0,0,0,83,UTA,22,20,28,15,0,0,0,85,20060410
2006,NJN,26,19,23,33,0,0,0,101,CHI,22,26,22,34,0,0,0,104,20060411
2006,GSW,33,23,21,23,0,0,0,100,LAL,23,39,33,16,0,0,0,111,20060411
2006,MIN,13,16,21,26,0,0,0,76,MEM,25,19,24,24,0,0,0,92,20060411
2006,TOR,21,30,26,20,0,0,0,97,MIA,31,30,21,24,0,0,0,106,20060411
2006,PHO,23,28,33,39,0,0,0,123,SAC,30,38,16,26,0,0,0,110,20060411
2006,SEA,22,26,20,27,0,0,0,95,SAS,25,30,26,23,0,0,0,104,20060411
2006,CHI,18,25,27,26,0,0,0,96,ATL,28,15,17,30,0,0,0,90,20060412
2006,MEM,26,21,25,24,0,0,0,96,CHA,22,24,21,21,0,0,0,88,20060412
2006,CLE,19,10,22,22,0,0,0,73,DET,27,29,19,21,0,0,0,96,20060412
2006,DAL,27,22,29,24,0,0,0,102,GSW,19,29,34,32,0,0,0,114,20060412
2006,MIN,12,21,28,21,0,0,0,82,HOU,20,23,26,10,0,0,0,79,20060412
2006,BOS,35,26,25,26,0,0,0,112,IND,38,26,32,21,0,0,0,117,20060412
2006,POR,28,25,17,23,0,0,0,93,LAC,22,30,19,26,0,0,0,97,20060412
2006,WAS,23,22,23,29,0,0,0,97,MIL,24,23,25,28,0,0,0,100,20060412
2006,PHI,33,34,23,26,0,0,0,116,NJN,21,25,27,23,0,0,0,96,20060412
2006,SEA,29,27,21,22,0,0,0,99,NOK,24,34,25,21,0,0,0,104,20060412
2006,TOR,24,31,20,21,0,0,0,96,ORL,30,24,32,17,0,0,0,103,20060412
2006,DEN,21,20,22,20,0,0,0,83,UTA,25,23,23,33,0,0,0,104,20060412
2006,NYK,16,21,30,20,0,0,0,87,CLE,16,25,19,31,0,0,0,91,20060413
2006,DAL,25,20,32,27,0,0,0,104,PHO,36,24,30,27,0,0,0,117,20060413
2006,ORL,27,27,24,14,0,0,0,92,SAS,28,22,19,11,0,0,0,80,20060413
2006,CHA,23,32,34,27,0,0,0,116,ATL,33,20,25,32,0,0,0,110,20060414
2006,NJN,14,11,30,24,0,0,0,79,BOS,18,15,20,21,0,0,0,74,20060414
2006,WAS,28,28,23,22,0,0,0,101,CHI,26,22,27,28,0,0,0,103,20060414
2006,PHO,23,32,22,25,0,0,0,102,GSW,26,21,37,26,0,0,0,110,20060414
2006,MIN,18,27,19,13,0,0,0,77,IND,28,21,24,16,0,0,0,89,20060414
2006,POR,18,27,29,25,0,0,0,99,LAL,36,14,29,31,0,0,0,110,20060414
2006,PHI,23,16,24,22,0,0,0,85,MIA,25,29,30,20,0,0,0,104,20060414
2006,UTA,20,23,33,29,0,0,0,105,NOK,28,26,24,26,0,0,0,104,20060414
2006,MIL,30,21,32,14,0,0,0,97,NYK,19,24,14,23,0,0,0,80,20060414
2006,LAC,30,25,27,19,0,0,0,101,SEA,33,33,15,16,0,0,0,97,20060414
2006,DET,24,23,29,27,0,0,0,103,TOR,23,29,18,38,0,0,0,108,20060414
2006,IND,21,14,30,19,7,0,0,91,CHA,18,29,12,25,8,0,0,92,20060415
2006,SAC,25,27,30,18,0,0,0,100,DEN,19,26,18,19,0,0,0,82,20060415
2006,MEM,27,19,27,20,0,0,0,93,HOU,17,29,16,19,0,0,0,81,20060415
2006,ATL,24,32,31,33,0,0,0,120,MIL,30,25,28,31,0,0,0,114,20060415
2006,PHI,27,29,24,17,0,0,0,97,ORL,37,21,25,19,0,0,0,102,20060415
2006,GSW,24,16,23,23,0,0,0,86,POR,15,22,20,24,0,0,0,81,20060415
2006,UTA,24,24,24,23,0,0,0,95,DAL,33,23,36,19,0,0,0,111,20060416
2006,NYK,18,25,25,29,0,0,0,97,DET,40,20,25,18,0,0,0,103,20060416
2006,SEA,38,29,33,14,0,0,0,114,LAC,27,24,23,24,0,0,0,98,20060416
2006,PHO,22,19,29,19,0,0,0,89,LAL,35,27,21,26,0,0,0,109,20060416
2006,CHI,25,33,30,29,0,0,0,117,MIA,35,18,21,19,0,0,0,93,20060416
2006,SAS,26,30,21,26,0,0,0,103,MIN,21,14,24,31,0,0,0,90,20060416
2006,BOS,21,27,22,23,0,0,0,93,NJN,31,22,21,21,0,0,0,95,20060416
2006,NOK,20,15,28,16,0,0,0,79,SAC,26,28,24,18,0,0,0,96,20060416
2006,CLE,17,24,21,30,0,0,0,92,WAS,25,28,35,16,0,0,0,104,20060416
2006,CLE,25,23,34,11,0,0,0,93,BOS,26,23,14,25,0,0,0,88,20060417
2006,HOU,16,19,24,27,0,0,0,86,DEN,29,22,15,17,0,0,0,83,20060417
2006,POR,20,20,15,24,0,0,0,79,GSW,27,22,26,18,0,0,0,93,20060417
2006,DET,16,23,19,35,0,0,0,93,MIL,27,27,33,26,0,0,0,113,20060417
2006,CHA,26,29,21,22,0,0,0,98,NYK,27,22,20,22,0,0,0,91,20060417
2006,CHI,24,17,28,27,20,0,0,116,ORL,26,26,24,20,16,0,0,112,20060417
2006,NOK,20,20,24,14,0,0,0,78,PHO,25,29,33,28,0,0,0,115,20060417
2006,UTA,19,19,28,16,0,0,0,82,SAS,28,27,30,30,0,0,0,115,20060417
2006,IND,40,30,33,17,0,0,0,120,TOR,29,22,17,27,0,0,0,95,20060417
2006,MIA,28,25,25,22,0,0,0,100,ATL,28,24,26,25,0,0,0,103,20060418
2006,LAC,15,18,32,30,0,0,0,95,MEM,18,33,25,25,0,0,0,101,20060418
2006,NJN,29,14,22,23,0,0,0,88,PHI,14,23,30,24,0,0,0,91,20060418
2006,SEA,21,33,35,16,0,0,0,105,SAC,28,32,26,25,0,0,0,111,20060418
2006,MIL,23,20,39,21,0,0,0,103,WAS,20,34,33,29,0,0,0,116,20060418
2006,MIA,17,29,21,11,0,0,0,78,BOS,24,22,22,17,0,0,0,85,20060419
2006,PHI,19,22,20,25,0,0,0,86,CHA,21,28,19,28,0,0,0,96,20060419
2006,TOR,23,35,20,28,0,0,0,106,CHI,34,34,35,24,0,0,0,127,20060419
2006,ATL,30,13,23,33,0,0,0,99,CLE,18,31,31,20,0,0,0,100,20060419
2006,LAC,20,34,12,19,0,0,0,85,DAL,21,17,15,18,0,0,0,71,20060419
2006,WAS,19,30,23,24,0,0,0,96,DET,24,17,21,18,0,0,0,80,20060419
2006,SAS,17,26,22,24,0,0,0,89,HOU,19,17,23,28,0,0,0,87,20060419
2006,ORL,13,24,21,25,0,0,0,83,IND,23,18,31,17,0,0,0,89,20060419
2006,NOK,20,18,25,32,0,0,0,95,LAL,32,33,29,21,0,0,0,115,20060419
2006,MEM,18,25,16,21,5,17,0,102,MIN,21,30,14,15,5,7,0,92,20060419
2006,NYK,22,24,24,20,0,0,0,90,NJN,24,15,18,26,0,0,0,83,20060419
2006,PHO,23,32,33,18,0,0,0,106,POR,16,32,18,30,0,0,0,96,20060419
2006,DEN,20,26,25,27,0,0,0,98,SEA,35,29,23,22,0,0,0,109,20060419
2006,GSW,36,18,23,25,0,0,0,102,UTA,27,21,29,28,0,0,0,105,20060419
2006,WAS,20,16,21,29,0,0,0,86,CLE,31,19,24,23,0,0,0,97,20060422
2006,DEN,26,19,21,21,0,0,0,87,LAC,31,23,22,13,0,0,0,89,20060422
2006,CHI,24,27,31,24,0,0,0,106,MIA,26,37,24,24,0,0,0,111,20060422
2006,SAC,24,15,28,21,0,0,0,88,SAS,32,41,21,28,0,0,0,122,20060422
2006,MEM,22,29,27,15,0,0,0,93,DAL,28,32,23,20,0,0,0,103,20060423
2006,MIL,19,18,19,18,0,0,0,74,DET,19,24,25,24,0,0,0,92,20060423
2006,IND,30,20,14,26,0,0,0,90,NJN,24,22,19,23,0,0,0,88,20060423
2006,LAL,29,21,25,27,0,0,0,102,PHO,39,19,17,32,0,0,0,107,20060423
2006,DEN,13,21,25,28,0,0,0,87,LAC,32,24,19,23,0,0,0,98,20060424
2006,CHI,26,31,19,32,0,0,0,108,MIA,33,35,27,20,0,0,0,115,20060424
2006,WAS,21,16,24,28,0,0,0,89,CLE,23,15,25,21,0,0,0,84,20060425
2006,IND,22,14,17,22,0,0,0,75,NJN,26,18,29,17,0,0,0,90,20060425
2006,SAC,30,26,26,27,10,0,0,119,SAS,23,28,31,27,19,0,0,128,20060425
2006,MEM,31,12,13,23,0,0,0,79,DAL,32,24,20,18,0,0,0,94,20060426
2006,MIL,23,25,27,23,0,0,0,98,DET,32,29,31,17,0,0,0,109,20060426
2006,LAL,24,29,21,25,0,0,0,99,PHO,22,16,29,26,0,0,0,93,20060426
2006,MIA,23,19,29,19,0,0,0,90,CHI,31,17,39,22,0,0,0,109,20060427
2006,LAC,13,29,28,17,0,0,0,87,DEN,24,21,25,24,0,0,0,94,20060427
2006,NJN,27,28,15,25,0,0,0,95,IND,22,29,27,29,0,0,0,107,20060427
2006,PHO,27,17,30,18,0,0,0,92,LAL,31,18,28,22,0,0,0,99,20060428
2006,SAS,20,21,23,29,0,0,0,93,SAC,22,25,21,26,0,0,0,94,20060428
2006,CLE,19,31,21,26,0,0,0,97,WAS,26,32,13,25,0,0,0,96,20060428
2006,LAC,24,32,22,22,0,0,0,100,DEN,21,24,19,22,0,0,0,86,20060429
2006,NJN,24,26,26,21,0,0,0,97,IND,15,22,20,31,0,0,0,88,20060429
2006,DAL,17,21,22,16,18,0,0,94,MEM,23,23,15,15,13,0,0,89,20060429
2006,DET,27,27,20,30,0,0,0,104,MIL,30,31,29,34,0,0,0,124,20060429
2006,MIA,23,17,19,28,0,0,0,87,CHI,21,23,21,28,0,0,0,93,20060430
2006,PHO,26,15,26,23,8,0,0,98,LAL,25,16,23,26,9,0,0,99,20060430
2006,SAS,24,19,21,20,0,0,0,84,SAC,26,28,21,27,0,0,0,102,20060430
2006,CLE,27,30,15,24,0,0,0,96,WAS,26,20,26,34,0,0,0,106,20060430
2006,DEN,23,17,17,26,0,0,0,83,LAC,21,25,25,30,0,0,0,101,20060501
2006,DAL,26,22,31,23,0,0,0,102,MEM,23,16,22,15,0,0,0,76,20060501
2006,DET,27,24,23,35,0,0,0,109,MIL,20,25,31,23,0,0,0,99,20060501
2006,CHI,19,19,23,17,0,0,0,78,MIA,25,15,21,31,0,0,0,92,20060502
2006,IND,25,21,19,21,0,0,0,86,NJN,28,21,23,20,0,0,0,92,20060502
2006,LAL,25,22,21,29,0,0,0,97,PHO,27,29,28,30,0,0,0,114,20060502
2006,SAC,19,27,22,30,0,0,0,98,SAS,21,22,37,29,0,0,0,109,20060502
2006,WAS,27,24,30,26,13,0,0,120,CLE,25,27,33,22,14,0,0,121,20060503
2006,MIL,23,26,17,27,0,0,0,93,DET,39,23,35,25,0,0,0,122,20060503
2006,MIA,29,26,29,29,0,0,0,113,CHI,19,22,28,27,0,0,0,96,20060504
2006,NJN,21,20,32,23,0,0,0,96,IND,26,15,28,21,0,0,0,90,20060504
2006,PHO,30,30,28,17,21,0,0,126,LAL,37,20,28,20,13,0,0,118,20060504
2006,SAS,22,23,33,27,0,0,0,105,SAC,20,18,24,21,0,0,0,83,20060505
2006,CLE,17,31,27,32,7,0,0,114,WAS,24,25,27,31,6,0,0,113,20060505
2006,LAL,15,30,20,25,0,0,0,90,PHO,32,28,30,31,0,0,0,121,20060506
2006,CLE,16,32,15,23,0,0,0,86,DET,26,43,25,19,0,0,0,113,20060507
2006,DAL,29,23,20,13,0,0,0,85,SAS,26,20,25,16,0,0,0,87,20060507
2006,NJN,38,26,20,16,0,0,0,100,MIA,21,25,18,24,0,0,0,88,20060508
2006,LAC,25,36,30,32,0,0,0,123,PHO,29,27,37,37,0,0,0,130,20060508
2006,CLE,16,20,24,31,0,0,0,91,DET,23,29,26,19,0,0,0,97,20060509
2006,DAL,26,32,26,29,0,0,0,113,SAS,22,16,28,25,0,0,0,91,20060509
2006,NJN,19,21,27,22,0,0,0,89,MIA,41,19,24,27,0,0,0,111,20060510
2006,LAC,38,27,33,24,0,0,0,122,PHO,22,29,28,18,0,0,0,97,20060510
2006,PHO,26,22,24,22,0,0,0,94,LAC,28,20,15,28,0,0,0,91,20060512
2006,MIA,27,27,18,31,0,0,0,103,NJN,27,22,23,20,0,0,0,92,20060512
2006,DET,17,25,14,21,0,0,0,77,CLE,18,18,17,33,0,0,0,86,20060513
2006,SAS,18,30,21,34,0,0,0,103,DAL,27,26,20,31,0,0,0,104,20060513
2006,PHO,28,23,31,25,0,0,0,107,LAC,33,28,29,24,0,0,0,114,20060514
2006,MIA,27,27,22,26,0,0,0,102,NJN,24,24,25,19,0,0,0,92,20060514
2006,DET,19,19,21,13,0,0,0,72,CLE,16,20,17,21,0,0,0,74,20060515
2006,SAS,26,27,27,31,7,0,0,118,DAL,19,34,31,27,12,0,0,123,20060515
2006,NJN,33,21,28,23,0,0,0,105,MIA,24,30,31,21,0,0,0,106,20060516
2006,LAC,31,21,26,23,10,7,0,118,PHO,26,32,26,17,10,14,0,125,20060516
2006,CLE,20,30,18,18,0,0,0,86,DET,20,25,21,18,0,0,0,84,20060517
2006,DAL,24,33,21,19,0,0,0,97,SAS,29,28,24,17,0,0,0,98,20060517
2006,PHO,32,18,31,25,0,0,0,106,LAC,31,31,26,30,0,0,0,118,20060518
2006,DET,20,18,25,21,0,0,0,84,CLE,19,18,24,21,0,0,0,82,20060519
2006,SAS,20,21,26,24,0,0,0,91,DAL,25,22,20,19,0,0,0,86,20060519
2006,CLE,15,23,10,13,0,0,0,61,DET,21,19,18,21,0,0,0,79,20060521
2006,LAC,28,29,22,28,0,0,0,107,PHO,32,33,29,33,0,0,0,127,20060522
2006,DAL,37,27,20,20,15,0,0,119,SAS,27,23,28,26,7,0,0,111,20060522
2006,MIA,33,15,18,25,0,0,0,91,DET,25,19,17,25,0,0,0,86,20060523
2006,PHO,35,27,29,30,0,0,0,121,DAL,29,29,37,23,0,0,0,118,20060524
2006,MIA,12,25,19,32,0,0,0,88,DET,25,23,22,22,0,0,0,92,20060525
2006,PHO,17,35,25,21,0,0,0,98,DAL,22,25,28,30,0,0,0,105,20060526
2006,DET,24,14,24,21,0,0,0,83,MIA,26,23,25,24,0,0,0,98,20060527
2006,DAL,22,25,25,23,0,0,0,95,PHO,25,27,16,20,0,0,0,88,20060528
2006,DET,17,21,22,18,0,0,0,78,MIA,23,21,18,27,0,0,0,89,20060529
2006,DAL,28,18,21,19,0,0,0,86,PHO,28,23,28,27,0,0,0,106,20060530
2006,MIA,20,23,22,13,0,0,0,78,DET,25,22,26,18,0,0,0,91,20060531
2006,PHO,23,32,26,20,0,0,0,101,DAL,36,22,24,35,0,0,0,117,20060601
2006,DET,20,16,17,25,0,0,0,78,MIA,25,22,25,23,0,0,0,95,20060602
2006,DAL,14,25,23,40,0,0,0,102,PHO,29,22,15,27,0,0,0,93,20060603
2006,MIA,31,13,24,12,0,0,0,80,DAL,23,23,24,20,0,0,0,90,20060608
2006,MIA,17,17,24,27,0,0,0,85,DAL,18,32,32,17,0,0,0,99,20060611
2006,DAL,21,22,34,19,0,0,0,96,MIA,29,23,16,30,0,0,0,98,20060613
2006,DAL,25,19,23,7,0,0,0,74,MIA,30,24,24,20,0,0,0,98,20060615
2006,DAL,21,30,20,22,7,0,0,100,MIA,24,19,27,23,8,0,0,101,20060618
2006,MIA,23,26,22,24,0,0,0,95,DAL,30,18,20,24,0,0,0,92,20060620
2007,PHO,41,17,21,27,0,0,0,106,LAL,26,27,34,27,0,0,0,114,20061031
2007,CHI,22,37,21,28,0,0,0,108,MIA,16,14,21,15,0,0,0,66,20061031
2007,NOK,26,28,21,16,0,0,0,91,BOS,16,25,24,22,0,0,0,87,20061101
2007,IND,23,26,28,29,0,0,0,106,CHA,27,23,23,26,0,0,0,99,20061101
2007,WAS,28,17,24,25,0,0,0,94,CLE,26,21,28,22,0,0,0,97,20061101
2007,MIL,30,25,23,27,0,0,0,105,DET,21,24,27,25,0,0,0,97,20061101
2007,LAL,22,27,38,23,0,0,0,110,GSW,22,26,25,25,0,0,0,98,20061101
2007,NYK,20,31,20,18,11,8,10,118,MEM,25,21,14,29,11,8,9,117,20061101
2007,SAC,16,25,25,17,0,0,0,83,MIN,23,20,21,28,0,0,0,92,20061101
2007,TOR,27,22,21,22,0,0,0,92,NJN,28,25,21,28,0,0,0,102,20061101
2007,CHI,20,25,25,24,0,0,0,94,ORL,32,31,23,23,0,0,0,109,20061101
2007,ATL,14,21,23,17,0,0,0,75,PHI,29,20,24,15,0,0,0,88,20061101
2007,LAC,20,25,29,30,0,0,0,104,PHO,24,24,29,35,0,0,0,112,20061101
2007,POR,20,28,28,34,0,0,0,110,SEA,24,27,27,28,0,0,0,106,20061101
2007,HOU,26,22,24,25,0,0,0,97,UTA,35,25,25,22,0,0,0,107,20061101
2007,SAS,26,19,27,25,0,0,0,97,DAL,27,24,24,16,0,0,0,91,20061102
2007,DEN,24,24,22,25,0,0,0,95,LAC,18,31,16,31,0,0,0,96,20061102
2007,NYK,22,15,29,26,0,0,0,92,ATL,21,26,25,30,0,0,0,102,20061103
2007,DET,24,21,28,28,0,0,0,101,BOS,25,21,24,18,0,0,0,88,20061103
2007,SAC,14,20,28,27,0,0,0,89,CHI,17,23,22,26,0,0,0,88,20061103
2007,MIN,26,27,31,28,0,0,0,112,DEN,27,30,34,18,0,0,0,109,20061103
2007,POR,25,20,20,24,0,0,0,89,GSW,24,22,28,28,0,0,0,102,20061103
2007,NOK,26,22,21,31,0,0,0,100,IND,20,20,32,19,0,0,0,91,20061103
2007,SEA,26,30,32,24,0,0,0,112,LAL,38,27,21,32,0,0,0,118,20061103
2007,CHA,21,26,23,13,0,0,0,83,MEM,24,20,16,36,0,0,0,96,20061103
2007,NJN,24,17,21,23,0,0,0,85,MIA,21,22,22,26,0,0,0,91,20061103
2007,PHI,26,27,24,28,0,0,0,105,ORL,24,28,26,25,0,0,0,103,20061103
2007,UTA,29,18,30,31,0,0,0,108,PHO,18,36,29,21,0,0,0,104,20061103
2007,CLE,23,20,19,26,0,0,0,88,SAS,18,18,20,25,0,0,0,81,20061103
2007,MIL,21,29,25,17,0,0,0,92,TOR,27,23,29,30,0,0,0,109,20061103
2007,CLE,28,22,16,22,0,0,0,88,CHA,20,26,23,23,0,0,0,92,20061104
2007,MEM,25,15,22,24,0,0,0,86,DET,23,23,24,25,0,0,0,95,20061104
2007,DAL,16,22,23,15,0,0,0,76,HOU,25,27,23,32,0,0,0,107,20061104
2007,PHO,26,17,39,26,0,0,0,108,LAC,20,36,24,34,0,0,0,114,20061104
2007,SAC,27,28,16,20,0,0,0,91,MIL,30,19,37,18,0,0,0,104,20061104
2007,IND,22,23,32,32,0,0,0,109,NYK,14,26,36,19,0,0,0,95,20061104
2007,MIN,30,22,22,12,0,0,0,86,POR,14,27,28,19,0,0,0,88,20061104
2007,GSW,22,19,21,20,0,0,0,82,UTA,29,31,25,21,0,0,0,106,20061104
2007,BOS,28,29,31,29,0,0,0,117,WAS,35,23,40,26,0,0,0,124,20061104
2007,ORL,11,24,22,25,0,0,0,82,ATL,22,24,20,29,0,0,0,95,20061105
2007,HOU,15,27,28,20,0,0,0,90,NOK,26,22,23,25,0,0,0,96,20061105
2007,MIA,29,28,16,25,0,0,0,98,PHI,26,24,28,29,0,0,0,107,20061105
2007,LAL,31,18,23,29,0,0,0,101,SEA,29,28,38,22,0,0,0,117,20061105
2007,SAS,17,32,27,27,0,0,0,103,TOR,25,21,22,26,0,0,0,94,20061105
2007,MIL,20,22,19,24,0,0,0,85,CHI,27,33,20,30,0,0,0,110,20061106
2007,GSW,27,30,27,23,0,0,0,107,DAL,34,25,24,21,0,0,0,104,20061106
2007,POR,22,20,18,29,0,0,0,89,LAC,20,26,25,31,0,0,0,102,20061106
2007,SAS,25,29,28,23,0,0,0,105,NYK,16,25,26,26,0,0,0,93,20061106
2007,WAS,29,23,31,20,0,0,0,103,ORL,28,24,29,25,0,0,0,106,20061106
2007,MIN,21,21,21,18,0,0,0,81,SAC,26,20,30,17,0,0,0,93,20061106
2007,DET,22,32,17,30,0,0,0,101,UTA,27,29,25,22,0,0,0,103,20061106
2007,ATL,20,17,29,24,14,0,0,104,CLE,20,18,33,19,5,0,0,95,20061107
2007,PHI,23,13,19,31,0,0,0,86,IND,20,31,29,17,0,0,0,97,20061107
2007,MIN,19,26,18,25,0,0,0,88,LAL,24,27,25,19,0,0,0,95,20061107
2007,HOU,19,26,19,22,0,0,0,86,MEM,12,27,21,20,0,0,0,80,20061107
2007,SEA,21,25,15,26,0,0,0,87,MIA,11,29,25,25,0,0,0,90,20061107
2007,GSW,17,26,21,29,0,0,0,93,NOK,29,23,22,23,0,0,0,97,20061107
2007,CHA,24,25,25,26,8,0,0,108,BOS,17,28,37,18,10,0,0,110,20061108
2007,NYK,31,18,24,36,0,0,0,109,DEN,33,24,26,24,0,0,0,107,20061108
2007,DAL,32,18,16,19,0,0,0,85,LAC,21,22,30,30,0,0,0,103,20061108
2007,HOU,26,22,28,21,0,0,0,97,MIL,17,22,20,34,0,0,0,93,20061108
2007,UTA,21,20,21,27,0,0,0,89,NJN,27,20,23,26,0,0,0,96,20061108
2007,SEA,21,26,20,20,0,0,0,87,ORL,24,18,25,21,0,0,0,88,20061108
2007,LAL,23,26,20,21,0,0,0,90,POR,25,30,23,23,0,0,0,101,20061108
2007,DET,11,28,25,22,0,0,0,86,SAC,18,21,32,28,0,0,0,99,20061108
2007,PHO,25,24,26,26,5,0,0,106,SAS,21,29,20,31,10,0,0,111,20061108
2007,PHI,21,19,29,35,0,0,0,104,TOR,28,17,26,35,0,0,0,106,20061108
2007,IND,26,21,21,23,0,0,0,91,WAS,33,29,37,18,0,0,0,117,20061108
2007,CHI,18,21,29,26,0,0,0,94,CLE,30,22,28,33,0,0,0,113,20061109
2007,NOK,35,22,26,33,0,0,0,116,GSW,34,24,34,29,0,0,0,121,20061109
2007,DAL,34,26,33,26,0,0,0,119,PHO,26,30,29,27,0,0,0,112,20061109
2007,UTA,27,25,30,25,0,0,0,107,BOS,31,17,22,30,0,0,0,100,20061110
2007,SEA,20,22,35,22,0,0,0,99,CHA,22,24,19,20,0,0,0,85,20061110
2007,NYK,20,26,20,28,0,0,0,94,HOU,26,28,28,21,0,0,0,103,20061110
2007,ORL,32,18,13,20,0,0,0,83,IND,27,20,23,23,0,0,0,93,20061110
2007,DET,27,18,25,27,0,0,0,97,LAL,21,16,18,28,0,0,0,83,20061110
2007,MIA,22,21,33,37,0,0,0,113,NJN,32,21,22,31,0,0,0,106,20061110
2007,DEN,30,22,26,30,0,0,0,108,PHI,23,25,20,33,0,0,0,101,20061110
2007,NOK,38,15,18,20,0,0,0,91,POR,13,31,23,25,0,0,0,92,20061110
2007,ATL,28,19,30,34,0,0,0,111,TOR,16,22,32,32,0,0,0,102,20061110
2007,MIL,23,28,34,26,0,0,0,111,WAS,33,26,17,40,0,0,0,116,20061110
2007,SEA,29,28,25,19,12,0,0,113,ATL,26,26,28,21,11,0,0,112,20061111
2007,IND,25,23,18,14,0,0,0,80,CHI,24,19,16,30,0,0,0,89,20061111
2007,BOS,25,23,28,17,0,0,0,93,CLE,10,24,26,34,0,0,0,94,20061111
2007,DET,16,16,23,24,0,0,0,79,GSW,32,25,29,25,0,0,0,111,20061111
2007,UTA,32,30,24,27,0,0,0,113,MIL,23,18,28,42,0,0,0,111,20061111
2007,ORL,29,30,21,29,0,0,0,109,MIN,20,21,26,31,0,0,0,98,20061111
2007,MEM,23,20,15,29,0,0,0,87,PHO,23,31,35,7,0,0,0,96,20061111
2007,NYK,21,25,21,25,0,0,0,92,SAS,32,25,19,24,0,0,0,100,20061111
2007,DEN,24,31,27,26,0,0,0,108,CHA,22,25,26,28,0,0,0,101,20061112
2007,NOK,16,26,22,12,0,0,0,76,LAC,22,31,15,24,0,0,0,92,20061112
2007,MEM,14,16,32,19,0,0,0,81,LAL,23,26,23,19,0,0,0,91,20061112
2007,HOU,22,17,21,34,0,0,0,94,MIA,25,17,14,16,0,0,0,72,20061112
2007,DAL,24,20,33,26,0,0,0,103,POR,13,28,23,32,0,0,0,96,20061112
2007,TOR,25,19,20,28,0,0,0,92,SAC,36,23,26,22,0,0,0,107,20061112
2007,NJN,23,27,17,20,18,0,0,105,WAS,17,19,24,27,6,0,0,93,20061112
2007,ORL,24,21,21,26,0,0,0,92,BOS,22,15,24,28,0,0,0,89,20061113
2007,SEA,35,25,36,23,0,0,0,119,NJN,17,25,38,33,0,0,0,113,20061113
2007,CLE,15,36,20,31,0,0,0,102,NYK,20,27,16,33,0,0,0,96,20061113
2007,MIL,31,29,18,25,0,0,0,103,ATL,16,33,34,18,0,0,0,101,20061114
2007,CHI,24,22,23,30,0,0,0,99,DAL,30,22,25,34,0,0,0,111,20061114
2007,TOR,21,41,18,19,0,0,0,99,GSW,28,28,20,34,0,0,0,110,20061114
2007,SAS,23,20,28,21,0,0,0,92,HOU,27,29,19,9,0,0,0,84,20061114
2007,DEN,24,24,34,30,0,0,0,112,MIA,17,35,31,22,0,0,0,105,20061114
2007,POR,11,23,26,29,0,0,0,89,MIN,30,22,26,23,0,0,0,101,20061114
2007,CHA,34,18,16,17,0,0,0,85,NOK,34,21,17,22,0,0,0,94,20061114
2007,LAC,23,31,18,18,0,0,0,90,UTA,25,28,26,33,0,0,0,112,20061114
2007,IND,24,21,21,22,0,0,0,88,BOS,25,22,33,34,0,0,0,114,20061115
2007,POR,18,25,18,26,0,0,0,87,CLE,24,27,28,21,0,0,0,100,20061115
2007,NOK,27,33,21,19,0,0,0,100,DET,24,25,27,23,0,0,0,99,20061115
2007,MIL,25,19,24,19,0,0,0,87,NJN,31,26,19,24,0,0,0,100,20061115
2007,WAS,25,18,26,13,0,0,0,82,NYK,27,23,27,25,0,0,0,102,20061115
2007,DEN,27,24,23,25,0,0,0,99,ORL,24,26,29,29,0,0,0,108,20061115
2007,MEM,20,29,28,34,0,0,0,111,SAC,28,26,30,31,0,0,0,115,20061115
2007,CHA,20,28,20,15,12,0,0,95,SAS,23,21,19,20,9,0,0,92,20061115
2007,PHI,24,19,33,20,0,0,0,96,SEA,20,16,27,27,0,0,0,90,20061115
2007,SAC,28,25,27,25,0,0,0,105,GSW,40,25,27,25,0,0,0,117,20061116
2007,CHI,26,13,30,31,0,0,0,100,HOU,20,30,28,23,0,0,0,101,20061116
2007,POR,20,23,22,25,0,0,0,90,BOS,20,30,27,41,0,0,0,118,20061117
2007,MIN,22,23,17,14,0,0,0,76,CLE,22,20,24,26,0,0,0,92,20061117
2007,WAS,20,26,15,30,0,0,0,91,DET,26,17,31,26,0,0,0,100,20061117
2007,NJN,26,25,20,29,0,0,0,100,IND,18,23,29,21,0,0,0,91,20061117
2007,TOR,22,31,27,20,0,0,0,100,LAL,26,35,21,25,0,0,0,107,20061117
2007,DAL,28,23,24,40,0,0,0,115,MEM,28,29,21,25,0,0,0,103,20061117
2007,NYK,31,23,34,12,0,0,0,100,MIA,22,27,14,13,0,0,0,76,20061117
2007,PHI,20,32,24,18,0,0,0,94,PHO,29,30,30,17,0,0,0,106,20061117
2007,CHI,27,15,23,18,0,0,0,83,SAS,28,22,25,25,0,0,0,100,20061117
2007,UTA,28,24,30,36,0,0,0,118,SEA,23,24,30,32,0,0,0,109,20061117
2007,MIA,20,22,16,16,19,0,0,93,ATL,12,20,27,15,14,0,0,88,20061118
2007,MEM,18,28,20,18,0,0,0,84,DAL,22,22,23,22,0,0,0,89,20061118
2007,TOR,36,22,26,25,0,0,0,109,DEN,38,26,25,28,0,0,0,117,20061118
2007,HOU,23,29,26,14,0,0,0,92,DET,24,26,26,28,0,0,0,104,20061118
2007,SEA,22,20,25,28,0,0,0,95,GSW,23,32,21,31,0,0,0,107,20061118
2007,PHI,25,18,22,25,7,0,0,97,LAC,13,25,23,29,13,0,0,103,20061118
2007,IND,15,20,32,35,0,0,0,102,MIL,27,23,21,29,0,0,0,100,20061118
2007,NOK,32,16,19,32,0,0,0,99,MIN,28,25,21,22,0,0,0,96,20061118
2007,POR,25,18,24,19,0,0,0,86,NJN,8,18,22,20,0,0,0,68,20061118
2007,BOS,24,29,35,34,0,0,0,122,NYK,24,32,22,40,0,0,0,118,20061118
2007,CHA,20,23,21,19,0,0,0,83,ORL,25,32,19,21,0,0,0,97,20061118
2007,PHO,22,27,35,22,11,0,0,117,UTA,25,29,19,33,14,0,0,120,20061118
2007,CLE,29,29,16,25,0,0,0,99,WAS,26,36,31,18,0,0,0,111,20061118
2007,CHI,21,14,24,13,0,0,0,72,LAL,19,19,24,20,0,0,0,82,20061119
2007,SAS,29,27,35,17,0,0,0,108,SAC,28,26,24,21,0,0,0,99,20061119
2007,DAL,21,22,24,26,0,0,0,93,CHA,21,20,24,20,0,0,0,85,20061120
2007,PHO,31,21,37,24,0,0,0,113,GSW,31,26,27,26,0,0,0,110,20061120
2007,ORL,23,22,20,21,0,0,0,86,MEM,14,26,23,32,0,0,0,95,20061120
2007,HOU,21,27,17,32,0,0,0,97,NYK,20,25,17,28,0,0,0,90,20061120
2007,SAS,22,26,30,29,0,0,0,107,POR,25,31,18,24,0,0,0,98,20061120
2007,NJN,25,26,19,17,0,0,0,87,SEA,21,24,21,33,0,0,0,99,20061120
2007,TOR,25,29,23,19,0,0,0,96,UTA,29,23,19,30,0,0,0,101,20061120
2007,MEM,13,23,30,28,0,0,0,94,CLE,25,29,26,17,0,0,0,97,20061121
2007,WAS,30,21,13,16,0,0,0,80,DAL,21,30,25,31,0,0,0,107,20061121
2007,CHI,24,31,23,31,0,0,0,109,DEN,31,24,24,34,0,0,0,113,20061121
2007,MIL,25,24,22,17,0,0,0,88,IND,23,25,20,25,0,0,0,93,20061121
2007,LAC,25,23,26,27,0,0,0,101,LAL,27,24,32,22,0,0,0,105,20061121
2007,MIA,19,27,25,15,0,0,0,86,NOK,21,26,28,26,0,0,0,101,20061121
2007,DET,24,22,27,24,0,0,0,97,PHI,19,20,22,26,0,0,0,87,20061121
2007,BOS,17,32,15,19,0,0,0,83,CHA,29,24,16,23,0,0,0,92,20061122
2007,ATL,26,23,23,26,0,0,0,98,DET,26,19,28,30,0,0,0,103,20061122
2007,DEN,34,27,32,22,0,0,0,115,GSW,26,32,25,29,0,0,0,112,20061122
2007,WAS,15,13,28,26,0,0,0,82,HOU,23,17,26,20,0,0,0,86,20061122
2007,SEA,27,22,20,26,0,0,0,95,LAC,18,25,19,23,0,0,0,85,20061122
2007,PHI,31,26,22,15,0,0,0,94,MIL,25,28,19,26,0,0,0,98,20061122
2007,NYK,13,23,29,24,0,0,0,89,MIN,30,26,27,24,0,0,0,107,20061122
2007,IND,27,24,17,23,0,0,0,91,ORL,22,23,27,24,0,0,0,96,20061122
2007,NOK,28,18,13,24,0,0,0,83,PHO,34,17,20,21,0,0,0,92,20061122
2007,NJN,30,27,18,22,0,0,0,97,POR,20,24,25,31,0,0,0,100,20061122
2007,UTA,20,17,34,39,0,0,0,110,SAC,30,25,29,17,0,0,0,101,20061122
2007,MIA,18,20,24,24,0,0,0,86,SAS,19,38,28,21,0,0,0,106,20061122
2007,CLE,20,32,23,12,0,0,0,87,TOR,35,21,17,22,0,0,0,95,20061122
2007,TOR,23,25,17,28,0,0,0,93,ATL,32,15,25,25,0,0,0,97,20061124
2007,NYK,23,29,29,20,0,0,0,101,BOS,25,22,14,16,0,0,0,77,20061124
2007,GSW,34,26,33,36,0,0,0,129,DEN,35,36,38,31,0,0,0,140,20061124
2007,CHA,27,22,23,23,0,0,0,95,DET,30,22,22,30,0,0,0,104,20061124
2007,CLE,27,29,9,22,0,0,0,87,IND,12,32,25,28,0,0,0,97,20061124
2007,WAS,15,22,22,21,0,0,0,80,MEM,20,21,27,27,0,0,0,95,20061124
2007,ORL,24,24,30,29,0,0,0,107,MIA,23,24,31,26,0,0,0,104,20061124
2007,MIN,23,21,22,20,0,0,0,86,NOK,26,17,17,19,0,0,0,79,20061124
2007,CHI,24,26,31,27,0,0,0,108,PHI,31,29,33,30,0,0,0,123,20061124
2007,NJN,21,20,22,30,0,0,0,93,PHO,39,18,25,17,0,0,0,99,20061124
2007,DAL,37,22,15,21,0,0,0,95,SAS,23,27,23,19,0,0,0,92,20061124
2007,SAC,32,21,29,27,0,0,0,109,SEA,34,18,23,25,0,0,0,100,20061124
2007,LAL,26,27,35,20,0,0,0,108,UTA,29,21,32,32,0,0,0,114,20061124
2007,MIA,23,28,21,30,0,0,0,102,CHA,25,18,23,27,0,0,0,93,20061125
2007,PHI,25,13,32,25,0,0,0,95,CLE,16,35,31,26,0,0,0,108,20061125
2007,NOK,16,20,17,20,0,0,0,73,DAL,35,16,19,15,0,0,0,85,20061125
2007,UTA,14,28,17,19,0,0,0,78,GSW,27,16,30,18,0,0,0,91,20061125
2007,MEM,18,21,15,22,0,0,0,76,HOU,24,13,28,20,0,0,0,85,20061125
2007,BOS,25,21,37,28,0,0,0,111,MIL,27,33,20,18,0,0,0,98,20061125
2007,LAC,26,31,24,15,0,0,0,96,MIN,17,30,22,35,0,0,0,104,20061125
2007,CHI,29,27,26,24,0,0,0,106,NYK,21,13,28,33,0,0,0,95,20061125
2007,ATL,18,11,28,22,0,0,0,79,ORL,31,26,22,19,0,0,0,98,20061125
2007,POR,26,17,23,19,0,0,0,85,SAC,34,31,22,18,0,0,0,105,20061125
2007,DET,34,28,28,25,0,0,0,115,WAS,35,23,21,32,0,0,0,111,20061125
2007,LAC,17,32,21,18,0,0,0,88,DEN,28,24,35,16,0,0,0,103,20061126
2007,NJN,33,15,18,27,0,0,0,93,LAL,24,19,30,26,0,0,0,99,20061126
2007,PHO,33,26,34,26,0,0,0,119,POR,27,20,25,29,0,0,0,101,20061126
2007,SAS,25,24,22,27,0,0,0,98,SEA,21,18,24,15,0,0,0,78,20061126
2007,IND,17,19,25,22,0,0,0,83,TOR,32,20,18,22,0,0,0,92,20061126
2007,MIN,23,17,21,26,0,0,0,87,DAL,33,18,25,17,0,0,0,93,20061127
2007,SAS,23,27,28,24,0,0,0,102,GSW,25,25,27,34,0,0,0,111,20061127
2007,PHI,31,20,17,23,0,0,0,91,MIA,25,26,23,29,0,0,0,103,20061127
2007,ORL,26,21,17,24,0,0,0,88,UTA,23,18,11,23,0,0,0,75,20061127
2007,NYK,23,23,22,17,0,0,0,85,CHI,21,26,24,31,0,0,0,102,20061128
2007,MEM,17,36,28,27,0,0,0,108,DEN,25,27,28,16,0,0,0,96,20061128
2007,MIN,17,14,16,28,0,0,0,75,HOU,21,15,18,28,0,0,0,82,20061128
2007,MIL,27,25,27,30,0,0,0,109,LAL,30,17,31,27,0,0,0,105,20061128
2007,CHA,31,28,15,22,0,0,0,96,NJN,26,23,20,23,0,0,0,92,20061128
2007,TOR,23,26,23,22,0,0,0,94,NOK,25,20,14,18,0,0,0,77,20061128
2007,IND,21,30,24,30,0,0,0,105,POR,24,22,29,22,0,0,0,97,20061128
2007,LAC,23,22,22,13,0,0,0,80,SAC,23,24,23,23,0,0,0,93,20061128
2007,ATL,22,27,27,19,0,0,0,95,WAS,30,25,21,20,0,0,0,96,20061128
2007,CHA,16,25,31,18,0,0,0,90,ATL,19,37,27,16,0,0,0,99,20061129
2007,NJN,27,25,24,30,0,0,0,106,BOS,28,27,29,19,0,0,0,103,20061129
2007,NYK,28,28,17,28,0,0,0,101,CLE,25,26,26,21,0,0,0,98,20061129
2007,TOR,23,26,25,24,0,0,0,98,DAL,38,21,30,28,0,0,0,117,20061129
2007,IND,28,27,26,27,0,0,0,108,GSW,29,27,25,25,0,0,0,106,20061129
2007,MEM,20,29,24,17,0,0,0,90,LAC,30,34,17,24,0,0,0,105,20061129
2007,HOU,22,18,27,24,0,0,0,91,PHO,35,22,13,32,0,0,0,102,20061129
2007,ORL,21,24,23,26,0,0,0,94,SEA,26,19,20,19,0,0,0,84,20061129
2007,SAS,23,16,17,19,0,0,0,75,UTA,16,21,24,22,0,0,0,83,20061129
2007,UTA,27,14,32,29,0,0,0,102,LAL,29,24,42,37,0,0,0,132,20061130
2007,DET,18,24,24,21,0,0,0,87,MIA,25,20,19,21,0,0,0,85,20061130
2007,CLE,32,30,17,27,0,0,0,106,ATL,26,26,27,16,0,0,0,95,20061201
2007,SAC,19,22,24,25,0,0,0,90,DAL,38,24,28,19,0,0,0,109,20061201
2007,NYK,25,24,22,29,0,0,0,100,DET,29,27,28,24,0,0,0,108,20061201
2007,DEN,28,28,33,17,0,0,0,106,MIN,25,20,22,25,0,0,0,92,20061201
2007,CHI,28,31,24,28,0,0,0,111,NOK,24,23,30,31,0,0,0,108,20061201
2007,MIL,32,32,23,29,0,0,0,116,PHO,34,28,35,25,0,0,0,122,20061201
2007,ORL,26,25,21,19,0,0,0,91,POR,22,22,23,22,0,0,0,89,20061201
2007,IND,28,30,22,23,0,0,0,103,SEA,27,35,22,21,0,0,0,105,20061201
2007,BOS,32,19,27,24,0,0,0,102,TOR,30,28,23,25,0,0,0,106,20061201
2007,CHA,30,33,25,21,0,0,0,109,WAS,31,32,36,22,0,0,0,121,20061201
2007,WAS,25,19,21,29,0,0,0,94,CHI,29,33,30,20,0,0,0,112,20061202
2007,IND,26,29,26,20,0,0,0,101,DEN,29,36,34,22,0,0,0,121,20061202
2007,MIL,27,33,29,26,0,0,0,115,GSW,24,36,34,16,0,0,0,110,20061202
2007,CLE,19,10,15,19,0,0,0,63,HOU,23,20,19,19,0,0,0,81,20061202
2007,LAL,20,27,22,28,0,0,0,97,LAC,22,17,25,24,0,0,0,88,20061202
2007,MIA,25,32,19,22,0,0,0,98,MEM,20,28,23,26,0,0,0,97,20061202
2007,PHI,26,23,25,33,0,0,0,107,NJN,24,32,29,27,0,0,0,112,20061202
2007,TOR,29,35,19,20,0,0,0,103,NYK,31,29,20,20,0,0,0,100,20061202
2007,SAC,26,19,26,27,0,0,0,98,SAS,26,27,27,20,0,0,0,100,20061202
2007,SEA,26,21,23,37,0,0,0,107,UTA,25,27,30,27,0,0,0,109,20061202
2007,DET,25,19,26,19,0,0,0,89,CHA,23,20,34,20,0,0,0,97,20061203
2007,ORL,29,20,26,16,0,0,0,91,LAC,35,31,22,28,0,0,0,116,20061203
2007,MIN,21,26,21,27,0,0,0,95,PHI,20,24,21,19,0,0,0,84,20061203
2007,ATL,25,35,27,20,0,0,0,107,POR,22,30,20,24,0,0,0,96,20061203
2007,BOS,14,21,18,29,0,0,0,82,CHI,28,25,25,22,0,0,0,100,20061204
2007,IND,19,25,21,22,0,0,0,87,LAL,33,27,23,18,0,0,0,101,20061204
2007,MEM,19,27,21,23,0,0,0,90,NYK,25,30,26,17,0,0,0,98,20061204
2007,ORL,21,24,24,23,0,0,0,92,SAC,21,27,23,18,0,0,0,89,20061204
2007,GSW,14,28,19,28,0,0,0,89,SAS,30,26,37,36,0,0,0,129,20061204
2007,MIL,25,21,18,24,0,0,0,88,UTA,28,29,29,15,0,0,0,101,20061204
2007,DAL,23,18,25,31,0,0,0,97,WAS,31,28,29,18,0,0,0,106,20061204
2007,POR,16,25,23,24,0,0,0,88,DET,24,20,20,21,0,0,0,85,20061205
2007,GSW,20,24,24,22,0,0,0,90,HOU,35,30,28,25,0,0,0,118,20061205
2007,MIA,25,19,21,32,0,0,0,97,LAC,22,23,27,29,0,0,0,101,20061205
2007,DAL,21,28,20,23,0,0,0,92,NJN,14,21,26,14,0,0,0,75,20061205
2007,SAC,29,22,26,25,0,0,0,102,PHO,41,21,35,30,0,0,0,127,20061205
2007,ATL,18,21,24,24,0,0,0,87,SEA,29,23,25,25,0,0,0,102,20061205
2007,MEM,19,27,28,24,0,0,0,98,BOS,28,16,22,30,0,0,0,96,20061206
2007,SAS,22,26,22,26,0,0,0,96,CHA,23,19,15,19,0,0,0,76,20061206
2007,PHI,16,32,22,24,0,0,0,94,CHI,39,30,27,25,0,0,0,121,20061206
2007,TOR,25,22,20,24,0,0,0,91,CLE,18,26,24,27,0,0,0,95,20061206
2007,ATL,24,24,13,37,0,0,0,98,DEN,24,20,31,21,0,0,0,96,20061206
2007,ORL,27,15,17,21,0,0,0,80,IND,28,24,24,18,0,0,0,94,20061206
2007,NOK,30,24,21,30,0,0,0,105,LAL,34,18,19,18,0,0,0,89,20061206
2007,POR,23,15,20,28,8,0,0,94,MIL,14,23,22,27,16,0,0,102,20061206
2007,HOU,25,15,25,19,0,0,0,84,MIN,20,23,26,21,0,0,0,90,20061206
2007,WAS,35,31,33,14,0,0,0,113,NYK,31,24,30,17,0,0,0,102,20061206
2007,DET,29,23,24,16,0,0,0,92,DAL,20,24,16,22,0,0,0,82,20061207
2007,PHO,30,34,28,41,10,18,0,161,NJN,29,29,32,43,10,14,0,157,20061207
2007,MIA,22,20,26,17,8,0,0,93,SAC,17,21,22,25,6,0,0,91,20061207
2007,PHO,35,24,21,36,0,0,0,116,BOS,33,21,27,30,0,0,0,111,20061208
2007,HOU,31,21,25,15,0,0,0,92,CHA,17,14,15,16,0,0,0,62,20061208
2007,TOR,29,20,19,22,0,0,0,90,CHI,19,29,24,21,0,0,0,93,20061208
2007,MIA,32,24,35,16,0,0,0,107,DEN,35,39,28,21,0,0,0,123,20061208
2007,POR,24,29,14,28,0,0,0,95,IND,22,20,35,31,0,0,0,108,20061208
2007,ATL,20,27,22,26,0,0,0,95,LAL,20,26,30,30,0,0,0,106,20061208
2007,MEM,16,20,20,38,0,0,0,94,MIL,28,22,32,18,0,0,0,100,20061208
2007,UTA,21,25,24,33,0,0,0,103,MIN,22,21,34,33,0,0,0,110,20061208
2007,DET,19,21,26,21,0,0,0,87,ORL,22,22,23,16,0,0,0,83,20061208
2007,WAS,20,28,33,32,0,0,0,113,PHI,29,23,21,25,0,0,0,98,20061208
2007,LAC,22,21,16,23,0,0,0,82,SAS,33,32,25,21,0,0,0,111,20061208
2007,NOK,18,15,29,12,0,0,0,74,SEA,27,22,25,20,0,0,0,94,20061208
2007,MIN,24,29,19,19,0,0,0,91,CHI,17,23,22,19,0,0,0,81,20061209
2007,IND,16,26,13,20,0,0,0,75,CLE,31,25,28,23,0,0,0,107,20061209
2007,DEN,25,16,29,20,0,0,0,90,DAL,41,21,21,22,0,0,0,105,20061209
2007,NOK,21,24,17,18,0,0,0,80,GSW,18,27,28,28,0,0,0,101,20061209
2007,LAC,23,25,19,22,0,0,0,89,MEM,20,21,19,22,0,0,0,82,20061209
2007,BOS,11,34,23,24,0,0,0,92,NJN,27,21,25,17,0,0,0,90,20061209
2007,MIL,26,30,22,29,0,0,0,107,NYK,29,30,36,20,0,0,0,115,20061209
2007,PHI,25,25,20,14,0,0,0,84,ORL,31,22,18,15,0,0,0,86,20061209
2007,HOU,20,31,29,34,0,0,0,114,WAS,23,29,23,34,0,0,0,109,20061209
2007,PHO,27,30,33,24,0,0,0,114,CHA,30,24,17,13,0,0,0,84,20061210
2007,SAS,28,20,22,29,0,0,0,99,LAL,21,25,37,23,0,0,0,106,20061210
2007,ATL,20,20,22,30,0,0,0,92,SAC,22,31,39,25,0,0,0,117,20061210
2007,GSW,38,34,16,27,0,0,0,115,SEA,25,31,31,30,0,0,0,117,20061210
2007,POR,24,26,20,23,0,0,0,93,TOR,21,20,21,21,0,0,0,83,20061210
2007,IND,25,25,25,16,0,0,0,91,CHI,42,24,23,17,0,0,0,106,20061211
2007,SAS,32,27,19,25,0,0,0,103,LAC,17,25,21,18,0,0,0,81,20061211
2007,TOR,23,15,22,17,0,0,0,77,MIA,24,34,17,24,0,0,0,99,20061211
2007,MEM,10,28,28,26,0,0,0,92,NJN,25,27,32,21,0,0,0,105,20061211
2007,CLE,25,26,22,16,0,0,0,89,NOK,21,30,21,23,0,0,0,95,20061211
2007,BOS,31,30,21,15,0,0,0,97,NYK,17,19,31,23,0,0,0,90,20061211
2007,PHO,25,30,30,18,0,0,0,103,ORL,26,27,14,22,0,0,0,89,20061211
2007,POR,19,24,14,24,0,0,0,81,PHI,13,24,24,18,0,0,0,79,20061211
2007,DAL,19,20,24,16,0,0,0,79,UTA,26,25,24,26,0,0,0,101,20061211
2007,DEN,22,21,28,29,0,0,0,100,ATL,29,25,16,17,0,0,0,87,20061212
2007,SAC,25,29,29,30,0,0,0,113,GSW,32,36,27,31,0,0,0,126,20061212
2007,LAL,21,33,30,18,0,0,0,102,HOU,25,26,13,30,0,0,0,94,20061212
2007,SEA,29,23,23,18,0,0,0,93,MIL,30,20,23,21,0,0,0,94,20061212
2007,SEA,18,15,27,24,0,0,0,84,CHI,31,18,29,21,0,0,0,99,20061213
2007,CHA,29,19,25,28,0,0,0,101,CLE,29,32,19,24,0,0,0,104,20061213
2007,LAL,21,26,34,20,0,0,0,101,DAL,33,23,27,27,0,0,0,110,20061213
2007,DET,25,24,22,19,0,0,0,90,IND,28,26,22,25,0,0,0,101,20061213
2007,UTA,21,26,28,30,0,0,0,105,LAC,28,14,26,18,0,0,0,86,20061213
2007,POR,27,21,16,21,0,0,0,85,MEM,14,21,22,22,0,0,0,79,20061213
2007,PHO,26,30,28,15,0,0,0,99,MIA,19,21,23,26,0,0,0,89,20061213
2007,MIL,23,24,26,22,0,0,0,95,NJN,27,23,27,31,0,0,0,108,20061213
2007,ATL,18,23,16,25,0,0,0,82,NYK,20,27,26,21,0,0,0,94,20061213
2007,TOR,26,18,21,26,0,0,0,91,ORL,18,26,16,24,0,0,0,84,20061213
2007,BOS,24,19,29,29,0,0,0,101,PHI,27,14,19,21,0,0,0,81,20061213
2007,MIN,28,28,15,11,0,0,0,82,SAS,26,22,25,22,0,0,0,95,20061213
2007,DEN,26,25,25,15,0,0,0,91,WAS,39,24,28,29,0,0,0,120,20061213
2007,ORL,18,20,26,25,0,0,0,89,CHA,15,30,27,27,0,0,0,99,20061214
2007,HOU,21,29,28,29,0,0,0,107,GSW,25,27,23,34,0,0,0,109,20061214
2007,SAS,29,24,32,18,0,0,0,103,NOK,22,20,20,15,0,0,0,77,20061214
2007,DEN,17,30,27,40,0,0,0,114,BOS,31,33,21,34,0,0,0,119,20061215
2007,MIL,21,34,26,30,0,0,0,111,CHI,27,28,33,29,0,0,0,117,20061215
2007,SEA,28,17,16,23,0,0,0,84,CLE,35,29,21,21,0,0,0,106,20061215
2007,PHI,11,23,28,17,0,0,0,79,DAL,27,22,20,24,0,0,0,93,20061215
2007,NYK,24,25,19,28,0,0,0,96,IND,22,42,28,20,0,0,0,112,20061215
2007,HOU,29,24,13,23,10,2,0,101,LAL,10,25,25,29,10,13,0,112,20061215
2007,ATL,22,25,20,30,0,0,0,97,MEM,16,21,23,28,0,0,0,88,20061215
2007,GSW,17,35,28,21,0,0,0,101,PHO,34,25,23,23,0,0,0,105,20061215
2007,LAC,27,26,19,27,0,0,0,99,POR,32,23,26,28,0,0,0,109,20061215
2007,NJN,14,21,21,22,0,0,0,78,TOR,24,21,19,26,0,0,0,90,20061215
2007,SAC,27,26,13,32,0,0,0,98,UTA,27,27,23,20,0,0,0,97,20061215
2007,MIA,17,32,27,19,0,0,0,95,WAS,40,20,23,23,0,0,0,106,20061215
2007,CHI,24,27,24,18,13,0,0,106,ATL,26,29,18,20,11,0,0,104,20061216
2007,BOS,27,33,18,28,0,0,0,106,CHA,26,24,31,19,0,0,0,100,20061216
2007,MEM,26,21,22,21,0,0,0,90,MIA,28,26,26,18,0,0,0,98,20061216
2007,MIN,28,23,23,30,0,0,0,104,MIL,21,24,31,32,0,0,0,108,20061216
2007,DET,29,15,25,21,0,0,0,90,NJN,27,22,20,13,0,0,0,82,20061216
2007,DAL,26,14,30,20,0,0,0,90,NOK,16,24,18,21,0,0,0,79,20061216
2007,DEN,29,38,27,29,0,0,0,123,NYK,22,32,30,16,0,0,0,100,20061216
2007,CLE,23,8,20,23,0,0,0,74,ORL,12,26,20,23,0,0,0,81,20061216
2007,PHO,19,26,35,25,0,0,0,105,SAC,29,21,23,25,0,0,0,98,20061216
2007,PHI,26,24,24,24,0,0,0,98,SAS,23,31,31,18,0,0,0,103,20061216
2007,SEA,28,22,24,19,0,0,0,93,DET,21,30,26,20,0,0,0,97,20061217
2007,UTA,29,24,30,21,0,0,0,104,IND,23,24,24,23,0,0,0,94,20061217
2007,HOU,26,19,34,29,0,0,0,108,LAC,26,20,25,32,0,0,0,103,20061217
2007,WAS,26,33,31,36,21,0,0,147,LAL,20,29,31,46,15,0,0,141,20061217
2007,GSW,28,29,26,32,0,0,0,115,TOR,34,29,32,25,0,0,0,120,20061217
2007,WAS,16,27,30,35,0,0,0,108,DEN,36,29,20,32,0,0,0,117,20061218
2007,SEA,26,26,32,15,16,11,0,126,MEM,25,25,29,20,16,19,0,134,20061218
2007,NOK,26,37,19,17,0,0,0,99,MIA,33,21,25,22,0,0,0,101,20061218
2007,GSW,26,27,31,13,0,0,0,97,NJN,28,21,29,27,0,0,0,105,20061218
2007,UTA,34,10,17,24,11,0,0,96,NYK,20,26,20,19,12,0,0,97,20061218
2007,DAL,33,21,24,31,0,0,0,109,SAC,18,22,27,24,0,0,0,91,20061218
2007,LAL,26,22,22,19,0,0,0,89,CHI,23,19,28,24,0,0,0,94,20061219
2007,TOR,25,19,26,28,0,0,0,98,PHO,33,20,37,25,0,0,0,115,20061219
2007,UTA,22,31,19,40,0,0,0,112,ATL,20,34,39,13,0,0,0,106,20061220
2007,GSW,29,29,18,20,0,0,0,96,BOS,29,19,23,24,0,0,0,95,20061220
2007,TOR,25,33,26,14,0,0,0,98,LAC,26,24,25,21,0,0,0,96,20061220
2007,MIA,22,34,15,24,0,0,0,95,MIL,30,23,30,38,0,0,0,121,20061220
2007,LAL,26,33,18,34,0,0,0,111,MIN,29,28,30,7,0,0,0,94,20061220
2007,CLE,28,24,19,40,0,0,0,111,NJN,29,22,27,35,0,0,0,113,20061220
2007,CHA,35,28,16,16,7,7,0,109,NYK,28,24,34,9,7,9,0,111,20061220
2007,NOK,13,28,27,15,0,0,0,83,ORL,26,15,23,22,0,0,0,86,20061220
2007,IND,24,23,25,29,0,0,0,101,PHI,27,21,20,25,0,0,0,93,20061220
2007,HOU,20,14,26,27,0,0,0,87,POR,20,24,26,19,0,0,0,89,20061220
2007,MEM,22,24,30,22,0,0,0,98,SAS,24,38,20,23,0,0,0,105,20061220
2007,DAL,24,21,28,30,0,0,0,103,SEA,31,25,16,23,0,0,0,95,20061220
2007,DET,22,20,15,30,0,0,0,87,CLE,24,17,14,16,0,0,0,71,20061221
2007,WAS,24,29,44,29,0,0,0,126,SAC,31,28,24,36,0,0,0,119,20061221
2007,IND,27,25,28,20,0,0,0,100,ATL,21,26,22,21,0,0,0,90,20061222
2007,PHI,24,24,25,25,0,0,0,98,BOS,20,21,22,20,0,0,0,83,20061222
2007,UTA,13,20,31,25,0,0,0,89,CHA,16,37,25,23,0,0,0,101,20061222
2007,LAC,22,23,14,24,0,0,0,83,DAL,26,37,34,18,0,0,0,115,20061222
2007,SAC,26,26,21,28,0,0,0,101,DEN,24,21,32,19,0,0,0,96,20061222
2007,MIL,29,30,24,30,0,0,0,113,MIN,31,21,27,28,0,0,0,107,20061222
2007,LAL,26,26,23,24,0,0,0,99,NJN,21,26,29,19,0,0,0,95,20061222
2007,MEM,22,18,30,20,7,0,0,97,NOK,21,24,20,25,10,0,0,100,20061222
2007,CHI,30,21,18,23,0,0,0,92,NYK,23,31,23,26,0,0,0,103,20061222
2007,GSW,23,25,32,37,0,0,0,117,ORL,31,21,29,27,0,0,0,108,20061222
2007,WAS,39,25,33,30,17,0,0,144,PHO,28,30,32,37,12,0,0,139,20061222
2007,TOR,25,27,16,22,11,0,0,101,POR,23,26,25,16,10,0,0,100,20061222
2007,HOU,30,23,21,23,0,0,0,97,SAS,21,15,23,19,0,0,0,78,20061222
2007,CHA,19,20,19,18,0,0,0,76,CHI,24,31,29,31,0,0,0,115,20061223
2007,ORL,25,19,21,18,0,0,0,83,CLE,21,19,22,24,0,0,0,86,20061223
2007,ATL,19,18,19,25,0,0,0,81,DET,26,20,35,27,0,0,0,108,20061223
2007,LAC,22,17,30,29,0,0,0,98,HOU,23,25,19,26,0,0,0,93,20061223
2007,MIN,20,20,17,21,0,0,0,78,IND,32,18,8,13,0,0,0,71,20061223
2007,UTA,20,25,30,25,0,0,0,100,MEM,28,20,30,19,0,0,0,97,20061223
2007,GSW,24,19,22,27,0,0,0,92,MIA,23,30,28,24,0,0,0,105,20061223
2007,NJN,22,19,30,33,0,0,0,104,MIL,29,25,35,26,0,0,0,115,20061223
2007,SAS,30,30,30,22,0,0,0,112,NOK,20,28,18,11,0,0,0,77,20061223
2007,NYK,17,20,19,21,0,0,0,77,PHI,26,26,23,23,0,0,0,98,20061223
2007,TOR,22,33,26,16,0,0,0,97,SEA,36,28,20,26,0,0,0,110,20061223
2007,LAL,16,24,24,21,0,0,0,85,MIA,30,17,27,27,0,0,0,101,20061225
2007,CHA,26,15,24,19,0,0,0,84,DAL,24,25,29,19,0,0,0,97,20061226
2007,BOS,25,22,31,27,0,0,0,105,DEN,27,30,31,28,0,0,0,116,20061226
2007,NJN,20,19,29,23,0,0,0,91,DET,31,16,20,25,0,0,0,92,20061226
2007,PHI,27,20,24,26,0,0,0,97,GSW,36,31,26,23,0,0,0,116,20061226
2007,HOU,24,15,19,18,0,0,0,76,IND,22,19,21,19,0,0,0,81,20061226
2007,CHI,17,23,27,31,0,0,0,98,MIN,29,26,27,18,0,0,0,100,20061226
2007,POR,14,18,25,30,0,0,0,87,PHO,25,24,27,34,0,0,0,110,20061226
2007,MIL,31,24,28,31,0,0,0,114,SAS,33,28,26,20,0,0,0,107,20061226
2007,NOK,27,20,25,22,0,0,0,94,SEA,26,23,23,30,0,0,0,102,20061226
2007,LAC,23,20,22,27,0,0,0,92,UTA,22,28,23,29,0,0,0,102,20061226
2007,MEM,18,33,20,30,0,0,0,101,WAS,45,32,22,17,0,0,0,116,20061226
2007,CLE,28,22,16,23,0,0,0,89,ATL,18,19,19,20,0,0,0,76,20061227
2007,WAS,39,27,16,32,0,0,0,114,CHA,28,28,27,24,0,0,0,107,20061227
2007,MIA,21,24,26,32,0,0,0,103,CHI,24,33,21,31,0,0,0,109,20061227
2007,BOS,28,15,19,15,0,0,0,77,LAC,31,24,28,17,0,0,0,100,20061227
2007,MIL,25,29,29,29,0,0,0,112,MEM,21,22,22,31,0,0,0,96,20061227
2007,HOU,18,31,22,25,0,0,0,96,NJN,12,27,17,15,0,0,0,71,20061227
2007,DET,29,31,29,27,6,15,8,145,NYK,28,33,27,28,6,15,14,151,20061227
2007,LAL,21,25,33,27,0,0,0,106,ORL,25,22,26,20,0,0,0,93,20061227
2007,NOK,21,25,14,25,0,0,0,85,POR,28,26,26,20,0,0,0,100,20061227
2007,PHI,18,14,31,13,0,0,0,76,SAC,20,25,30,26,0,0,0,101,20061227
2007,MIN,24,26,26,21,0,0,0,97,TOR,22,24,25,29,0,0,0,100,20061227
2007,PHO,20,29,27,23,0,0,0,99,DAL,30,22,26,23,0,0,0,101,20061228
2007,SEA,27,29,20,22,0,0,0,98,DEN,35,25,25,27,0,0,0,112,20061228
2007,UTA,24,19,17,23,0,0,0,83,SAS,29,29,29,19,0,0,0,106,20061228
2007,LAL,30,30,25,20,8,7,4,124,CHA,18,42,26,19,8,7,13,133,20061229
2007,MIL,19,21,31,28,0,0,0,99,CLE,34,26,19,30,0,0,0,109,20061229
2007,IND,22,26,19,26,0,0,0,93,DET,32,15,17,28,0,0,0,92,20061229
2007,BOS,21,27,23,29,0,0,0,100,GSW,33,20,28,29,0,0,0,110,20061229
2007,ATL,14,18,14,22,0,0,0,68,HOU,20,26,29,19,0,0,0,94,20061229
2007,SAC,24,21,24,24,0,0,0,93,LAC,25,21,34,22,0,0,0,102,20061229
2007,NJN,24,15,32,20,0,0,0,91,MIA,21,22,18,20,0,0,0,81,20061229
2007,SEA,20,19,14,29,0,0,0,82,MIN,28,28,21,24,0,0,0,101,20061229
2007,DEN,29,30,16,14,0,0,0,89,NOK,24,31,17,27,0,0,0,99,20061229
2007,NYK,14,25,28,19,0,0,0,86,PHO,34,22,25,27,0,0,0,108,20061229
2007,PHI,20,27,31,20,0,0,0,98,POR,30,21,20,24,0,0,0,95,20061229
2007,CHI,26,28,28,25,0,0,0,107,TOR,32,14,29,22,0,0,0,97,20061229
2007,ORL,31,32,19,29,0,0,0,111,WAS,26,33,26,27,0,0,0,112,20061229
2007,CLE,27,26,14,29,0,0,0,96,CHI,32,24,22,25,0,0,0,103,20061230
2007,NOK,26,15,15,24,0,0,0,80,DAL,30,23,24,17,0,0,0,94,20061230
2007,CHA,29,25,25,34,0,0,0,113,IND,25,25,27,25,0,0,0,102,20061230
2007,TOR,18,32,28,26,0,0,0,104,MEM,39,25,22,24,0,0,0,110,20061230
2007,WAS,23,28,34,17,0,0,0,102,MIL,23,25,34,37,0,0,0,119,20061230
2007,MIN,16,30,20,26,0,0,0,92,NJN,21,31,20,28,0,0,0,100,20061230
2007,MIA,27,10,20,11,0,0,0,68,ORL,27,21,26,23,0,0,0,97,20061230
2007,GSW,25,18,26,27,0,0,0,96,SAC,35,39,27,18,0,0,0,119,20061230
2007,POR,21,14,27,24,0,0,0,86,UTA,20,29,24,23,0,0,0,96,20061230
2007,DAL,20,24,19,26,0,0,0,89,DEN,24,26,19,16,0,0,0,85,20061231
2007,PHO,29,27,28,24,0,0,0,108,DET,22,28,28,23,0,0,0,101,20061231
2007,MEM,29,30,15,35,0,0,0,109,HOU,24,34,26,27,0,0,0,111,20061231
2007,NYK,22,16,17,25,0,0,0,80,LAC,28,23,23,16,0,0,0,90,20061231
2007,PHI,18,20,30,26,0,0,0,94,LAL,26,20,37,21,0,0,0,104,20061231
2007,ATL,23,16,22,20,0,0,0,81,SAS,20,22,25,28,0,0,0,95,20061231
2007,BOS,18,21,20,36,0,0,0,95,SEA,27,21,28,25,0,0,0,101,20061231
2007,MIN,20,27,21,34,0,0,0,102,CHA,29,26,23,18,0,0,0,96,20070101
2007,BOS,23,21,26,19,0,0,0,89,POR,27,17,23,14,0,0,0,81,20070101
2007,PHO,18,25,20,34,0,0,0,97,CHI,27,28,18,23,0,0,0,96,20070102
2007,SAS,21,19,10,28,0,0,0,78,CLE,21,12,11,38,0,0,0,82,20070102
2007,SEA,22,33,17,16,0,0,0,88,DAL,33,22,23,34,0,0,0,112,20070102
2007,PHI,26,26,34,22,0,0,0,108,DEN,16,36,21,24,0,0,0,97,20070102
2007,GSW,21,28,27,21,0,0,0,97,NOK,27,18,18,26,0,0,0,89,20070102
2007,LAC,28,20,15,23,0,0,0,86,ORL,23,18,26,24,0,0,0,91,20070102
2007,NYK,26,22,25,27,0,0,0,100,SAC,33,24,24,31,0,0,0,112,20070102
2007,CLE,19,30,33,25,0,0,0,107,BOS,21,33,22,28,0,0,0,104,20070103
2007,SEA,30,18,25,23,0,0,0,96,HOU,32,21,27,23,0,0,0,103,20070103
2007,GSW,36,32,31,36,0,0,0,135,MEM,32,35,34,43,0,0,0,144,20070103
2007,LAC,29,32,30,19,0,0,0,110,MIA,29,22,13,31,0,0,0,95,20070103
2007,SAS,20,22,29,22,8,0,0,101,MIN,31,24,26,12,10,0,0,103,20070103
2007,NYK,23,28,29,19,0,0,0,99,POR,24,18,18,21,0,0,0,81,20070103
2007,PHO,29,31,18,22,0,0,0,100,TOR,23,22,23,30,0,0,0,98,20070103
2007,PHI,24,21,23,19,0,0,0,87,UTA,22,19,35,22,0,0,0,98,20070103
2007,MIL,28,31,23,23,0,0,0,105,WAS,30,26,22,30,0,0,0,108,20070103
2007,IND,24,23,26,18,0,0,0,91,DAL,19,26,27,28,0,0,0,100,20070104
2007,DET,31,27,14,20,0,0,0,92,NOK,19,13,23,13,0,0,0,68,20070104
2007,LAL,33,41,16,27,15,0,0,132,SAC,18,40,25,34,11,0,0,128,20070104
2007,UTA,19,26,25,16,0,0,0,86,HOU,29,25,28,18,0,0,0,100,20070105
2007,DEN,28,27,26,23,0,0,0,104,LAL,35,33,36,19,0,0,0,123,20070105
2007,BOS,34,24,39,31,0,0,0,128,MEM,36,22,32,29,0,0,0,119,20070105
2007,CLE,26,22,20,27,0,0,0,95,MIL,28,23,23,12,0,0,0,86,20070105
2007,PHI,26,26,22,22,6,0,0,102,MIN,24,24,26,22,8,0,0,104,20070105
2007,CHI,23,20,25,18,0,0,0,86,NJN,15,33,18,25,0,0,0,91,20070105
2007,CHA,27,23,10,14,0,0,0,74,ORL,33,23,17,33,0,0,0,106,20070105
2007,MIA,24,21,26,9,0,0,0,80,PHO,29,31,23,25,0,0,0,108,20070105
2007,DAL,21,19,26,24,0,0,0,90,SAS,29,22,18,16,0,0,0,85,20070105
2007,NYK,36,32,25,18,0,0,0,111,SEA,21,30,19,23,0,0,0,93,20070105
2007,ATL,25,21,22,24,0,0,0,92,TOR,31,27,23,24,0,0,0,105,20070105
2007,LAC,39,18,23,25,0,0,0,105,WAS,29,37,27,23,0,0,0,116,20070105
2007,LAC,16,20,23,15,0,0,0,74,ATL,25,17,22,22,0,0,0,86,20070106
2007,DET,28,18,20,23,0,0,0,89,CHI,32,23,29,22,0,0,0,106,20070106
2007,NJN,21,17,27,26,0,0,0,91,CLE,27,19,25,25,0,0,0,96,20070106
2007,UTA,27,21,17,31,0,0,0,96,DEN,16,16,30,22,0,0,0,84,20070106
2007,SEA,28,29,18,29,0,0,0,104,GSW,25,26,27,30,0,0,0,108,20070106
2007,IND,23,27,21,29,0,0,0,100,NOK,18,28,24,23,0,0,0,93,20070106
2007,POR,28,32,19,16,15,0,0,110,SAC,31,28,24,12,10,0,0,105,20070106
2007,DAL,21,30,26,21,0,0,0,98,LAL,27,21,20,33,0,0,0,101,20070107
2007,SAS,28,29,31,22,0,0,0,110,MEM,21,24,29,22,0,0,0,96,20070107
2007,HOU,21,19,22,26,11,0,0,99,MIN,24,20,27,17,15,0,0,103,20070107
2007,BOS,17,21,18,23,0,0,0,79,ORL,29,25,12,21,0,0,0,87,20070107
2007,GSW,30,23,23,29,0,0,0,105,PHO,29,32,32,35,0,0,0,128,20070107
2007,MIA,22,30,17,24,0,0,0,93,POR,30,30,17,13,0,0,0,90,20070107
2007,WAS,22,29,19,41,0,0,0,111,TOR,31,26,27,32,0,0,0,116,20070107
2007,HOU,16,14,24,30,0,0,0,84,CHI,18,22,11,26,0,0,0,77,20070108
2007,MIL,29,20,19,24,0,0,0,92,DEN,35,25,19,25,0,0,0,104,20070108
2007,LAC,15,34,23,28,0,0,0,100,NOK,26,25,22,17,0,0,0,90,20070108
2007,ATL,16,17,16,23,0,0,0,72,IND,17,21,23,30,0,0,0,91,20070109
2007,LAL,24,33,22,39,0,0,0,118,MEM,20,32,46,30,0,0,0,128,20070109
2007,TOR,19,29,17,21,0,0,0,86,NJN,24,23,27,27,0,0,0,101,20070109
2007,DET,24,23,33,18,0,0,0,98,PHI,22,22,20,25,0,0,0,89,20070109
2007,SEA,33,27,14,28,0,0,0,102,PHO,28,30,22,33,0,0,0,113,20070109
2007,CLE,22,16,37,33,0,0,0,108,SAC,30,23,17,28,0,0,0,98,20070109
2007,POR,21,23,24,16,0,0,0,84,SAS,18,33,26,21,0,0,0,98,20070109
2007,DAL,26,19,36,27,0,0,0,108,UTA,24,29,29,23,0,0,0,105,20070109
2007,NOK,23,25,22,26,0,0,0,96,ATL,23,20,13,21,0,0,0,77,20070110
2007,IND,22,30,28,17,0,0,0,97,BOS,27,25,14,18,0,0,0,84,20070110
2007,POR,22,12,19,21,0,0,0,74,DAL,22,25,25,27,0,0,0,99,20070110
2007,SAS,26,22,20,24,0,0,0,92,DEN,25,24,16,18,0,0,0,83,20070110
2007,CHA,18,27,23,35,0,0,0,103,DET,27,8,30,31,0,0,0,96,20070110
2007,ORL,24,18,20,29,0,0,0,91,GSW,18,29,10,19,0,0,0,76,20070110
2007,LAL,22,24,12,19,0,0,0,77,HOU,24,23,25,30,0,0,0,102,20070110
2007,TOR,28,26,17,19,0,0,0,90,MIL,28,18,11,20,0,0,0,77,20070110
2007,LAC,24,23,25,20,0,0,0,92,MIN,18,28,24,21,0,0,0,91,20070110
2007,PHI,21,21,22,35,0,0,0,99,NYK,32,29,19,26,0,0,0,106,20070110
2007,MIA,26,22,31,28,0,0,0,107,SEA,30,25,24,24,0,0,0,103,20070110
2007,CHI,18,25,28,32,0,0,0,103,WAS,27,19,30,37,0,0,0,113,20070110
2007,NJN,15,20,26,25,0,0,0,86,CHI,28,21,16,18,0,0,0,83,20070111
2007,CLE,26,15,18,31,0,0,0,90,PHO,33,34,24,18,0,0,0,109,20070111
2007,DET,20,22,26,25,0,0,0,93,ATL,25,24,28,22,0,0,0,99,20070112
2007,TOR,21,20,26,28,0,0,0,95,BOS,15,25,18,28,0,0,0,86,20070112
2007,HOU,17,27,23,23,0,0,0,90,DEN,20,21,23,22,0,0,0,86,20070112
2007,MIA,30,34,31,23,0,0,0,118,GSW,29,25,17,25,0,0,0,96,20070112
2007,DAL,17,27,30,29,12,0,0,115,IND,26,25,22,30,10,0,0,113,20070112
2007,ORL,29,24,28,25,0,0,0,106,LAL,26,29,27,27,0,0,0,109,20070112
2007,MIN,36,28,27,25,0,0,0,116,MEM,19,30,30,31,0,0,0,110,20070112
2007,WAS,32,19,22,24,0,0,0,97,NOK,24,27,25,28,0,0,0,104,20070112
2007,CHA,26,26,36,38,0,0,0,126,NYK,30,21,27,32,0,0,0,110,20070112
2007,MIL,25,29,24,19,0,0,0,97,PHI,21,25,38,26,0,0,0,110,20070112
2007,SAC,24,16,24,23,0,0,0,87,POR,16,26,26,27,0,0,0,95,20070112
2007,UTA,26,28,19,33,8,0,0,114,SEA,21,29,23,33,16,0,0,122,20070112
2007,PHI,14,20,28,21,0,0,0,83,CHA,23,19,25,22,0,0,0,89,20070113
2007,MEM,21,17,19,9,0,0,0,66,CHI,37,34,26,14,0,0,0,111,20070113
2007,BOS,27,16,17,13,0,0,0,73,DET,26,23,11,21,0,0,0,81,20070113
2007,CLE,24,23,32,25,0,0,0,104,LAC,27,21,21,23,0,0,0,92,20070113
2007,NJN,24,24,29,21,0,0,0,98,MIN,19,27,26,37,0,0,0,109,20070113
2007,ORL,25,24,34,18,0,0,0,101,PHO,30,30,30,17,0,0,0,107,20070113
2007,HOU,25,21,31,24,14,0,0,115,SAC,26,26,23,26,10,0,0,111,20070113
2007,WAS,15,23,16,26,0,0,0,80,SAS,29,15,25,24,0,0,0,93,20070113
2007,MIA,25,39,33,22,0,0,0,119,UTA,21,27,36,26,0,0,0,110,20070113
2007,DEN,31,18,41,19,0,0,0,109,POR,19,37,17,20,0,0,0,93,20070114
2007,DAL,22,26,23,26,0,0,0,97,TOR,32,27,18,19,0,0,0,96,20070114
2007,BOS,15,25,26,30,0,0,0,96,ATL,22,25,29,24,0,0,0,100,20070115
2007,MIL,26,26,24,23,0,0,0,99,CHA,27,24,23,17,0,0,0,91,20070115
2007,SAS,24,21,19,23,0,0,0,87,CHI,21,31,22,25,0,0,0,99,20070115
2007,MIN,27,15,20,17,15,0,0,94,DET,22,21,20,16,11,0,0,90,20070115
2007,LAC,23,28,28,14,0,0,0,93,GSW,24,36,21,27,0,0,0,108,20070115
2007,MIA,29,30,28,23,8,0,0,118,LAL,33,28,27,22,14,0,0,124,20070115
2007,PHO,32,44,34,27,0,0,0,137,MEM,35,37,24,26,0,0,0,122,20070115
2007,IND,24,18,21,32,0,0,0,95,NJN,35,28,25,17,0,0,0,105,20070115
2007,SAC,27,20,29,21,0,0,0,97,NYK,23,26,26,27,0,0,0,102,20070115
2007,TOR,24,26,32,22,0,0,0,104,PHI,24,20,14,28,0,0,0,86,20070115
2007,UTA,31,27,20,33,0,0,0,111,WAS,27,21,34,32,0,0,0,114,20070115
2007,HOU,30,23,21,22,0,0,0,96,DAL,25,22,29,33,0,0,0,109,20070116
2007,ORL,19,14,20,22,3,0,0,78,NOK,20,18,23,14,9,0,0,84,20070116
2007,CLE,28,26,19,23,0,0,0,96,SEA,24,25,24,28,0,0,0,101,20070116
2007,NJN,20,33,21,18,0,0,0,92,CHA,18,16,26,25,0,0,0,85,20070117
2007,UTA,26,20,26,28,0,0,0,100,DET,24,27,19,29,0,0,0,99,20070117
2007,PHO,19,29,31,21,0,0,0,100,HOU,28,23,24,16,0,0,0,91,20070117
2007,GSW,27,28,28,26,0,0,0,109,LAC,35,29,32,19,0,0,0,115,20070117
2007,PHI,24,25,29,24,0,0,0,102,MEM,37,33,23,25,0,0,0,118,20070117
2007,CHI,26,23,18,32,0,0,0,99,MIL,31,20,22,17,0,0,0,90,20070117
2007,ATL,26,30,27,22,0,0,0,105,MIN,22,23,20,23,0,0,0,88,20070117
2007,CLE,9,28,14,25,0,0,0,76,POR,18,23,29,24,0,0,0,94,20070117
2007,LAL,19,30,24,27,0,0,0,100,SAS,25,28,18,25,0,0,0,96,20070117
2007,SAC,25,18,26,16,0,0,0,85,TOR,23,25,20,33,0,0,0,101,20070117
2007,NYK,24,29,17,28,0,0,0,98,WAS,25,31,25,18,0,0,0,99,20070117
2007,LAL,28,20,24,23,0,0,0,95,DAL,26,34,35,19,0,0,0,114,20070118
2007,IND,22,27,21,31,0,0,0,101,MIA,23,32,30,19,0,0,0,104,20070118
2007,CHA,21,32,22,21,0,0,0,96,ATL,21,20,16,18,0,0,0,75,20070119
2007,SAC,21,20,21,34,0,0,0,96,BOS,22,22,23,24,0,0,0,91,20070119
2007,CLE,22,23,25,29,0,0,0,99,DEN,29,35,24,22,0,0,0,110,20070119
2007,DET,20,19,14,26,12,13,0,104,MIN,21,18,19,21,12,7,0,98,20070119
2007,NJN,22,32,21,26,0,0,0,101,NYK,24,24,18,34,0,0,0,100,20070119
2007,WAS,21,24,38,31,0,0,0,114,ORL,23,22,30,18,0,0,0,93,20070119
2007,MIA,15,19,29,26,6,0,0,95,PHI,25,22,20,22,9,0,0,98,20070119
2007,POR,28,20,21,32,0,0,0,101,PHO,25,30,26,25,0,0,0,106,20070119
2007,NOK,12,24,24,26,0,0,0,86,SAS,26,27,23,23,0,0,0,99,20070119
2007,MIL,13,16,22,21,0,0,0,72,SEA,27,24,28,20,0,0,0,99,20070119
2007,UTA,26,31,23,22,0,0,0,102,TOR,28,24,19,23,0,0,0,94,20070119
2007,ATL,20,23,22,20,0,0,0,85,CHA,25,23,27,29,0,0,0,104,20070120
2007,UTA,22,20,25,28,0,0,0,95,CHI,17,21,24,23,0,0,0,85,20070120
2007,SAC,12,22,15,25,0,0,0,74,DET,22,26,27,16,0,0,0,91,20070120
2007,CLE,25,19,29,25,8,0,0,106,GSW,27,35,23,13,6,0,0,104,20070120
2007,DEN,25,28,24,31,13,0,0,121,HOU,31,27,28,22,5,0,0,113,20070120
2007,NYK,23,29,27,29,0,0,0,108,IND,22,23,32,29,0,0,0,106,20070120
2007,MEM,28,12,28,23,0,0,0,91,LAC,24,39,26,23,0,0,0,112,20070120
2007,ORL,23,25,20,26,0,0,0,94,NJN,21,17,31,32,0,0,0,101,20070120
2007,LAL,29,22,31,21,0,0,0,103,NOK,25,34,24,30,0,0,0,113,20070120
2007,BOS,26,23,35,18,8,0,0,110,WAS,39,23,23,17,13,0,0,115,20070120
2007,DAL,31,20,23,25,0,0,0,99,MIA,23,17,27,26,0,0,0,93,20070121
2007,SAS,30,31,17,21,0,0,0,99,PHI,15,26,24,20,0,0,0,85,20070121
2007,MIN,28,23,20,31,0,0,0,102,PHO,35,23,46,27,0,0,0,131,20070121
2007,MIL,20,25,18,32,0,0,0,95,POR,30,28,17,24,0,0,0,99,20070121
2007,SAS,20,30,27,16,0,0,0,93,BOS,24,14,25,26,0,0,0,89,20070122
2007,ORL,26,28,17,19,0,0,0,90,CLE,20,18,22,19,0,0,0,79,20070122
2007,MEM,18,29,23,28,0,0,0,98,DEN,38,21,29,27,0,0,0,115,20070122
2007,CHI,23,20,28,20,0,0,0,91,IND,27,33,17,21,0,0,0,98,20070122
2007,GSW,35,22,28,18,0,0,0,103,LAL,32,29,19,28,0,0,0,108,20070122
2007,NYK,12,29,23,19,0,0,0,83,MIA,40,16,21,24,0,0,0,101,20070122
2007,NJN,20,27,29,11,0,0,0,87,SAC,21,24,19,24,0,0,0,88,20070122
2007,CHA,27,26,8,23,0,0,0,84,TOR,37,19,21,28,0,0,0,105,20070122
2007,MIN,23,13,30,25,0,0,0,91,UTA,20,29,34,23,0,0,0,106,20070122
2007,ATL,20,17,22,27,0,0,0,86,CHI,27,14,29,24,0,0,0,94,20070123
2007,MIL,24,34,16,22,0,0,0,96,LAC,34,35,20,26,0,0,0,115,20070123
2007,DAL,34,27,28,22,0,0,0,111,ORL,18,27,33,17,0,0,0,95,20070123
2007,NOK,21,19,25,31,0,0,0,96,PHI,30,24,22,26,0,0,0,102,20070123
2007,DEN,25,28,32,32,0,0,0,117,SEA,28,32,18,34,0,0,0,112,20070123
2007,PHO,41,35,24,27,0,0,0,127,WAS,20,31,30,24,0,0,0,105,20070123
2007,ATL,10,19,27,26,0,0,0,82,BOS,28,16,18,14,0,0,0,76,20070124
2007,DET,20,25,26,32,0,0,0,103,CHA,23,21,21,27,0,0,0,92,20070124
2007,PHI,18,23,22,29,8,18,0,118,CLE,18,23,25,26,8,15,0,115,20070124
2007,NJN,36,22,24,27,0,0,0,109,GSW,20,32,28,30,0,0,0,110,20070124
2007,MIA,26,15,29,17,7,0,0,94,IND,21,13,23,30,9,0,0,96,20070124
2007,PHO,24,25,32,31,0,0,0,112,NYK,25,21,22,39,0,0,0,107,20070124
2007,MIN,22,24,22,19,11,0,0,98,POR,23,23,20,21,14,0,0,101,20070124
2007,MIL,27,20,24,35,0,0,0,106,SAC,37,21,23,33,0,0,0,114,20070124
2007,HOU,16,20,25,29,0,0,0,90,SAS,21,16,21,27,0,0,0,85,20070124
2007,NOK,31,19,19,19,0,0,0,88,TOR,22,22,20,26,0,0,0,90,20070124
2007,MEM,24,32,31,31,14,0,0,132,UTA,28,27,33,30,12,0,0,130,20070124
2007,DAL,13,28,15,29,0,0,0,85,CHI,27,20,20,29,0,0,0,96,20070125
2007,NJN,24,16,30,31,0,0,0,101,LAC,31,26,24,21,0,0,0,102,20070125
2007,WAS,23,23,26,27,0,0,0,99,DET,26,22,16,32,0,0,0,96,20070126
2007,POR,20,14,14,21,0,0,0,69,HOU,19,17,32,31,0,0,0,99,20070126
2007,CHA,27,24,21,19,15,0,0,106,LAL,21,28,25,17,6,0,0,97,20070126
2007,PHO,22,30,26,20,0,0,0,98,MIL,16,34,21,19,0,0,0,90,20070126
2007,SAC,21,29,10,24,0,0,0,84,NOK,23,23,21,21,0,0,0,88,20070126
2007,MIA,33,16,27,20,0,0,0,96,NYK,27,38,31,20,0,0,0,116,20070126
2007,ATL,29,12,29,23,0,0,0,93,ORL,25,30,18,17,0,0,0,90,20070126
2007,CLE,25,18,29,33,0,0,0,105,PHI,38,22,18,19,0,0,0,97,20070126
2007,MEM,21,26,34,15,0,0,0,96,SAS,29,33,19,31,0,0,0,112,20070126
2007,MIN,21,28,25,26,0,0,0,100,SEA,25,27,26,24,0,0,0,102,20070126
2007,BOS,17,26,28,19,0,0,0,90,TOR,24,25,20,27,0,0,0,96,20070126
2007,DEN,36,31,24,20,0,0,0,111,UTA,32,30,25,29,0,0,0,116,20070126
2007,PHI,27,28,21,28,0,0,0,104,ATL,18,30,21,20,0,0,0,89,20070127
2007,MIA,13,33,21,30,0,0,0,97,CHI,27,27,23,23,0,0,0,100,20070127
2007,SAC,22,27,30,25,0,0,0,104,DAL,25,27,23,31,0,0,0,106,20070127
2007,NJN,20,32,28,32,0,0,0,112,DEN,31,22,23,26,0,0,0,102,20070127
2007,CHA,25,29,22,29,0,0,0,105,GSW,40,23,38,30,0,0,0,131,20070127
2007,TOR,23,17,21,23,0,0,0,84,IND,18,21,30,33,0,0,0,102,20070127
2007,MIN,25,21,26,29,0,0,0,101,LAC,16,22,31,18,0,0,0,87,20070127
2007,POR,21,26,38,26,5,19,0,135,MEM,28,31,28,24,5,16,0,132,20070127
2007,UTA,18,16,21,28,0,0,0,83,NOK,27,14,26,27,0,0,0,94,20070127
2007,WAS,30,18,29,28,0,0,0,105,BOS,29,21,20,21,0,0,0,91,20070128
2007,PHO,23,35,33,24,0,0,0,115,CLE,26,30,31,13,0,0,0,100,20070128
2007,IND,12,31,22,22,0,0,0,87,DET,27,20,27,21,0,0,0,95,20070128
2007,SAS,19,17,21,23,16,0,0,96,LAL,16,28,23,13,14,0,0,94,20070128
2007,NYK,20,27,22,36,0,0,0,105,MIL,24,28,26,29,0,0,0,107,20070128
2007,LAC,28,25,36,9,0,0,0,98,SEA,19,12,25,20,0,0,0,76,20070128
2007,ORL,21,20,17,25,0,0,0,83,ATL,29,19,23,22,0,0,0,93,20070129
2007,CHA,31,30,20,24,0,0,0,105,DEN,34,24,21,22,0,0,0,101,20070129
2007,PHI,21,13,17,33,0,0,0,84,HOU,29,29,31,16,0,0,0,105,20070129
2007,SAC,34,32,27,24,0,0,0,117,MEM,34,21,28,41,0,0,0,124,20070129
2007,PHO,31,37,27,17,0,0,0,112,MIN,29,31,34,27,0,0,0,121,20070129
2007,POR,25,21,25,20,0,0,0,91,NOK,29,19,28,27,0,0,0,103,20070129
2007,NJN,20,33,35,28,0,0,0,116,UTA,26,30,31,28,0,0,0,115,20070129
2007,GSW,22,25,29,21,0,0,0,97,CLE,37,30,24,33,0,0,0,124,20070130
2007,SEA,28,26,26,22,0,0,0,102,DAL,28,38,19,37,0,0,0,122,20070130
2007,BOS,30,13,13,40,0,0,0,96,IND,24,28,24,27,0,0,0,103,20070130
2007,MIL,14,23,25,18,0,0,0,80,MIA,35,31,25,19,0,0,0,110,20070130
2007,LAL,20,21,23,30,0,0,0,94,NYK,25,18,30,26,0,0,0,99,20070130
2007,DET,18,24,22,35,0,0,0,99,WAS,30,25,19,30,0,0,0,104,20070130
2007,GSW,29,27,19,19,0,0,0,94,ATL,30,40,22,23,0,0,0,115,20070131
2007,LAL,35,22,26,28,0,0,0,111,BOS,23,26,24,25,0,0,0,98,20070131
2007,NYK,30,24,18,15,0,0,0,87,CHA,26,30,22,26,0,0,0,104,20070131
2007,SEA,29,22,31,20,0,0,0,102,HOU,31,28,26,27,0,0,0,112,20070131
2007,CHI,23,22,26,27,0,0,0,98,LAC,31,26,22,31,0,0,0,110,20070131
2007,DAL,23,17,23,32,0,0,0,95,MEM,20,13,28,33,0,0,0,94,20070131
2007,SAC,26,28,26,20,0,0,0,100,MIN,22,19,29,28,0,0,0,98,20070131
2007,DET,30,32,31,20,0,0,0,113,NJN,27,24,18,20,0,0,0,89,20070131
2007,PHI,18,27,26,18,0,0,0,89,NOK,18,16,23,21,0,0,0,78,20070131
2007,MIL,13,16,24,20,0,0,0,73,ORL,31,25,13,29,0,0,0,98,20070131
2007,DEN,22,20,24,25,0,0,0,91,POR,24,16,26,34,0,0,0,100,20070131
2007,WAS,17,29,34,29,0,0,0,109,TOR,28,26,43,22,0,0,0,119,20070131
2007,SAS,17,30,16,30,0,0,0,93,UTA,20,25,26,26,0,0,0,97,20070131
2007,CLE,16,25,25,23,0,0,0,89,MIA,17,21,20,34,0,0,0,92,20070201
2007,SAS,22,31,17,17,0,0,0,87,PHO,16,34,22,31,0,0,0,103,20070201
2007,TOR,31,32,21,19,0,0,0,103,ATL,21,25,26,19,0,0,0,91,20070202
2007,LAC,25,22,20,33,0,0,0,100,BOS,21,21,27,20,0,0,0,89,20070202
2007,CHA,19,15,21,26,0,0,0,81,CLE,24,26,21,30,0,0,0,101,20070202
2007,POR,23,20,23,31,10,0,0,107,DEN,13,28,24,32,17,0,0,114,20070202
2007,MIL,20,21,21,24,0,0,0,86,DET,19,25,28,24,0,0,0,96,20070202
2007,LAL,18,23,29,14,0,0,0,84,IND,26,18,19,32,0,0,0,95,20070202
2007,MIN,22,23,16,22,0,0,0,83,NOK,29,19,18,24,0,0,0,90,20070202
2007,NJN,15,22,24,25,0,0,0,86,ORL,29,30,33,27,0,0,0,119,20070202
2007,GSW,20,22,33,27,0,0,0,102,PHI,17,31,20,33,0,0,0,101,20070202
2007,CHI,30,25,24,28,0,0,0,107,SEA,32,24,17,28,0,0,0,101,20070202
2007,GSW,28,25,21,16,0,0,0,90,CHA,24,25,28,21,0,0,0,98,20070203
2007,MIN,26,21,22,24,0,0,0,93,DAL,27,29,22,16,0,0,0,94,20070203
2007,NOK,17,16,30,24,0,0,0,87,HOU,15,15,19,25,0,0,0,74,20070203
2007,IND,31,25,35,25,0,0,0,116,MEM,28,34,27,21,0,0,0,110,20070203
2007,MIA,22,27,41,27,0,0,0,117,MIL,22,31,25,20,0,0,0,98,20070203
2007,NYK,23,26,22,23,0,0,0,94,ORL,18,16,24,28,0,0,0,86,20070203
2007,UTA,29,29,28,22,0,0,0,108,PHO,30,19,32,24,0,0,0,105,20070203
2007,CHI,12,33,14,29,0,0,0,88,POR,16,12,28,30,0,0,0,86,20070203
2007,DEN,27,16,25,19,0,0,0,87,SAC,24,29,19,22,0,0,0,94,20070203
2007,LAL,29,25,32,32,0,0,0,118,WAS,29,21,26,26,0,0,0,102,20070203
2007,DET,27,23,20,20,0,0,0,90,CLE,24,19,16,19,0,0,0,78,20070204
2007,ATL,22,21,24,19,15,0,0,101,NJN,24,18,18,26,13,0,0,99,20070204
2007,LAC,29,25,28,28,0,0,0,110,TOR,36,30,26,30,0,0,0,122,20070204
2007,LAL,16,24,22,28,0,0,0,90,ATL,14,17,26,26,0,0,0,83,20070205
2007,PHO,28,23,30,32,0,0,0,113,DEN,27,33,19,29,0,0,0,108,20070205
2007,MIN,15,15,22,25,0,0,0,77,HOU,21,29,32,23,0,0,0,105,20070205
2007,GSW,34,31,26,22,0,0,0,113,IND,18,24,30,26,0,0,0,98,20070205
2007,CHA,21,26,23,23,0,0,0,93,MIA,32,33,22,26,0,0,0,113,20070205
2007,NJN,23,24,16,25,10,0,0,98,PHI,27,15,20,26,12,0,0,100,20070205
2007,NOK,24,26,29,20,0,0,0,99,SAC,40,23,24,18,0,0,0,105,20070205
2007,CHI,25,18,21,31,0,0,0,95,UTA,24,33,14,29,0,0,0,100,20070205
2007,SEA,31,28,20,29,0,0,0,108,WAS,31,25,32,30,0,0,0,118,20070205
2007,BOS,20,20,27,35,0,0,0,102,DET,25,31,33,20,0,0,0,109,20070206
2007,HOU,25,29,25,19,0,0,0,98,MEM,21,22,31,16,0,0,0,90,20070206
2007,ORL,26,33,23,29,0,0,0,111,MIL,28,35,25,28,0,0,0,116,20070206
2007,LAC,28,25,11,26,0,0,0,90,NYK,19,24,27,32,0,0,0,102,20070206
2007,PHO,34,17,24,21,13,0,0,109,POR,22,25,24,25,6,0,0,102,20070206
2007,NJN,12,24,25,26,0,0,0,87,ATL,20,20,17,28,0,0,0,85,20070207
2007,MIA,17,27,26,21,0,0,0,91,BOS,27,13,18,21,0,0,0,79,20070207
2007,LAC,26,17,18,16,0,0,0,77,CLE,28,26,20,20,0,0,0,94,20070207
2007,MEM,24,21,20,32,0,0,0,97,DAL,40,25,24,24,0,0,0,113,20070207
2007,NOK,22,29,27,25,11,0,0,114,DEN,31,25,25,22,9,0,0,112,20070207
2007,SEA,25,26,21,31,0,0,0,103,IND,23,25,31,23,0,0,0,102,20070207
2007,GSW,27,18,27,21,0,0,0,93,MIN,32,31,26,32,0,0,0,121,20070207
2007,CHA,16,23,21,23,0,0,0,83,PHI,29,23,22,18,0,0,0,92,20070207
2007,ORL,27,25,24,27,0,0,0,103,TOR,24,28,25,36,0,0,0,113,20070207
2007,SAS,33,26,25,26,0,0,0,110,WAS,16,23,31,13,0,0,0,83,20070207
2007,LAL,17,19,23,19,0,0,0,78,DET,28,20,25,20,0,0,0,93,20070208
2007,MIL,25,20,19,26,7,4,0,101,NOK,27,24,23,16,7,12,0,109,20070208
2007,CHI,23,12,23,19,0,0,0,77,SAC,18,19,23,26,0,0,0,86,20070208
2007,NJN,19,23,27,23,0,0,0,92,BOS,16,23,17,22,0,0,0,78,20070209
2007,POR,21,21,27,18,21,0,0,108,CHA,18,30,24,15,13,0,0,100,20070209
2007,MIA,17,16,24,22,0,0,0,79,CLE,23,21,25,34,0,0,0,103,20070209
2007,HOU,24,15,14,21,0,0,0,74,DAL,20,23,29,23,0,0,0,95,20070209
2007,CHI,30,31,32,19,9,0,0,121,GSW,35,29,15,33,11,0,0,123,20070209
2007,DEN,20,20,36,26,0,0,0,102,IND,16,24,23,32,0,0,0,95,20070209
2007,MIN,23,20,29,20,5,0,0,97,MEM,24,22,21,25,13,0,0,105,20070209
2007,SAS,27,32,21,24,0,0,0,104,ORL,20,28,32,26,0,0,0,106,20070209
2007,LAC,22,19,16,33,0,0,0,90,PHI,22,19,23,25,0,0,0,89,20070209
2007,ATL,22,27,31,40,0,0,0,120,PHO,20,25,36,30,0,0,0,111,20070209
2007,LAL,17,23,25,27,0,0,0,92,TOR,16,27,29,24,0,0,0,96,20070209
2007,TOR,24,25,24,19,0,0,0,92,DET,18,25,33,22,0,0,0,98,20070210
2007,CHA,28,18,20,17,0,0,0,83,HOU,29,31,22,22,0,0,0,104,20070210
2007,DEN,22,27,31,29,0,0,0,109,MIL,23,26,25,28,0,0,0,102,20070210
2007,ORL,28,15,20,15,0,0,0,78,NJN,28,21,17,27,0,0,0,93,20070210
2007,MEM,27,20,24,28,0,0,0,99,NOK,29,27,35,23,0,0,0,114,20070210
2007,SAC,27,36,26,25,0,0,0,114,SEA,23,23,26,21,0,0,0,93,20070210
2007,NYK,28,17,31,17,9,0,0,102,UTA,24,25,17,27,11,0,0,104,20070210
2007,LAL,23,18,26,23,0,0,0,90,CLE,24,28,12,35,0,0,0,99,20070211
2007,ATL,34,24,26,22,0,0,0,106,GSW,26,23,30,26,0,0,0,105,20070211
2007,LAC,17,15,30,18,0,0,0,80,IND,20,32,25,17,0,0,0,94,20070211
2007,SAS,22,24,19,20,0,0,0,85,MIA,22,23,24,31,0,0,0,100,20070211
2007,BOS,31,25,29,22,0,0,0,107,MIN,24,27,36,22,0,0,0,109,20070211
2007,DAL,25,38,21,22,0,0,0,106,PHI,18,21,26,24,0,0,0,89,20070211
2007,CHI,29,32,18,37,0,0,0,116,PHO,20,30,34,19,0,0,0,103,20070211
2007,SEA,27,32,26,29,0,0,0,114,SAC,23,20,27,33,0,0,0,103,20070211
2007,POR,21,20,22,31,0,0,0,94,WAS,12,18,19,24,0,0,0,73,20070211
2007,GSW,36,23,28,24,0,0,0,111,DEN,33,32,40,18,0,0,0,123,20070212
2007,LAC,23,15,18,18,0,0,0,74,DET,27,18,26,21,0,0,0,92,20070212
2007,ATL,13,19,18,26,0,0,0,76,UTA,22,28,29,23,0,0,0,102,20070212
2007,TOR,33,23,31,25,0,0,0,112,CHI,26,25,31,29,0,0,0,111,20070213
2007,SAC,25,26,29,17,7,0,0,104,HOU,22,32,23,20,12,0,0,109,20070213
2007,NYK,17,32,32,26,0,0,0,107,LAL,19,35,26,26,0,0,0,106,20070213
2007,NOK,30,22,27,25,0,0,0,104,MEM,23,29,21,35,0,0,0,108,20070213
2007,POR,24,20,26,15,0,0,0,85,MIA,22,24,27,31,0,0,0,104,20070213
2007,DAL,22,23,26,28,0,0,0,99,MIL,30,28,24,11,0,0,0,93,20070213
2007,SAS,26,33,20,28,0,0,0,107,NJN,22,16,22,22,0,0,0,82,20070213
2007,MIL,32,22,20,23,0,0,0,97,BOS,19,39,31,28,0,0,0,117,20070214
2007,CHI,29,16,20,20,0,0,0,85,CHA,24,25,26,25,0,0,0,100,20070214
2007,SAS,25,26,19,20,0,0,0,90,DET,19,15,20,27,0,0,0,81,20070214
2007,NYK,19,19,40,23,0,0,0,101,GSW,30,32,30,28,0,0,0,120,20070214
2007,MEM,33,23,27,21,0,0,0,104,IND,26,25,36,27,0,0,0,114,20070214
2007,ATL,24,19,19,34,0,0,0,96,LAC,19,26,30,18,0,0,0,93,20070214
2007,DEN,28,22,26,18,0,0,0,94,MIN,23,28,22,26,0,0,0,99,20070214
2007,SAC,22,25,21,25,0,0,0,93,NOK,26,31,28,25,0,0,0,110,20070214
2007,POR,20,19,23,29,0,0,0,91,ORL,21,31,29,22,0,0,0,103,20070214
2007,WAS,22,22,21,27,0,0,0,92,PHI,23,22,17,23,0,0,0,85,20070214
2007,PHO,21,31,25,13,0,0,0,90,SEA,30,33,29,22,0,0,0,114,20070214
2007,NJN,23,28,35,23,0,0,0,109,TOR,32,29,32,27,0,0,0,120,20070214
2007,CLE,29,23,20,26,0,0,0,98,UTA,19,26,23,31,0,0,0,99,20070214
2007,DAL,21,17,20,22,0,0,0,80,HOU,23,22,12,20,0,0,0,77,20070215
2007,CLE,29,27,35,23,0,0,0,114,LAL,28,26,31,23,0,0,0,108,20070215
2007,NOK,24,20,34,22,0,0,0,100,CHA,25,28,24,27,0,0,0,104,20070220
2007,ATL,19,24,8,30,0,0,0,81,CHI,26,22,28,30,0,0,0,106,20070220
2007,PHO,38,24,30,23,0,0,0,115,LAC,26,19,23,22,0,0,0,90,20070220
2007,DET,28,19,16,21,0,0,0,84,MIL,18,23,23,19,0,0,0,83,20070220
2007,ORL,22,23,31,18,0,0,0,94,NYK,23,26,30,21,0,0,0,100,20070220
2007,UTA,30,22,19,29,0,0,0,100,POR,27,25,25,26,0,0,0,103,20070220
2007,BOS,26,36,19,20,0,0,0,101,SAC,34,32,25,13,0,0,0,104,20070220
2007,DEN,21,17,10,32,0,0,0,80,SAS,25,24,30,16,0,0,0,95,20070220
2007,MEM,24,34,22,25,0,0,0,105,SEA,32,32,32,25,0,0,0,121,20070220
2007,MIN,19,25,30,26,0,0,0,100,WAS,31,26,26,29,0,0,0,112,20070220
2007,SAS,23,29,18,33,0,0,0,103,ATL,21,22,27,26,0,0,0,96,20070221
2007,ORL,27,16,22,23,0,0,0,88,DET,31,31,29,19,0,0,0,110,20070221
2007,MEM,23,31,23,25,13,0,0,115,GSW,19,30,22,31,16,0,0,118,20070221
2007,MIA,19,29,27,27,0,0,0,102,HOU,31,32,26,23,0,0,0,112,20070221
2007,MIL,24,36,26,28,8,7,0,129,IND,39,24,29,22,8,14,0,136,20070221
2007,POR,25,27,26,34,0,0,0,112,LAL,30,24,26,28,0,0,0,108,20070221
2007,CHA,24,21,29,26,0,0,0,100,MIN,24,34,23,14,0,0,0,95,20070221
2007,NOK,27,23,26,35,0,0,0,111,NJN,25,19,35,28,0,0,0,107,20070221
2007,NYK,22,16,29,17,0,0,0,84,PHI,18,35,21,30,0,0,0,104,20070221
2007,BOS,26,20,36,26,0,0,0,108,PHO,30,27,29,32,0,0,0,118,20070221
2007,CLE,23,21,27,15,0,0,0,86,TOR,25,23,22,15,0,0,0,85,20070221
2007,CHI,22,21,21,20,0,0,0,84,CLE,22,9,31,16,0,0,0,78,20070222
2007,MIA,21,21,21,37,0,0,0,100,DAL,26,39,28,19,0,0,0,112,20070222
2007,SAC,29,20,24,33,0,0,0,106,WAS,33,24,28,24,0,0,0,109,20070222
2007,HOU,28,17,28,26,0,0,0,99,ATL,29,21,24,31,0,0,0,105,20070223
2007,PHI,20,23,20,24,0,0,0,87,CHA,28,27,22,25,0,0,0,102,20070223
2007,WAS,26,18,26,20,0,0,0,90,CHI,24,25,24,32,0,0,0,105,20070223
2007,UTA,31,26,36,21,0,0,0,114,DEN,30,18,26,30,0,0,0,104,20070223
2007,BOS,30,24,20,22,0,0,0,96,LAL,34,31,33,24,0,0,0,122,20070223
2007,PHO,25,39,31,21,0,0,0,116,MIN,30,22,31,21,0,0,0,104,20070223
2007,SAC,11,28,29,28,0,0,0,96,NJN,19,38,29,23,0,0,0,109,20070223
2007,SEA,25,23,31,18,0,0,0,97,NOK,29,22,28,19,0,0,0,98,20070223
2007,MIL,23,28,22,20,0,0,0,93,NYK,23,24,21,27,0,0,0,95,20070223
2007,DET,22,22,23,27,0,0,0,94,ORL,24,21,26,18,0,0,0,89,20070223
2007,MEM,33,25,21,24,0,0,0,103,POR,23,27,32,20,0,0,0,102,20070223
2007,IND,17,29,18,24,0,0,0,88,TOR,22,40,29,19,0,0,0,110,20070223
2007,TOR,19,25,24,25,0,0,0,93,CHA,18,23,18,17,0,0,0,76,20070224
2007,DEN,33,23,23,16,0,0,0,95,DAL,29,31,28,27,0,0,0,115,20070224
2007,GSW,26,25,23,16,0,0,0,90,LAC,28,22,26,27,0,0,0,103,20070224
2007,PHI,24,22,22,22,0,0,0,90,MIL,19,28,32,30,0,0,0,109,20070224
2007,SEA,20,14,11,26,0,0,0,71,SAS,27,29,22,24,0,0,0,102,20070224
2007,BOS,20,21,23,23,0,0,0,87,UTA,26,26,24,29,0,0,0,105,20070224
2007,PHO,38,22,30,25,0,0,0,115,ATL,24,29,32,21,0,0,0,106,20070225
2007,CHI,27,26,16,24,0,0,0,93,DET,25,20,22,28,0,0,0,95,20070225
2007,LAL,29,27,23,23,0,0,0,102,GSW,25,17,22,21,0,0,0,85,20070225
2007,SAC,24,23,40,23,0,0,0,110,IND,27,23,24,19,0,0,0,93,20070225
2007,CLE,19,19,21,22,0,0,0,81,MIA,20,21,18,27,0,0,0,86,20070225
2007,WAS,23,21,22,28,0,0,0,94,MIN,23,28,26,21,0,0,0,98,20070225
2007,NYK,28,25,15,24,0,0,0,92,NJN,22,22,33,24,0,0,0,101,20070225
2007,HOU,26,25,25,21,0,0,0,97,ORL,17,22,31,23,0,0,0,93,20070225
2007,ORL,26,20,19,29,0,0,0,94,CHI,23,22,20,22,0,0,0,87,20070226
2007,ATL,23,22,22,20,0,0,0,87,DAL,27,33,27,23,0,0,0,110,20070226
2007,BOS,14,15,15,33,0,0,0,77,HOU,22,13,18,19,0,0,0,72,20070226
2007,CHA,25,17,28,23,0,0,0,93,LAC,30,25,19,26,0,0,0,100,20070226
2007,DEN,30,25,27,29,0,0,0,111,MEM,25,29,29,24,0,0,0,107,20070226
2007,MIA,23,16,31,23,0,0,0,93,NYK,24,21,25,29,0,0,0,99,20070226
2007,SAC,27,18,18,19,0,0,0,82,PHI,24,18,25,22,0,0,0,89,20070226
2007,TOR,22,16,26,27,0,0,0,91,SAS,27,35,26,19,0,0,0,107,20070226
2007,POR,11,24,20,18,0,0,0,73,SEA,20,23,30,24,0,0,0,97,20070226
2007,LAL,25,30,15,32,0,0,0,102,UTA,20,30,20,24,0,0,0,94,20070226
2007,NOK,18,25,22,24,0,0,0,89,CLE,25,27,25,20,0,0,0,97,20070227
2007,PHO,19,30,24,30,0,0,0,103,IND,19,31,29,13,0,0,0,92,20070227
2007,GSW,30,23,15,33,0,0,0,101,MIL,27,35,29,31,0,0,0,122,20070227
2007,DAL,26,16,26,23,0,0,0,91,MIN,19,8,26,12,0,0,0,65,20070227
2007,WAS,18,33,27,23,0,0,0,101,NJN,22,27,30,34,0,0,0,113,20070227
2007,NYK,19,18,36,21,0,0,0,94,BOS,27,30,20,25,0,0,0,102,20070228
2007,GSW,28,30,11,14,0,0,0,83,CHI,31,31,33,18,0,0,0,113,20070228
2007,ORL,21,23,32,25,0,0,0,101,DEN,22,24,35,30,0,0,0,111,20070228
2007,TOR,27,40,12,27,0,0,0,106,HOU,21,26,21,22,0,0,0,90,20070228
2007,SEA,19,24,32,16,0,0,0,91,LAC,26,25,23,22,0,0,0,96,20070228
2007,UTA,17,27,33,27,0,0,0,104,MEM,25,24,22,17,0,0,0,88,20070228
2007,ATL,30,20,26,24,0,0,0,100,NOK,27,32,18,30,0,0,0,107,20070228
2007,PHO,23,26,15,30,0,0,0,94,PHI,35,19,19,26,0,0,0,99,20070228
2007,CHA,28,30,30,32,0,0,0,120,SAC,31,31,34,39,0,0,0,135,20070228
2007,MIA,27,19,23,23,0,0,0,92,WAS,20,25,20,18,0,0,0,83,20070228
2007,CLE,23,19,20,30,0,0,0,92,DAL,27,25,22,21,0,0,0,95,20070301
2007,CHA,16,24,26,24,0,0,0,90,POR,31,29,43,24,0,0,0,127,20070301
2007,LAC,21,13,23,18,0,0,0,75,SEA,26,15,16,20,0,0,0,77,20070301
2007,NOK,21,32,26,14,0,0,0,93,CHI,26,27,26,25,0,0,0,104,20070302
2007,HOU,35,25,27,21,0,0,0,108,DEN,26,29,14,28,0,0,0,97,20070302
2007,SAC,37,28,27,24,0,0,0,116,LAL,26,22,26,34,0,0,0,108,20070302
2007,DET,15,16,26,25,0,0,0,82,MIA,20,30,11,24,0,0,0,85,20070302
2007,UTA,22,35,23,29,0,0,0,109,MIN,19,20,23,21,0,0,0,83,20070302
2007,GSW,18,30,27,22,0,0,0,97,NYK,26,28,21,31,0,0,0,106,20070302
2007,MEM,23,25,25,30,9,0,0,112,PHI,22,23,28,30,14,0,0,117,20070302
2007,IND,28,21,25,16,0,0,0,90,PHO,30,32,27,26,0,0,0,115,20070302
2007,ORL,16,17,24,17,0,0,0,74,SAS,22,21,22,33,0,0,0,98,20070302
2007,MIL,21,27,20,26,0,0,0,94,TOR,22,23,18,18,0,0,0,81,20070302
2007,ATL,24,21,22,25,0,0,0,92,WAS,25,22,27,19,0,0,0,93,20070302
2007,NYK,15,22,25,25,17,0,0,104,ATL,31,18,22,16,13,0,0,100,20070303
2007,TOR,23,29,22,23,0,0,0,97,CLE,30,32,31,27,0,0,0,120,20070303
2007,ORL,19,23,30,26,0,0,0,98,DAL,24,16,35,28,0,0,0,103,20070303
2007,SAS,30,24,27,16,0,0,0,97,HOU,15,27,17,15,0,0,0,74,20070303
2007,IND,17,13,16,18,0,0,0,64,LAC,20,23,20,24,0,0,0,87,20070303
2007,DET,28,21,16,27,0,0,0,92,MEM,23,26,19,21,0,0,0,89,20070303
2007,BOS,15,18,17,33,13,0,0,96,NJN,20,16,17,30,5,0,0,88,20070303
2007,SAC,33,24,25,22,0,0,0,104,POR,25,26,23,22,0,0,0,96,20070303
2007,MIN,20,23,31,19,14,10,0,117,BOS,20,22,26,25,14,17,0,124,20070304
2007,CHI,28,24,26,33,15,0,0,126,MIL,31,23,36,21,10,0,0,121,20070304
2007,UTA,15,29,33,31,0,0,0,108,NOK,19,18,31,26,0,0,0,94,20070304
2007,NJN,30,13,22,21,0,0,0,86,PHI,18,31,29,21,0,0,0,99,20070304
2007,LAL,21,25,21,27,0,0,0,94,PHO,22,24,28,25,0,0,0,99,20070304
2007,CHA,27,18,27,17,0,0,0,89,SEA,23,28,19,26,0,0,0,96,20070304
2007,GSW,30,23,31,22,0,0,0,106,WAS,20,30,31,26,0,0,0,107,20070304
2007,HOU,20,13,24,28,0,0,0,85,CLE,19,24,25,23,0,0,0,91,20070305
2007,GSW,26,35,27,23,0,0,0,111,DET,28,27,16,22,0,0,0,93,20070305
2007,SAS,22,21,21,24,0,0,0,88,LAC,16,18,15,25,0,0,0,74,20070305
2007,ATL,17,14,23,27,0,0,0,81,MIA,16,23,20,29,0,0,0,88,20070305
2007,MIL,10,24,21,26,0,0,0,81,ORL,20,29,26,24,0,0,0,99,20070305
2007,CHA,25,23,22,25,0,0,0,95,UTA,32,26,28,34,0,0,0,120,20070305
2007,NJN,18,23,27,21,0,0,0,89,DAL,25,22,25,30,0,0,0,102,20070306
2007,NOK,25,18,22,26,0,0,0,91,DEN,24,29,34,19,0,0,0,106,20070306
2007,LAL,28,25,25,20,7,2,0,107,MIN,23,27,21,27,7,12,0,117,20070306
2007,SEA,31,24,18,27,0,0,0,100,NYK,18,24,24,33,0,0,0,99,20070306
2007,SAS,22,25,18,34,0,0,0,99,POR,29,25,20,20,0,0,0,94,20070306
2007,IND,22,20,32,24,0,0,0,98,SAC,30,27,24,21,0,0,0,102,20070306
2007,TOR,28,29,26,26,0,0,0,109,WAS,31,40,30,28,0,0,0,129,20070306
2007,WAS,31,21,15,30,0,0,0,97,ATL,21,23,27,29,0,0,0,100,20070307
2007,HOU,30,32,31,18,0,0,0,111,BOS,22,27,19,12,0,0,0,80,20070307
2007,CLE,34,18,18,23,8,0,0,101,DET,24,26,20,23,4,0,0,97,20070307
2007,DEN,28,30,11,27,0,0,0,96,GSW,31,28,22,29,0,0,0,110,20070307
2007,CHI,18,25,13,14,0,0,0,70,MIA,30,22,18,33,0,0,0,103,20070307
2007,LAL,21,23,17,29,0,0,0,90,MIL,21,29,27,33,0,0,0,110,20070307
2007,SEA,23,22,21,23,0,0,0,89,PHI,33,18,20,21,0,0,0,92,20070307
2007,CHA,19,33,27,19,8,0,0,106,PHO,30,25,24,19,17,0,0,115,20070307
2007,MEM,20,18,21,28,0,0,0,87,TOR,25,24,26,19,0,0,0,94,20070307
2007,IND,22,15,24,11,0,0,0,72,UTA,24,26,17,27,0,0,0,94,20070307
2007,CHI,26,23,22,29,0,0,0,100,ORL,17,12,19,28,0,0,0,76,20070308
2007,SAS,25,23,17,35,0,0,0,100,SAC,19,25,17,32,0,0,0,93,20070308
2007,MEM,23,27,30,25,0,0,0,105,ATL,31,29,21,25,0,0,0,106,20070309
2007,SEA,35,31,16,21,0,0,0,103,BOS,31,26,27,34,0,0,0,118,20070309
2007,DET,27,20,27,21,0,0,0,95,DEN,23,24,15,20,0,0,0,82,20070309
2007,LAC,32,16,24,17,0,0,0,89,GSW,36,29,20,14,0,0,0,99,20070309
2007,NJN,18,24,22,27,0,0,0,91,HOU,31,21,33,27,0,0,0,112,20070309
2007,MIN,25,19,25,22,0,0,0,91,MIA,29,21,31,24,0,0,0,105,20070309
2007,LAL,26,31,18,17,0,0,0,92,PHI,30,21,32,25,0,0,0,108,20070309
2007,NOK,29,25,22,27,0,0,0,103,PHO,34,21,23,26,0,0,0,104,20070309
2007,MIN,21,29,24,19,0,0,0,93,ATL,22,22,28,27,0,0,0,99,20070310
2007,MEM,31,26,21,37,0,0,0,115,CHA,21,35,16,35,0,0,0,107,20070310
2007,PHI,30,19,25,26,0,0,0,100,IND,24,28,19,25,0,0,0,96,20070310
2007,CLE,21,25,16,32,0,0,0,94,MIL,24,23,24,21,0,0,0,92,20070310
2007,NJN,15,18,19,25,0,0,0,77,SAS,18,24,24,27,0,0,0,93,20070310
2007,NOK,25,22,16,23,0,0,0,86,UTA,19,26,28,23,0,0,0,96,20070310
2007,NYK,19,20,28,23,0,0,0,90,WAS,21,20,25,23,0,0,0,89,20070310
2007,CHI,24,24,18,28,0,0,0,94,BOS,17,24,22,15,0,0,0,78,20070311
2007,IND,18,19,24,27,0,0,0,88,CLE,31,24,27,17,0,0,0,99,20070311
2007,ORL,23,22,21,26,0,0,0,92,HOU,31,27,25,20,0,0,0,103,20070311
2007,DET,27,20,24,27,0,0,0,98,LAC,22,21,14,23,0,0,0,80,20070311
2007,DAL,28,31,26,23,0,0,0,108,LAL,24,11,23,14,0,0,0,72,20070311
2007,WAS,14,29,38,23,0,0,0,104,MIA,28,28,16,34,0,0,0,106,20070311
2007,GSW,25,20,21,21,0,0,0,87,POR,27,25,35,19,0,0,0,106,20070311
2007,DEN,27,32,24,30,0,0,0,113,SAC,29,16,28,28,0,0,0,101,20070311
2007,SEA,19,30,29,28,13,0,0,119,TOR,25,22,24,35,14,0,0,120,20070311
2007,ORL,27,22,28,31,0,0,0,108,CHA,34,28,33,24,0,0,0,119,20070312
2007,DAL,33,18,18,31,0,0,0,100,GSW,33,31,34,19,0,0,0,117,20070312
2007,NJN,28,23,36,26,0,0,0,113,MEM,21,24,30,27,0,0,0,102,20070312
2007,TOR,37,25,24,22,0,0,0,108,MIL,24,22,30,17,0,0,0,93,20070312
2007,HOU,20,22,24,16,0,0,0,82,PHO,30,22,22,29,0,0,0,103,20070312
2007,PHI,22,21,21,28,0,0,0,92,ATL,31,27,28,18,0,0,0,104,20070313
2007,BOS,29,18,22,18,0,0,0,87,CHI,26,24,25,20,0,0,0,95,20070313
2007,SAC,19,32,18,31,0,0,0,100,CLE,25,26,35,38,0,0,0,124,20070313
2007,POR,19,18,34,28,0,0,0,99,DEN,29,26,23,29,0,0,0,107,20070313
2007,UTA,30,18,26,12,0,0,0,86,MIA,18,17,25,28,0,0,0,88,20070313
2007,IND,20,22,25,14,0,0,0,81,MIN,19,16,23,28,0,0,0,86,20070313
2007,NJN,29,23,30,30,0,0,0,112,NOK,25,26,27,30,0,0,0,108,20070313
2007,LAC,22,18,21,23,0,0,0,84,SAS,21,29,22,21,0,0,0,93,20070313
2007,DET,26,22,25,28,0,0,0,101,SEA,18,29,24,26,0,0,0,97,20070313
2007,ATL,25,16,19,28,0,0,0,88,BOS,26,24,36,23,0,0,0,109,20070314
2007,SAC,30,31,19,28,0,0,0,108,CHA,31,25,26,29,0,0,0,111,20070314
2007,PHO,32,28,16,35,9,9,0,129,DAL,18,35,38,20,9,7,0,127,20070314
2007,LAC,18,34,24,29,0,0,0,105,HOU,31,26,30,22,0,0,0,109,20070314
2007,WAS,23,26,35,28,0,0,0,112,IND,24,22,28,22,0,0,0,96,20070314
2007,CLE,36,26,35,21,0,0,0,118,MEM,25,26,12,33,0,0,0,96,20070314
2007,UTA,23,17,24,26,0,0,0,90,ORL,21,21,35,24,0,0,0,101,20070314
2007,CHI,18,24,20,26,0,0,0,88,PHI,28,22,22,15,0,0,0,87,20070314
2007,DET,24,21,23,19,0,0,0,87,POR,14,23,21,17,0,0,0,75,20070314
2007,NYK,19,31,18,26,0,0,0,94,TOR,22,22,35,25,0,0,0,104,20070314
2007,LAL,31,20,21,14,0,0,0,86,DEN,30,21,36,26,0,0,0,113,20070315
2007,SAS,23,20,21,26,0,0,0,90,MIL,23,29,17,32,0,0,0,101,20070315
2007,MIA,23,20,25,25,0,0,0,93,NJN,19,26,15,26,0,0,0,86,20070315
2007,LAC,32,21,26,23,0,0,0,102,CHA,37,16,13,27,0,0,0,93,20070316
2007,BOS,26,28,16,31,0,0,0,101,DAL,29,15,25,37,0,0,0,106,20070316
2007,MIN,21,22,24,19,0,0,0,86,GSW,25,31,29,21,0,0,0,106,20070316
2007,POR,24,19,25,30,13,0,0,111,LAL,16,30,22,30,18,0,0,116,20070316
2007,SAC,17,28,25,27,0,0,0,97,MIA,24,32,28,19,0,0,0,103,20070316
2007,NOK,15,33,16,28,0,0,0,92,NYK,29,25,17,19,0,0,0,90,20070316
2007,UTA,21,18,18,31,0,0,0,88,PHI,24,21,23,21,0,0,0,89,20070316
2007,DET,24,24,27,30,0,0,0,105,PHO,26,17,21,19,0,0,0,83,20070316
2007,HOU,35,27,25,27,0,0,0,114,TOR,18,35,19,28,0,0,0,100,20070316
2007,UTA,20,12,24,17,0,0,0,73,CLE,17,14,29,22,0,0,0,82,20070317
2007,PHO,25,19,29,34,0,0,0,107,DEN,37,33,41,20,0,0,0,131,20070317
2007,ATL,23,21,21,25,0,0,0,90,IND,36,32,16,29,0,0,0,113,20070317
2007,CHI,17,25,35,26,0,0,0,103,MEM,27,27,21,29,0,0,0,104,20070317
2007,CHA,20,27,23,21,0,0,0,91,MIL,24,19,24,30,0,0,0,97,20070317
2007,SAC,21,21,25,28,0,0,0,95,ORL,25,27,12,19,0,0,0,83,20070317
2007,BOS,29,16,30,16,0,0,0,91,SAS,15,25,22,23,0,0,0,85,20070317
2007,GSW,27,32,18,22,0,0,0,99,SEA,16,29,30,23,0,0,0,98,20070317
2007,NOK,30,25,30,18,0,0,0,103,WAS,39,26,30,30,0,0,0,125,20070317
2007,DAL,25,21,21,25,0,0,0,92,DET,22,28,19,19,0,0,0,88,20070318
2007,MIN,22,21,25,34,0,0,0,102,LAL,29,23,35,22,0,0,0,109,20070318
2007,ORL,28,27,21,21,0,0,0,97,MIA,16,21,22,24,0,0,0,83,20070318
2007,LAC,24,21,25,25,0,0,0,95,NJN,27,21,22,31,0,0,0,101,20070318
2007,TOR,22,20,13,19,0,0,0,74,NYK,21,19,35,17,0,0,0,92,20070318
2007,HOU,32,27,34,31,0,0,0,124,PHI,15,25,16,18,0,0,0,74,20070318
2007,SEA,26,21,20,28,0,0,0,95,POR,25,12,24,16,0,0,0,77,20070318
2007,SAC,21,21,8,26,0,0,0,76,ATL,31,22,25,21,0,0,0,99,20070319
2007,BOS,31,9,18,30,0,0,0,88,NOK,26,31,29,20,0,0,0,106,20070319
2007,CLE,24,22,29,19,6,0,0,100,CHA,21,16,32,25,14,0,0,108,20070320
2007,LAC,26,24,21,32,0,0,0,103,CHI,28,17,25,19,0,0,0,89,20070320
2007,PHI,23,18,19,15,0,0,0,75,DET,26,23,21,26,0,0,0,96,20070320
2007,IND,16,21,22,17,0,0,0,76,HOU,18,21,22,25,0,0,0,86,20070320
2007,NOK,30,31,31,22,0,0,0,114,MEM,30,31,20,22,0,0,0,103,20070320
2007,DEN,20,22,31,21,0,0,0,94,NJN,20,29,16,25,0,0,0,90,20070320
2007,DAL,30,16,24,22,0,0,0,92,NYK,23,20,13,21,0,0,0,77,20070320
2007,MIN,22,25,20,23,0,0,0,90,PHO,25,26,33,24,0,0,0,108,20070320
2007,WAS,24,24,22,28,0,0,0,98,POR,19,22,24,35,0,0,0,100,20070320
2007,GSW,28,32,22,18,0,0,0,100,UTA,27,26,23,28,0,0,0,104,20070320
2007,MIA,24,23,22,22,0,0,0,91,ATL,22,14,23,24,0,0,0,83,20070321
2007,CHA,19,20,23,30,0,0,0,92,BOS,31,23,17,13,0,0,0,84,20070321
2007,DAL,22,27,30,19,0,0,0,98,CLE,23,22,21,24,0,0,0,90,20070321
2007,LAC,30,35,25,14,0,0,0,104,MIL,24,28,19,32,0,0,0,103,20070321
2007,MIN,22,21,20,32,0,0,0,95,SAC,28,20,22,19,0,0,0,89,20070321
2007,IND,22,15,13,22,0,0,0,72,SAS,17,25,28,20,0,0,0,90,20070321
2007,WAS,26,21,30,31,0,0,0,108,SEA,19,24,33,30,0,0,0,106,20070321
2007,ORL,17,23,23,22,0,0,0,85,TOR,24,21,22,25,0,0,0,92,20070321
2007,DEN,34,17,33,24,0,0,0,108,CHI,28,27,27,27,0,0,0,109,20070322
2007,DET,15,20,21,29,0,0,0,85,HOU,20,28,25,18,0,0,0,91,20070322
2007,LAL,34,26,32,29,0,0,0,121,MEM,25,29,37,28,0,0,0,119,20070322
2007,POR,26,19,24,23,0,0,0,92,NYK,20,24,18,24,0,0,0,86,20070322
2007,SAC,27,25,21,27,0,0,0,100,PHO,27,30,32,29,0,0,0,118,20070322
2007,POR,15,25,26,22,14,0,0,102,ATL,20,27,17,24,12,0,0,100,20070323
2007,DAL,33,23,34,19,0,0,0,109,BOS,16,35,20,24,0,0,0,95,20070323
2007,NYK,17,21,18,12,0,0,0,68,CLE,25,21,24,20,0,0,0,90,20070323
2007,WAS,37,36,21,34,0,0,0,128,GSW,35,29,38,33,0,0,0,135,20070323
2007,MIA,9,23,17,21,0,0,0,70,IND,33,19,20,23,0,0,0,95,20070323
2007,UTA,16,22,15,19,0,0,0,72,LAC,24,31,26,23,0,0,0,104,20070323
2007,LAL,29,27,31,24,0,0,0,111,NOK,31,26,18,30,0,0,0,105,20070323
2007,NJN,21,20,18,23,0,0,0,82,ORL,21,16,22,31,0,0,0,90,20070323
2007,CHA,23,25,26,23,0,0,0,97,PHI,37,32,17,20,0,0,0,106,20070323
2007,DET,16,31,14,28,0,0,0,89,SAS,27,18,26,19,0,0,0,90,20070323
2007,MIN,19,20,22,21,0,0,0,82,SEA,12,20,22,31,0,0,0,85,20070323
2007,DEN,15,28,21,30,0,0,0,94,TOR,36,36,23,26,0,0,0,121,20070323
2007,NJN,19,29,21,27,17,0,0,113,CHA,25,20,21,30,11,0,0,107,20070324
2007,WAS,25,23,22,35,0,0,0,105,LAC,21,26,32,32,0,0,0,111,20070324
2007,PHI,13,21,27,32,0,0,0,93,MIA,30,19,18,18,0,0,0,85,20070324
2007,MEM,28,17,33,30,0,0,0,108,UTA,32,35,28,23,0,0,0,118,20070324
2007,DAL,39,19,17,29,0,0,0,104,ATL,19,25,23,30,0,0,0,97,20070325
2007,DEN,23,32,26,24,0,0,0,105,CLE,26,27,22,18,0,0,0,93,20070325
2007,CHI,28,22,20,22,0,0,0,92,IND,29,23,19,19,0,0,0,90,20070325
2007,GSW,25,36,27,25,0,0,0,113,LAL,35,30,20,30,0,0,0,115,20070325
2007,DET,22,37,28,34,0,0,0,121,MIL,26,18,28,23,0,0,0,95,20070325
2007,POR,22,25,21,25,0,0,0,93,MIN,22,22,24,26,0,0,0,94,20070325
2007,HOU,30,22,21,21,0,0,0,94,NOK,20,24,31,31,0,0,0,106,20070325
2007,PHO,23,24,33,20,0,0,0,100,SAC,27,27,23,30,0,0,0,107,20070325
2007,SAS,30,23,28,39,0,0,0,120,SEA,23,17,25,14,0,0,0,79,20070325
2007,TOR,19,19,18,31,0,0,0,87,BOS,22,20,23,30,0,0,0,95,20070326
2007,POR,31,14,18,26,0,0,0,89,CHI,25,16,28,31,0,0,0,100,20070326
2007,DEN,13,31,27,27,11,0,0,109,DET,26,16,29,27,15,0,0,113,20070326
2007,SAS,36,37,29,24,0,0,0,126,GSW,30,24,12,23,0,0,0,89,20070326
2007,MIL,20,25,15,27,0,0,0,87,HOU,33,20,28,25,0,0,0,106,20070326
2007,ATL,22,30,17,20,0,0,0,89,MIA,28,29,25,24,0,0,0,106,20070326
2007,ORL,23,22,25,24,0,0,0,94,NYK,21,28,15,25,0,0,0,89,20070326
2007,MEM,27,16,21,23,0,0,0,87,PHO,31,27,22,25,0,0,0,105,20070326
2007,WAS,18,23,30,26,0,0,0,97,UTA,13,22,35,33,0,0,0,103,20070326
2007,CLE,25,27,23,30,0,0,0,105,IND,22,23,27,22,0,0,0,94,20070327
2007,MEM,15,26,27,20,0,0,0,88,LAL,27,22,14,23,0,0,0,86,20070327
2007,SEA,27,25,27,35,0,0,0,114,MIN,36,35,23,12,0,0,0,106,20070327
2007,DAL,30,26,28,21,0,0,0,105,NOK,24,20,15,30,0,0,0,89,20070327
2007,ORL,20,20,23,20,7,6,0,96,BOS,24,26,16,17,7,15,0,105,20070328
2007,ATL,20,24,21,22,0,0,0,87,CHA,25,24,26,26,0,0,0,101,20070328
2007,MIL,28,34,22,19,0,0,0,103,DAL,32,22,27,24,0,0,0,105,20070328
2007,SEA,32,27,22,19,0,0,0,100,DEN,35,19,22,21,0,0,0,97,20070328
2007,HOU,21,21,28,22,0,0,0,92,LAC,29,20,12,26,0,0,0,87,20070328
2007,IND,21,22,23,28,0,0,0,94,NJN,32,28,31,27,0,0,0,118,20070328
2007,CLE,26,20,23,24,0,0,0,93,NYK,24,27,19,27,0,0,0,97,20070328
2007,NOK,18,34,23,13,0,0,0,88,SAS,18,28,20,26,0,0,0,92,20070328
2007,MIA,15,25,16,27,0,0,0,83,TOR,31,27,16,22,0,0,0,96,20070328
2007,MIN,20,34,18,30,0,0,0,102,UTA,27,23,24,34,0,0,0,108,20070328
2007,PHI,25,24,24,35,0,0,0,108,WAS,22,30,31,28,0,0,0,111,20070328
2007,DET,17,24,20,20,0,0,0,81,CHI,25,13,22,23,0,0,0,83,20070329
2007,PHO,33,30,23,33,0,0,0,119,GSW,45,32,32,15,0,0,0,124,20070329
2007,MEM,24,26,19,27,0,0,0,96,POR,24,22,20,26,0,0,0,92,20070329
2007,MIL,20,26,12,23,0,0,0,81,CHA,20,23,30,24,0,0,0,97,20070330
2007,NYK,29,24,23,27,0,0,0,103,DAL,22,35,19,29,0,0,0,105,20070330
2007,NJN,21,21,34,29,0,0,0,105,DET,26,19,26,39,0,0,0,110,20070330
2007,HOU,31,22,22,20,12,0,0,107,LAL,22,26,19,28,9,0,0,104,20070330
2007,MIA,25,22,17,28,0,0,0,92,MIN,14,21,22,20,0,0,0,77,20070330
2007,IND,27,14,15,31,0,0,0,87,ORL,26,25,16,28,0,0,0,95,20070330
2007,BOS,20,11,27,24,0,0,0,82,PHI,25,19,23,21,0,0,0,88,20070330
2007,DEN,36,29,21,22,0,0,0,108,PHO,24,36,35,30,0,0,0,125,20070330
2007,LAC,30,27,21,27,0,0,0,105,SAC,19,31,20,31,0,0,0,101,20070330
2007,UTA,25,21,22,25,0,0,0,93,SAS,23,35,23,21,0,0,0,102,20070330
2007,MEM,28,27,17,21,0,0,0,93,SEA,40,29,32,19,0,0,0,120,20070330
2007,TOR,31,26,20,32,14,0,0,123,WAS,26,28,25,30,9,0,0,118,20070330
2007,CLE,26,33,24,17,12,0,0,112,CHI,30,23,20,27,8,0,0,108,20070331
2007,PHI,21,18,18,25,0,0,0,82,NJN,17,17,27,25,0,0,0,86,20070331
2007,NYK,23,14,26,29,2,0,0,94,NOK,19,32,21,20,11,0,0,103,20070331
2007,LAC,38,27,18,16,0,0,0,99,POR,18,21,27,20,0,0,0,86,20070331
2007,CHI,32,20,23,30,0,0,0,105,ATL,31,25,17,24,0,0,0,97,20070401
2007,CLE,16,33,20,27,0,0,0,96,BOS,28,25,27,18,0,0,0,98,20070401
2007,MIA,24,22,23,19,0,0,0,88,DET,13,28,24,29,0,0,0,94,20070401
2007,MEM,31,25,33,28,0,0,0,117,GSW,32,24,30,36,0,0,0,122,20070401
2007,UTA,20,16,23,27,0,0,0,86,HOU,16,16,29,22,0,0,0,83,20070401
2007,SAS,32,22,22,23,0,0,0,99,IND,26,27,24,23,0,0,0,100,20070401
2007,SAC,27,27,27,22,0,0,0,103,LAL,27,32,28,39,0,0,0,126,20070401
2007,WAS,25,32,31,33,0,0,0,121,MIL,35,16,34,22,0,0,0,107,20070401
2007,MIN,31,23,25,19,7,0,0,105,ORL,23,30,21,24,6,0,0,104,20070401
2007,DAL,29,27,26,22,0,0,0,104,PHO,26,34,29,37,0,0,0,126,20070401
2007,DEN,28,26,30,30,0,0,0,114,SEA,18,33,29,23,0,0,0,103,20070401
2007,CHA,19,26,26,23,0,0,0,94,TOR,27,26,27,27,0,0,0,107,20070401
2007,WAS,27,18,33,24,0,0,0,102,CHA,34,29,34,25,0,0,0,122,20070403
2007,DET,21,22,35,22,0,0,0,100,IND,26,20,18,21,0,0,0,85,20070403
2007,DEN,30,33,23,25,0,0,0,111,LAL,28,30,28,19,0,0,0,105,20070403
2007,PHO,31,40,18,27,0,0,0,116,MEM,36,23,29,23,0,0,0,111,20070403
2007,TOR,25,18,24,22,0,0,0,89,MIA,30,26,17,19,0,0,0,92,20070403
2007,NOK,37,30,20,32,0,0,0,119,MIL,31,25,25,20,0,0,0,101,20070403
2007,CLE,33,22,25,21,0,0,0,101,MIN,21,26,13,28,0,0,0,88,20070403
2007,DAL,23,26,20,28,0,0,0,97,SAC,24,24,22,23,0,0,0,93,20070403
2007,SEA,22,26,17,26,0,0,0,91,SAS,33,27,31,19,0,0,0,110,20070403
2007,SAC,25,25,29,36,0,0,0,115,DEN,33,38,24,25,0,0,0,120,20070404
2007,CHI,26,26,32,22,0,0,0,106,DET,24,29,16,19,0,0,0,88,20070404
2007,GSW,26,31,27,26,0,0,0,110,HOU,24,28,20,27,0,0,0,99,20070404
2007,LAL,22,20,27,13,0,0,0,82,LAC,28,29,18,15,0,0,0,90,20070404
2007,BOS,21,31,20,17,0,0,0,89,MIL,25,28,26,19,0,0,0,98,20070404
2007,ATL,22,17,21,26,0,0,0,86,NJN,27,25,26,23,0,0,0,101,20070404
2007,SEA,21,24,20,19,8,0,0,92,NOK,19,29,30,6,17,0,0,101,20070404
2007,PHI,26,20,19,27,0,0,0,92,NYK,20,19,28,23,0,0,0,90,20070404
2007,TOR,24,28,32,27,0,0,0,111,ORL,37,20,22,29,0,0,0,108,20070404
2007,UTA,21,24,15,29,0,0,0,89,POR,20,23,27,24,0,0,0,94,20070404
2007,CHA,19,25,31,33,0,0,0,108,WAS,21,24,34,21,0,0,0,100,20070404
2007,MIA,24,29,16,14,11,0,0,94,CLE,24,22,10,27,7,0,0,90,20070405
2007,PHO,19,18,22,26,0,0,0,85,SAS,20,16,35,21,0,0,0,92,20070405
2007,MIL,39,23,24,16,0,0,0,102,ATL,29,31,29,26,0,0,0,115,20070406
2007,MIA,28,24,18,18,0,0,0,88,BOS,26,19,25,15,0,0,0,85,20070406
2007,IND,25,26,30,31,0,0,0,112,CHA,23,32,22,25,0,0,0,102,20070406
2007,NJN,20,18,24,12,0,0,0,74,CHI,31,22,28,24,0,0,0,105,20070406
2007,DAL,22,15,14,20,0,0,0,71,DEN,13,17,22,23,0,0,0,75,20070406
2007,POR,23,17,21,24,0,0,0,85,HOU,14,19,21,24,0,0,0,78,20070406
2007,GSW,33,28,19,36,0,0,0,116,MEM,28,32,22,22,0,0,0,104,20070406
2007,PHO,37,23,17,26,0,0,0,103,NOK,23,25,19,28,0,0,0,95,20070406
2007,MIN,28,31,15,25,0,0,0,99,NYK,17,24,29,24,0,0,0,94,20070406
2007,TOR,23,22,28,21,0,0,0,94,PHI,18,28,15,24,0,0,0,85,20070406
2007,UTA,36,24,22,21,0,0,0,103,SAC,28,21,26,32,0,0,0,107,20070406
2007,LAL,31,18,33,30,0,0,0,112,SEA,28,29,29,23,0,0,0,109,20070406
2007,CLE,21,24,23,31,0,0,0,99,WAS,23,30,18,23,0,0,0,94,20070406
2007,POR,21,12,20,21,0,0,0,74,DAL,26,25,21,14,0,0,0,86,20070407
2007,BOS,15,28,24,31,0,0,0,98,IND,26,25,27,27,0,0,0,105,20070407
2007,DEN,26,23,17,30,0,0,0,96,LAC,31,21,22,19,0,0,0,93,20070407
2007,NYK,26,27,30,19,16,0,0,118,MIL,34,26,22,20,11,0,0,113,20070407
2007,NOK,19,32,29,16,0,0,0,96,MIN,21,36,18,19,0,0,0,94,20070407
2007,WAS,24,27,27,26,10,0,0,114,NJN,22,30,28,24,16,0,0,120,20070407
2007,MEM,14,30,19,26,0,0,0,89,ORL,35,26,34,21,0,0,0,116,20070407
2007,GSW,31,25,21,22,0,0,0,99,SAS,40,19,29,24,0,0,0,112,20070407
2007,SEA,30,18,19,39,0,0,0,106,UTA,27,30,30,16,0,0,0,103,20070407
2007,CLE,17,24,17,24,0,0,0,82,DET,29,15,20,23,0,0,0,87,20070408
2007,PHO,27,27,20,41,0,0,0,115,LAL,26,22,25,34,0,0,0,107,20070408
2007,CHA,29,28,21,14,19,0,0,111,MIA,22,27,19,24,11,0,0,103,20070408
2007,ATL,30,23,21,19,11,0,0,104,PHI,24,17,29,23,16,0,0,109,20070408
2007,HOU,21,29,31,31,0,0,0,112,SAC,24,33,23,26,0,0,0,106,20070408
2007,CHI,22,28,17,22,0,0,0,89,TOR,23,23,31,26,0,0,0,103,20070408
2007,LAC,27,18,22,19,0,0,0,86,DAL,30,22,28,16,0,0,0,96,20070409
2007,LAL,23,35,24,29,0,0,0,111,DEN,32,33,27,23,0,0,0,115,20070409
2007,UTA,27,20,28,27,0,0,0,102,GSW,26,37,36,27,0,0,0,126,20070409
2007,ORL,28,31,29,29,0,0,0,117,MIL,23,29,15,27,0,0,0,94,20070409
2007,TOR,25,23,25,38,0,0,0,111,MIN,27,25,27,21,0,0,0,100,20070409
2007,DET,24,21,18,28,0,0,0,91,NYK,23,15,30,15,0,0,0,83,20070409
2007,POR,19,29,28,20,0,0,0,96,SAS,32,22,29,29,0,0,0,112,20070409
2007,HOU,23,27,26,19,0,0,0,95,SEA,20,22,28,20,0,0,0,90,20070409
2007,BOS,28,31,19,18,0,0,0,96,ATL,24,27,25,28,0,0,0,104,20070410
2007,MIA,20,16,19,27,0,0,0,82,CHA,26,22,26,18,0,0,0,92,20070410
2007,NYK,10,17,23,19,0,0,0,69,CHI,21,24,33,20,0,0,0,98,20070410
2007,SAC,39,14,28,31,0,0,0,112,MEM,15,33,22,30,0,0,0,100,20070410
2007,LAC,25,27,14,23,11,0,0,100,NOK,26,15,29,19,14,0,0,103,20070410
2007,IND,17,22,19,28,0,0,0,86,PHI,26,19,24,21,0,0,0,90,20070410
2007,NJN,16,24,25,31,0,0,0,96,WAS,24,16,27,25,0,0,0,92,20070410
2007,PHI,20,27,29,26,0,0,0,102,BOS,29,29,18,18,0,0,0,94,20070411
2007,ORL,21,25,27,26,0,0,0,99,DET,34,22,28,20,0,0,0,104,20070411
2007,WAS,21,16,23,22,0,0,0,82,MIA,25,10,27,23,0,0,0,85,20070411
2007,IND,26,27,27,24,0,0,0,104,MIL,22,22,26,28,0,0,0,98,20070411
2007,DAL,23,25,38,19,0,0,0,105,MIN,23,28,15,22,0,0,0,88,20070411
2007,SEA,33,25,19,14,0,0,0,91,PHO,31,33,19,26,0,0,0,109,20070411
2007,HOU,28,25,25,21,0,0,0,99,POR,16,20,23,36,0,0,0,95,20070411
2007,SAC,22,26,32,20,0,0,0,100,SAS,23,31,25,30,0,0,0,109,20070411
2007,DEN,23,32,31,29,0,0,0,115,UTA,21,27,30,28,0,0,0,106,20070411
2007,NJN,19,13,19,25,0,0,0,76,CLE,20,16,36,22,0,0,0,94,20070412
2007,LAC,28,23,35,32,0,0,0,118,LAL,23,32,38,17,0,0,0,110,20070412
2007,WAS,28,21,26,23,0,0,0,98,ATL,20,15,26,24,0,0,0,85,20070413
2007,MIL,31,25,27,21,0,0,0,104,BOS,25,18,29,30,0,0,0,102,20070413
2007,CHA,23,19,20,19,0,0,0,81,CHI,30,26,19,25,0,0,0,100,20070413
2007,UTA,26,23,23,32,0,0,0,104,DAL,19,19,26,25,0,0,0,89,20070413
2007,POR,19,18,21,31,0,0,0,89,LAC,26,24,30,27,0,0,0,107,20070413
2007,IND,16,30,28,22,0,0,0,96,MIA,26,27,18,29,0,0,0,100,20070413
2007,SAS,30,25,30,25,0,0,0,110,MIN,21,18,21,31,0,0,0,91,20070413
2007,NYK,15,32,21,18,0,0,0,86,NJN,18,26,40,16,0,0,0,100,20070413
2007,DEN,22,31,24,30,0,0,0,107,NOK,35,21,29,20,0,0,0,105,20070413
2007,LAL,26,24,13,22,0,0,0,85,PHO,27,24,25,17,0,0,0,93,20070413
2007,GSW,32,42,26,25,0,0,0,125,SAC,30,23,40,15,0,0,0,108,20070413
2007,DET,20,30,19,15,0,0,0,84,TOR,14,23,21,29,0,0,0,87,20070413
2007,ATL,17,11,27,21,0,0,0,76,CLE,28,28,29,25,0,0,0,110,20070414
2007,NOK,30,20,28,34,0,0,0,112,HOU,32,25,28,38,0,0,0,123,20070414
2007,DEN,30,26,39,23,0,0,0,118,MEM,31,33,31,38,0,0,0,133,20070414
2007,CHA,27,27,32,27,0,0,0,113,MIL,28,23,19,22,0,0,0,92,20070414
2007,ORL,35,26,21,22,0,0,0,104,PHI,25,23,18,21,0,0,0,87,20070414
2007,SEA,26,24,28,24,0,0,0,102,POR,28,32,19,29,0,0,0,108,20070414
2007,PHO,32,36,28,30,0,0,0,126,UTA,19,27,27,25,0,0,0,98,20070414
2007,SAS,28,27,21,10,0,0,0,86,DAL,22,30,20,19,0,0,0,91,20070415
2007,PHI,27,23,27,25,0,0,0,102,DET,28,22,20,21,0,0,0,91,20070415
2007,MIN,22,28,16,42,0,0,0,108,GSW,38,30,38,15,0,0,0,121,20070415
2007,NJN,28,26,26,31,0,0,0,111,IND,22,34,24,27,0,0,0,107,20070415
2007,SAC,34,26,21,24,0,0,0,105,LAC,23,18,24,35,0,0,0,100,20070415
2007,SEA,15,31,28,24,0,0,0,98,LAL,29,26,26,28,0,0,0,109,20070415
2007,BOS,24,16,19,27,0,0,0,86,ORL,23,25,30,10,0,0,0,88,20070415
2007,NYK,27,32,19,27,0,0,0,105,TOR,30,20,27,30,0,0,0,107,20070415
2007,CHI,28,21,28,24,0,0,0,101,WAS,14,13,23,18,0,0,0,68,20070415
2007,MIN,30,29,18,30,0,0,0,107,DEN,26,34,32,30,0,0,0,122,20070416
2007,PHO,25,29,25,38,0,0,0,117,HOU,24,32,35,29,0,0,0,120,20070416
2007,SAS,17,26,23,25,0,0,0,91,MEM,26,30,26,19,0,0,0,101,20070416
2007,BOS,18,18,29,26,0,0,0,91,MIA,21,22,22,24,0,0,0,89,20070416
2007,ATL,25,18,28,25,0,0,0,96,MIL,31,25,28,18,0,0,0,102,20070416
2007,NJN,27,28,24,25,0,0,0,104,NYK,25,19,25,26,0,0,0,95,20070416
2007,NOK,31,30,33,31,0,0,0,125,SAC,31,30,32,25,0,0,0,118,20070416
2007,POR,23,22,27,21,0,0,0,93,UTA,26,37,31,36,0,0,0,130,20070416
2007,IND,23,32,25,22,0,0,0,102,ATL,41,35,14,28,0,0,0,118,20070417
2007,TOR,18,19,19,28,0,0,0,84,DET,23,38,16,23,0,0,0,100,20070417
2007,DAL,15,16,28,23,0,0,0,82,GSW,30,25,28,28,0,0,0,111,20070417
2007,CLE,26,32,17,23,0,0,0,98,PHI,25,25,20,22,0,0,0,92,20070417
2007,LAC,21,29,21,32,0,0,0,103,PHO,20,28,26,25,0,0,0,99,20070417
2007,ORL,30,27,12,26,0,0,0,95,WAS,27,18,28,16,0,0,0,89,20070417
2007,DET,19,26,24,22,0,0,0,91,BOS,22,27,18,22,0,0,0,89,20070418
2007,NYK,24,14,20,36,0,0,0,94,CHA,17,23,25,28,0,0,0,93,20070418
2007,MIL,22,29,21,24,0,0,0,96,CLE,31,23,25,30,0,0,0,109,20070418
2007,WAS,25,33,18,22,0,0,0,98,IND,18,35,20,22,0,0,0,95,20070418
2007,NOK,25,17,23,21,0,0,0,86,LAC,26,18,22,17,0,0,0,83,20070418
2007,MEM,27,27,34,28,0,0,0,116,MIN,27,24,22,21,0,0,0,94,20070418
2007,CHI,22,18,30,27,0,0,0,97,NJN,31,21,19,35,0,0,0,106,20070418
2007,MIA,23,14,10,21,0,0,0,68,ORL,22,17,26,29,0,0,0,94,20070418
2007,GSW,41,23,30,26,0,0,0,120,POR,26,20,31,21,0,0,0,98,20070418
2007,LAL,28,25,35,29,0,0,0,117,SAC,30,27,23,26,0,0,0,106,20070418
2007,DEN,25,21,33,21,0,0,0,100,SAS,16,24,22,15,0,0,0,77,20070418
2007,DAL,33,28,28,17,0,0,0,106,SEA,16,21,22,16,0,0,0,75,20070418
2007,PHI,25,39,22,36,0,0,0,122,TOR,28,29,29,33,0,0,0,119,20070418
2007,HOU,32,15,24,20,0,0,0,91,UTA,20,30,25,26,0,0,0,101,20070418
2007,MIA,28,18,16,29,0,0,0,91,CHI,27,22,23,24,0,0,0,96,20070421
2007,ORL,16,27,24,25,0,0,0,92,DET,28,23,30,19,0,0,0,100,20070421
2007,UTA,19,23,11,22,0,0,0,75,HOU,20,13,26,25,0,0,0,84,20070421
2007,NJN,23,28,27,18,0,0,0,96,TOR,22,19,24,26,0,0,0,91,20070421
2007,WAS,20,21,26,15,0,0,0,82,CLE,27,21,26,23,0,0,0,97,20070422
2007,GSW,23,15,34,25,0,0,0,97,DAL,17,21,28,19,0,0,0,85,20070422
2007,LAL,23,25,29,10,0,0,0,87,PHO,18,21,35,21,0,0,0,95,20070422
2007,DEN,21,23,23,28,0,0,0,95,SAS,16,26,24,23,0,0,0,89,20070422
2007,ORL,22,22,15,31,0,0,0,90,DET,28,19,24,27,0,0,0,98,20070423
2007,UTA,26,15,21,28,0,0,0,90,HOU,17,22,28,31,0,0,0,98,20070423
2007,MIA,21,31,19,18,0,0,0,89,CHI,31,24,30,22,0,0,0,107,20070424
2007,LAL,25,22,23,28,0,0,0,98,PHO,31,37,27,31,0,0,0,126,20070424
2007,NJN,12,24,27,20,0,0,0,83,TOR,14,19,25,31,0,0,0,89,20070424
2007,WAS,23,25,15,39,0,0,0,102,CLE,23,28,24,34,0,0,0,109,20070425
2007,GSW,30,22,22,25,0,0,0,99,DAL,28,26,33,25,0,0,0,112,20070425
2007,DEN,18,23,19,28,0,0,0,88,SAS,24,25,25,23,0,0,0,97,20070425
2007,PHO,31,20,19,19,0,0,0,89,LAL,17,31,26,21,0,0,0,95,20070426
2007,DET,23,25,23,22,0,0,0,93,ORL,23,19,19,16,0,0,0,77,20070426
2007,HOU,17,25,10,15,0,0,0,67,UTA,23,25,13,20,0,0,0,81,20070426
2007,DAL,20,28,23,20,0,0,0,91,GSW,29,32,28,20,0,0,0,109,20070427
2007,CHI,29,16,27,32,0,0,0,104,MIA,23,29,24,20,0,0,0,96,20070427
2007,TOR,19,20,29,21,0,0,0,89,NJN,31,27,21,23,0,0,0,102,20070427
2007,SAS,22,21,32,21,0,0,0,96,DEN,25,15,27,24,0,0,0,91,20070428
2007,DET,22,25,26,24,0,0,0,97,ORL,25,21,21,26,0,0,0,93,20070428
2007,HOU,21,24,17,23,0,0,0,85,UTA,19,31,33,15,0,0,0,98,20070428
2007,CLE,26,35,16,21,0,0,0,98,WAS,22,22,31,17,0,0,0,92,20070428
2007,DAL,27,22,28,22,0,0,0,99,GSW,21,28,28,26,0,0,0,103,20070429
2007,PHO,33,25,27,28,0,0,0,113,LAL,28,23,20,29,0,0,0,100,20070429
2007,CHI,23,21,24,24,0,0,0,92,MIA,28,20,16,15,0,0,0,79,20070429
2007,TOR,15,22,19,25,0,0,0,81,NJN,32,24,30,16,0,0,0,102,20070429
2007,SAS,20,22,25,29,0,0,0,96,DEN,27,23,23,16,0,0,0,89,20070430
2007,UTA,23,21,28,20,0,0,0,92,HOU,21,22,25,28,0,0,0,96,20070430
2007,CLE,22,22,22,31,0,0,0,97,WAS,23,24,20,23,0,0,0,90,20070430
2007,GSW,28,27,32,25,0,0,0,112,DAL,38,24,28,28,0,0,0,118,20070501
2007,NJN,13,29,25,29,0,0,0,96,TOR,33,26,20,19,0,0,0,98,20070501
2007,LAL,23,29,33,25,0,0,0,110,PHO,32,32,27,28,0,0,0,119,20070502
2007,DEN,21,27,11,19,0,0,0,78,SAS,25,19,19,30,0,0,0,93,20070502
2007,DAL,25,23,15,23,0,0,0,86,GSW,28,22,36,25,0,0,0,111,20070503
2007,HOU,22,21,19,20,0,0,0,82,UTA,20,26,22,26,0,0,0,94,20070503
2007,TOR,21,25,22,29,0,0,0,97,NJN,21,22,32,23,0,0,0,98,20070504
2007,CHI,23,18,16,12,0,0,0,69,DET,29,25,16,25,0,0,0,95,20070505
2007,UTA,29,24,22,28,0,0,0,103,HOU,22,21,24,32,0,0,0,99,20070505
2007,NJN,20,21,18,18,0,0,0,77,CLE,23,20,16,22,0,0,0,81,20070506
2007,SAS,27,24,26,34,0,0,0,111,PHO,26,27,22,31,0,0,0,106,20070506
2007,CHI,18,25,19,25,0,0,0,87,DET,34,24,25,25,0,0,0,108,20070507
2007,GSW,35,31,23,23,0,0,0,112,UTA,37,26,21,32,0,0,0,116,20070507
2007,NJN,28,17,28,19,0,0,0,92,CLE,24,24,26,28,0,0,0,102,20070508
2007,SAS,25,17,22,17,0,0,0,81,PHO,19,30,22,30,0,0,0,101,20070508
2007,GSW,31,27,31,24,4,0,0,117,UTA,28,35,27,23,14,0,0,127,20070509
2007,DET,18,10,32,21,0,0,0,81,CHI,20,24,17,13,0,0,0,74,20070510
2007,UTA,27,22,36,20,0,0,0,105,GSW,30,40,34,21,0,0,0,125,20070511
2007,CLE,15,28,21,21,0,0,0,85,NJN,22,23,28,23,0,0,0,96,20070512
2007,PHO,30,23,19,29,0,0,0,101,SAS,25,30,25,28,0,0,0,108,20070512
2007,DET,19,24,13,31,0,0,0,87,CHI,27,23,27,25,0,0,0,102,20070513
2007,UTA,25,25,25,40,0,0,0,115,GSW,23,26,29,23,0,0,0,101,20070513
2007,CLE,19,23,29,16,0,0,0,87,NJN,20,26,23,16,0,0,0,85,20070514
2007,PHO,24,16,32,32,0,0,0,104,SAS,22,23,35,18,0,0,0,98,20070514
2007,CHI,31,28,33,16,0,0,0,108,DET,25,26,20,21,0,0,0,92,20070515
2007,GSW,32,22,19,14,0,0,0,87,UTA,29,23,25,23,0,0,0,100,20070515
2007,NJN,24,23,30,6,0,0,0,83,CLE,18,21,20,13,0,0,0,72,20070516
2007,SAS,13,20,23,32,0,0,0,88,PHO,24,20,18,23,0,0,0,85,20070516
2007,DET,28,15,31,21,0,0,0,95,CHI,23,25,21,16,0,0,0,85,20070517
2007,CLE,32,21,8,27,0,0,0,88,NJN,15,23,22,12,0,0,0,72,20070518
2007,PHO,23,28,16,39,0,0,0,106,SAS,23,30,28,33,0,0,0,114,20070518
2007,UTA,20,16,26,38,0,0,0,100,SAS,23,31,24,30,0,0,0,108,20070520
2007,CLE,24,17,14,21,0,0,0,76,DET,19,16,21,23,0,0,0,79,20070521
2007,UTA,24,17,24,31,0,0,0,96,SAS,26,32,23,24,0,0,0,105,20070522
2007,CLE,16,34,13,13,0,0,0,76,DET,20,18,22,19,0,0,0,79,20070524
2007,SAS,23,24,20,16,0,0,0,83,UTA,15,28,32,34,0,0,0,109,20070526
2007,DET,22,21,20,19,0,0,0,82,CLE,22,24,16,26,0,0,0,88,20070527
2007,SAS,21,29,13,28,0,0,0,91,UTA,20,22,20,17,0,0,0,79,20070528
2007,DET,22,21,24,20,0,0,0,87,CLE,26,24,15,26,0,0,0,91,20070529
2007,UTA,15,24,17,28,0,0,0,84,SAS,34,21,28,26,0,0,0,109,20070530
2007,CLE,23,28,19,21,9,9,0,109,DET,29,23,18,21,9,7,0,107,20070531
2007,DET,21,27,18,16,0,0,0,82,CLE,27,21,19,31,0,0,0,98,20070602
2007,CLE,15,20,14,27,0,0,0,76,SAS,20,20,24,21,0,0,0,85,20070607
2007,CLE,17,16,29,30,0,0,0,92,SAS,28,30,31,14,0,0,0,103,20070610
2007,SAS,16,24,15,20,0,0,0,75,CLE,18,20,12,22,0,0,0,72,20070612
2007,SAS,19,20,21,23,0,0,0,83,CLE,20,14,18,30,0,0,0,82,20070614
2008,UTA,28,34,24,31,0,0,0,117,GSW,30,21,21,24,0,0,0,96,20071030
2008,HOU,16,27,27,25,0,0,0,95,LAL,25,18,19,31,0,0,0,93,20071030
2008,POR,26,23,28,20,0,0,0,97,SAS,29,30,22,25,0,0,0,106,20071030
2008,DAL,29,25,24,14,0,0,0,92,CLE,15,19,25,15,0,0,0,74,20071031
2008,SEA,31,27,23,22,0,0,0,103,DEN,35,24,27,34,0,0,0,120,20071031
2008,WAS,23,22,25,33,7,0,0,110,IND,28,20,22,33,16,0,0,119,20071031
2008,SAS,23,29,27,25,0,0,0,104,MEM,26,26,30,19,0,0,0,101,20071031
2008,CHI,21,20,32,23,7,0,0,103,NJN,25,31,18,22,16,0,0,112,20071031
2008,SAC,24,18,19,29,0,0,0,90,NOH,29,28,30,17,0,0,0,104,20071031
2008,MIL,24,22,16,21,0,0,0,83,ORL,24,24,35,19,0,0,0,102,20071031
2008,PHI,22,28,17,30,0,0,0,97,TOR,24,34,23,25,0,0,0,106,20071031
2008,DET,26,22,18,25,0,0,0,91,MIA,22,20,20,18,0,0,0,80,20071101
2008,PHO,27,28,24,27,0,0,0,106,SEA,26,32,24,17,0,0,0,99,20071101
2008,HOU,24,33,21,28,0,0,0,106,UTA,29,20,17,29,0,0,0,95,20071101
2008,DAL,19,20,30,25,0,0,0,94,ATL,29,17,22,33,0,0,0,101,20071102
2008,WAS,18,18,21,26,0,0,0,83,BOS,21,37,21,24,0,0,0,103,20071102
2008,MIL,18,31,20,30,0,0,0,99,CHA,24,22,25,31,0,0,0,102,20071102
2008,PHI,28,14,29,25,0,0,0,96,CHI,20,21,20,24,0,0,0,85,20071102
2008,NYK,34,20,26,26,0,0,0,106,CLE,32,23,20,35,0,0,0,110,20071102
2008,MIA,22,25,18,20,0,0,0,85,IND,24,24,20,19,0,0,0,87,20071102
2008,GSW,27,34,29,24,0,0,0,114,LAC,35,26,31,28,0,0,0,120,20071102
2008,DEN,21,28,25,25,0,0,0,99,MIN,27,25,25,14,0,0,0,91,20071102
2008,TOR,21,35,24,26,0,0,0,106,NJN,21,20,12,16,0,0,0,69,20071102
2008,POR,21,28,15,29,0,0,0,93,NOH,31,26,30,26,0,0,0,113,20071102
2008,DET,28,36,27,25,0,0,0,116,ORL,30,25,23,14,0,0,0,92,20071102
2008,LAL,33,30,32,24,0,0,0,119,PHO,20,30,17,31,0,0,0,98,20071102
2008,SAC,10,13,31,26,0,0,0,80,SAS,17,33,21,25,0,0,0,96,20071102
2008,SAC,25,31,27,19,0,0,0,102,DAL,37,36,28,22,0,0,0,123,20071103
2008,POR,12,19,15,34,0,0,0,80,HOU,25,21,16,27,0,0,0,89,20071103
2008,IND,40,32,22,27,0,0,0,121,MEM,31,30,26,24,0,0,0,111,20071103
2008,CHI,19,16,13,24,0,0,0,72,MIL,20,12,24,22,0,0,0,78,20071103
2008,NJN,17,21,29,26,0,0,0,93,PHI,19,15,23,31,0,0,0,88,20071103
2008,GSW,28,18,35,29,0,0,0,110,UTA,29,36,29,39,0,0,0,133,20071103
2008,ORL,19,31,14,30,0,0,0,94,WAS,18,24,25,15,0,0,0,82,20071103
2008,NOH,14,34,25,20,0,0,0,93,DEN,21,28,20,19,0,0,0,88,20071104
2008,ATL,19,29,21,22,0,0,0,91,DET,24,21,15,32,0,0,0,92,20071104
2008,SEA,21,31,24,25,0,0,0,101,LAC,25,27,26,37,0,0,0,115,20071104
2008,UTA,21,30,31,27,0,0,0,109,LAL,25,21,35,38,0,0,0,119,20071104
2008,CHA,27,28,20,15,0,0,0,90,MIA,27,21,15,25,0,0,0,88,20071104
2008,MIN,28,22,23,20,0,0,0,93,NYK,21,33,21,22,0,0,0,97,20071104
2008,CLE,22,23,19,28,0,0,0,92,PHO,21,17,31,34,0,0,0,103,20071104
2008,BOS,23,15,28,12,20,0,0,98,TOR,14,17,24,23,17,0,0,95,20071104
2008,HOU,29,22,24,23,0,0,0,98,DAL,24,26,27,30,0,0,0,107,20071105
2008,PHO,29,30,29,27,0,0,0,115,CHA,21,16,24,22,0,0,0,83,20071106
2008,LAC,26,31,18,22,0,0,0,97,CHI,26,26,22,17,0,0,0,91,20071106
2008,CLE,29,25,26,28,0,0,0,108,GSW,23,31,27,23,0,0,0,104,20071106
2008,SAS,19,13,24,25,0,0,0,81,HOU,18,27,19,25,0,0,0,89,20071106
2008,NOH,32,25,32,29,0,0,0,118,LAL,22,33,25,24,0,0,0,104,20071106
2008,TOR,23,25,16,21,0,0,0,85,MIL,37,26,25,24,0,0,0,112,20071106
2008,ORL,26,30,32,23,0,0,0,111,MIN,22,28,24,29,0,0,0,103,20071106
2008,ATL,19,22,16,25,0,0,0,82,NJN,22,23,24,18,0,0,0,87,20071106
2008,DEN,37,29,26,20,0,0,0,112,NYK,32,28,22,37,0,0,0,119,20071106
2008,SEA,25,36,17,20,0,0,0,98,SAC,26,22,24,32,0,0,0,104,20071106
2008,PHO,27,20,29,20,0,0,0,96,ATL,32,23,25,25,0,0,0,105,20071107
2008,DEN,22,16,28,27,0,0,0,93,BOS,38,39,26,16,0,0,0,119,20071107
2008,LAC,24,31,32,17,0,0,0,104,IND,25,33,14,17,0,0,0,89,20071107
2008,CHA,14,18,15,16,0,0,0,63,PHI,23,26,21,24,0,0,0,94,20071107
2008,NOH,23,26,15,26,0,0,0,90,POR,26,18,32,17,0,0,0,93,20071107
2008,MIA,21,17,20,20,0,0,0,78,SAS,23,16,26,23,0,0,0,88,20071107
2008,MEM,27,22,38,18,0,0,0,105,SEA,24,33,24,17,0,0,0,98,20071107
2008,ORL,31,21,26,27,0,0,0,105,TOR,23,24,27,22,0,0,0,96,20071107
2008,CLE,26,22,19,34,0,0,0,101,UTA,29,23,20,31,0,0,0,103,20071107
2008,DET,23,22,30,18,0,0,0,93,CHI,29,22,27,19,0,0,0,97,20071108
2008,DAL,27,30,34,29,0,0,0,120,GSW,27,34,25,29,0,0,0,115,20071108
2008,WAS,27,14,17,27,0,0,0,85,NJN,15,21,21,30,0,0,0,87,20071108
2008,ATL,19,22,20,22,0,0,0,83,BOS,24,31,19,32,0,0,0,106,20071109
2008,IND,27,16,30,14,0,0,0,87,CHA,24,16,25,31,0,0,0,96,20071109
2008,LAC,21,21,14,23,0,0,0,79,DET,31,28,24,20,0,0,0,103,20071109
2008,MIL,25,16,29,18,0,0,0,88,HOU,24,26,28,26,0,0,0,104,20071109
2008,MIN,28,22,19,24,0,0,0,93,LAL,30,26,27,24,0,0,0,107,20071109
2008,PHO,29,26,24,27,0,0,0,106,MIA,37,23,24,17,0,0,0,101,20071109
2008,SAS,23,29,29,16,0,0,0,97,NOH,24,21,18,22,0,0,0,85,20071109
2008,ORL,28,20,29,35,0,0,0,112,NYK,28,21,24,29,0,0,0,102,20071109
2008,TOR,24,23,24,34,0,0,0,105,PHI,19,20,29,35,0,0,0,103,20071109
2008,MEM,26,35,15,22,0,0,0,98,POR,23,26,25,36,0,0,0,110,20071109
2008,CLE,23,25,21,24,0,0,0,93,SAC,21,27,22,21,0,0,0,91,20071109
2008,UTA,28,24,26,25,0,0,0,103,SEA,25,21,29,26,0,0,0,101,20071109
2008,DEN,28,32,33,25,0,0,0,118,WAS,26,25,11,30,0,0,0,92,20071109
2008,TOR,17,24,36,24,0,0,0,101,CHI,13,17,13,28,0,0,0,71,20071110
2008,DEN,31,25,26,31,0,0,0,113,IND,46,28,14,18,0,0,0,106,20071110
2008,BOS,26,33,28,25,0,0,0,112,NJN,27,25,14,35,0,0,0,101,20071110
2008,PHO,34,25,26,21,0,0,0,106,ORL,27,16,23,30,0,0,0,96,20071110
2008,DAL,22,18,17,25,0,0,0,82,POR,28,21,21,21,0,0,0,91,20071110
2008,MIN,19,20,34,20,0,0,0,93,SAC,16,26,31,27,0,0,0,100,20071110
2008,MEM,30,19,22,23,0,0,0,94,UTA,36,28,25,29,0,0,0,118,20071110
2008,WAS,26,25,27,23,0,0,0,101,ATL,23,17,25,25,0,0,0,90,20071111
2008,HOU,14,21,25,25,0,0,0,85,CHA,15,25,25,17,0,0,0,82,20071111
2008,CLE,23,27,22,31,0,0,0,103,LAC,19,25,31,20,0,0,0,95,20071111
2008,MIA,25,12,15,23,0,0,0,75,NYK,20,19,19,14,0,0,0,72,20071111
2008,NOH,23,28,26,16,0,0,0,93,PHI,24,13,17,18,0,0,0,72,20071111
2008,MIL,24,14,23,27,0,0,0,88,SAS,36,29,26,22,0,0,0,113,20071111
2008,DET,35,29,17,26,0,0,0,107,SEA,20,32,21,30,0,0,0,103,20071111
2008,CLE,18,25,25,32,0,0,0,100,DEN,21,37,30,34,0,0,0,122,20071112
2008,NOH,26,23,16,19,0,0,0,84,NJN,21,16,30,15,0,0,0,82,20071112
2008,SAC,18,24,34,17,0,0,0,93,UTA,35,30,24,28,0,0,0,117,20071112
2008,MIA,12,23,12,29,0,0,0,76,CHA,17,23,31,20,0,0,0,91,20071113
2008,PHI,22,28,18,16,0,0,0,84,DAL,21,22,33,23,0,0,0,99,20071113
2008,BOS,26,26,24,25,0,0,0,101,IND,24,19,22,21,0,0,0,86,20071113
2008,HOU,28,25,26,20,0,0,0,99,MEM,25,24,31,25,0,0,0,105,20071113
2008,SEA,14,22,20,20,0,0,0,76,ORL,28,21,36,18,0,0,0,103,20071113
2008,NYK,29,22,21,30,0,0,0,102,PHO,34,29,24,26,0,0,0,113,20071113
2008,DET,27,26,21,20,0,0,0,94,POR,22,28,24,28,0,0,0,102,20071113
2008,LAL,15,23,24,30,0,0,0,92,SAS,21,33,25,28,0,0,0,107,20071113
2008,CHA,22,26,26,35,0,0,0,109,ATL,37,26,18,36,0,0,0,117,20071114
2008,NJN,23,11,20,15,0,0,0,69,BOS,17,19,26,29,0,0,0,91,20071114
2008,ORL,28,27,26,27,9,0,0,117,CLE,29,27,23,29,8,0,0,116,20071114
2008,POR,20,18,23,32,0,0,0,93,DEN,25,27,26,32,0,0,0,110,20071114
2008,DET,25,26,31,29,0,0,0,111,GSW,40,24,21,19,0,0,0,104,20071114
2008,LAL,25,36,14,18,0,0,0,93,HOU,22,27,22,19,0,0,0,90,20071114
2008,NYK,17,27,9,28,0,0,0,81,LAC,18,23,22,21,0,0,0,84,20071114
2008,SEA,30,31,19,24,0,0,0,104,MIA,25,16,27,27,0,0,0,95,20071114
2008,MEM,18,23,30,28,0,0,0,99,MIL,22,25,31,24,0,0,0,102,20071114
2008,SAC,21,27,21,34,0,0,0,103,MIN,21,24,26,37,0,0,0,108,20071114
2008,PHI,20,23,22,11,0,0,0,76,NOH,26,17,30,22,0,0,0,95,20071114
2008,UTA,18,21,25,28,0,0,0,92,TOR,22,14,23,29,0,0,0,88,20071114
2008,IND,15,26,25,24,0,0,0,90,WAS,28,28,27,20,0,0,0,103,20071114
2008,SAS,18,22,30,22,0,0,0,92,DAL,33,26,21,25,0,0,0,105,20071115
2008,CHI,22,24,29,27,0,0,0,102,PHO,26,30,19,37,0,0,0,112,20071115
2008,SEA,26,32,26,23,7,12,0,126,ATL,23,22,37,25,7,9,0,123,20071116
2008,MIA,24,22,19,26,0,0,0,91,BOS,24,28,24,16,0,0,0,92,20071116
2008,UTA,24,19,31,20,0,0,0,94,CLE,19,20,29,31,0,0,0,99,20071116
2008,LAC,26,29,32,18,0,0,0,105,GSW,34,30,32,26,0,0,0,122,20071116
2008,DET,20,26,22,23,0,0,0,91,LAL,29,19,14,41,0,0,0,103,20071116
2008,NOH,32,30,19,33,6,0,0,120,MEM,23,35,26,30,4,0,0,118,20071116
2008,WAS,32,15,24,34,0,0,0,105,MIN,24,27,23,15,0,0,0,89,20071116
2008,ORL,25,20,24,26,0,0,0,95,NJN,10,22,27,11,0,0,0,70,20071116
2008,POR,21,24,28,15,0,0,0,88,PHI,14,13,29,36,0,0,0,92,20071116
2008,NYK,31,16,26,24,10,11,0,118,SAC,28,29,25,15,10,16,0,123,20071116
2008,HOU,24,22,18,20,0,0,0,84,SAS,25,24,20,21,0,0,0,90,20071116
2008,IND,30,26,18,27,0,0,0,101,TOR,22,31,28,29,0,0,0,110,20071116
2008,SEA,22,27,21,14,0,0,0,84,CHA,22,25,30,23,0,0,0,100,20071117
2008,MEM,29,24,25,27,0,0,0,105,DAL,27,27,28,26,0,0,0,108,20071117
2008,NYK,22,18,16,27,0,0,0,83,DEN,30,28,26,31,0,0,0,115,20071117
2008,PHO,37,32,25,21,0,0,0,115,HOU,30,27,19,29,0,0,0,105,20071117
2008,UTA,19,27,26,25,0,0,0,97,IND,33,32,30,22,0,0,0,117,20071117
2008,CHI,29,22,19,22,0,0,0,92,LAC,16,24,19,14,0,0,0,73,20071117
2008,ATL,24,22,24,26,0,0,0,96,MIL,23,34,19,29,0,0,0,105,20071117
2008,NOH,25,17,32,26,0,0,0,100,MIN,21,19,21,21,0,0,0,82,20071117
2008,MIA,18,27,18,28,0,0,0,91,NJN,23,12,26,26,0,0,0,87,20071117
2008,POR,15,23,25,27,0,0,0,90,WAS,22,25,31,31,0,0,0,109,20071117
2008,CHI,21,25,14,18,0,0,0,78,LAL,16,29,30,31,0,0,0,106,20071118
2008,BOS,17,24,35,26,0,0,0,102,ORL,28,30,25,21,0,0,0,104,20071118
2008,DET,31,27,14,23,0,0,0,95,SAC,22,30,23,30,0,0,0,105,20071118
2008,GSW,32,26,22,26,0,0,0,106,TOR,29,32,27,12,0,0,0,100,20071118
2008,POR,23,13,25,31,0,0,0,92,CHA,24,16,23,38,0,0,0,101,20071119
2008,SEA,24,29,24,31,0,0,0,108,MEM,38,30,34,23,0,0,0,125,20071119
2008,ORL,33,20,17,25,0,0,0,95,NOH,17,26,25,20,0,0,0,88,20071119
2008,NJN,17,24,17,17,0,0,0,75,UTA,30,21,32,19,0,0,0,102,20071119
2008,SAS,29,32,22,12,0,0,0,95,ATL,20,24,21,18,0,0,0,83,20071120
2008,MIL,21,28,35,27,0,0,0,111,CLE,31,22,27,27,0,0,0,107,20071120
2008,TOR,31,24,17,27,0,0,0,99,DAL,19,22,38,26,0,0,0,105,20071120
2008,CHI,25,28,16,22,0,0,0,91,DEN,36,36,22,18,0,0,0,112,20071120
2008,LAL,37,34,33,30,0,0,0,134,IND,35,28,27,24,0,0,0,114,20071120
2008,GSW,31,29,17,31,0,0,0,108,NYK,24,23,15,20,0,0,0,82,20071120
2008,PHO,27,28,31,14,0,0,0,100,SAC,26,21,27,24,0,0,0,98,20071120
2008,PHI,26,18,24,33,0,0,0,101,WAS,24,36,38,18,0,0,0,116,20071120
2008,GSW,16,21,27,18,0,0,0,82,BOS,25,25,31,24,0,0,0,105,20071121
2008,WAS,26,18,35,25,10,0,0,114,CHA,20,26,32,26,7,0,0,111,20071121
2008,NYK,23,22,16,25,0,0,0,86,DET,36,19,23,20,0,0,0,98,20071121
2008,DAL,25,22,15,38,0,0,0,100,HOU,30,16,28,20,0,0,0,94,20071121
2008,DEN,27,19,20,24,0,0,0,90,LAC,24,29,24,24,0,0,0,101,20071121
2008,TOR,19,27,22,27,0,0,0,95,MEM,23,21,24,21,0,0,0,89,20071121
2008,ATL,21,16,19,26,0,0,0,82,MIA,24,19,23,13,0,0,0,79,20071121
2008,LAL,24,23,33,23,0,0,0,103,MIL,17,29,29,35,0,0,0,110,20071121
2008,CLE,24,22,26,25,0,0,0,97,MIN,25,17,22,22,0,0,0,86,20071121
2008,IND,23,31,28,23,0,0,0,105,NOH,29,26,17,21,0,0,0,93,20071121
2008,SAC,38,25,19,29,0,0,0,111,PHO,47,33,30,17,0,0,0,127,20071121
2008,NJN,19,26,29,32,0,0,0,106,POR,26,22,31,22,0,0,0,101,20071121
2008,ORL,34,30,26,20,0,0,0,110,SAS,30,29,34,35,0,0,0,128,20071121
2008,LAL,16,19,31,28,0,0,0,94,BOS,25,28,31,23,0,0,0,107,20071123
2008,MIN,22,34,18,19,0,0,0,93,DEN,22,29,24,24,0,0,0,99,20071123
2008,PHI,17,21,16,24,0,0,0,78,DET,17,23,24,19,0,0,0,83,20071123
2008,DAL,25,28,34,20,0,0,0,107,IND,30,32,26,23,0,0,0,111,20071123
2008,HOU,24,25,18,24,0,0,0,91,MIA,26,24,24,24,0,0,0,98,20071123
2008,CHA,16,28,22,26,0,0,0,92,ORL,27,28,25,25,0,0,0,105,20071123
2008,LAC,27,25,22,20,0,0,0,94,PHO,22,29,35,27,0,0,0,113,20071123
2008,SAC,25,18,22,19,0,0,0,84,POR,24,18,20,25,0,0,0,87,20071123
2008,MEM,22,18,19,29,0,0,0,88,SAS,29,32,16,24,0,0,0,101,20071123
2008,NJN,28,24,24,22,0,0,0,98,SEA,22,20,26,25,0,0,0,93,20071123
2008,NOH,24,19,21,7,0,0,0,71,UTA,20,24,31,24,0,0,0,99,20071123
2008,GSW,30,30,30,33,0,0,0,123,WAS,33,28,28,26,0,0,0,115,20071123
2008,BOS,23,25,28,20,0,0,0,96,CHA,23,30,22,20,0,0,0,95,20071124
2008,TOR,30,26,25,27,0,0,0,108,CLE,21,31,29,30,0,0,0,111,20071124
2008,DEN,13,27,22,19,0,0,0,81,HOU,34,24,26,25,0,0,0,109,20071124
2008,NOH,19,36,25,18,0,0,0,98,LAC,24,24,22,19,0,0,0,89,20071124
2008,WAS,26,27,25,40,0,0,0,118,MEM,26,24,32,42,0,0,0,124,20071124
2008,DAL,22,25,19,29,0,0,0,95,MIL,20,24,18,35,0,0,0,97,20071124
2008,ATL,17,28,19,30,0,0,0,94,MIN,28,35,12,12,0,0,0,87,20071124
2008,CHI,19,12,23,24,0,0,0,78,NYK,18,25,22,20,0,0,0,85,20071124
2008,MIA,28,21,27,23,0,0,0,99,ORL,34,25,32,29,0,0,0,120,20071124
2008,GSW,23,22,30,15,10,0,0,100,PHI,30,27,19,14,8,0,0,98,20071124
2008,UTA,30,27,22,24,0,0,0,103,DET,34,16,19,24,0,0,0,93,20071125
2008,CLE,21,33,19,38,0,0,0,111,IND,25,21,29,31,0,0,0,106,20071125
2008,NJN,18,19,35,30,0,0,0,102,LAL,26,23,23,28,0,0,0,100,20071125
2008,SAS,32,32,27,25,0,0,0,116,SEA,30,34,20,17,0,0,0,101,20071125
2008,CHI,33,11,20,14,0,0,0,78,TOR,26,24,20,23,0,0,0,93,20071125
2008,WAS,26,21,38,25,0,0,0,110,DAL,28,17,27,26,0,0,0,98,20071126
2008,PHO,37,26,29,22,0,0,0,114,GSW,45,27,31,26,0,0,0,129,20071126
2008,HOU,21,19,19,29,0,0,0,88,LAC,24,15,19,13,0,0,0,71,20071126
2008,MIN,29,29,18,27,0,0,0,103,NOH,19,18,24,33,0,0,0,94,20071126
2008,UTA,27,25,28,29,0,0,0,109,NYK,31,27,31,24,0,0,0,113,20071126
2008,ORL,17,25,17,26,0,0,0,85,POR,27,15,16,16,0,0,0,74,20071126
2008,SAS,23,25,25,26,0,0,0,99,SAC,22,30,34,26,0,0,0,112,20071126
2008,ATL,17,13,21,27,0,0,0,78,CHI,13,21,36,20,0,0,0,90,20071127
2008,BOS,20,29,23,20,12,0,0,104,CLE,26,20,28,18,17,0,0,109,20071127
2008,IND,31,25,26,30,0,0,0,112,DEN,25,25,33,27,0,0,0,110,20071127
2008,SEA,25,29,19,26,0,0,0,99,LAL,30,24,31,21,0,0,0,106,20071127
2008,CHA,15,28,19,28,0,0,0,90,MIA,23,32,31,24,0,0,0,110,20071127
2008,PHI,32,24,29,29,0,0,0,114,MIL,18,34,24,23,0,0,0,99,20071127
2008,MEM,28,30,23,29,0,0,0,110,NJN,25,20,31,27,0,0,0,103,20071127
2008,MIL,28,14,24,14,0,0,0,80,ATL,28,24,21,23,0,0,0,96,20071128
2008,MIN,22,23,32,26,0,0,0,103,DAL,30,28,25,26,0,0,0,109,20071128
2008,CLE,22,21,16,15,0,0,0,74,DET,23,25,29,32,0,0,0,109,20071128
2008,UTA,25,24,28,29,0,0,0,106,PHI,27,17,24,27,0,0,0,95,20071128
2008,HOU,27,29,21,23,0,0,0,100,PHO,28,24,21,21,0,0,0,94,20071128
2008,IND,17,25,25,28,0,0,0,95,POR,22,24,13,30,0,0,0,89,20071128
2008,GSW,29,24,28,22,0,0,0,103,SAC,25,30,27,14,0,0,0,96,20071128
2008,WAS,23,23,24,24,0,0,0,94,SAS,24,25,30,30,0,0,0,109,20071128
2008,ORL,30,27,26,27,0,0,0,110,SEA,24,21,23,26,0,0,0,94,20071128
2008,MEM,29,10,21,31,0,0,0,91,TOR,27,30,25,21,0,0,0,103,20071128
2008,NYK,16,15,10,18,0,0,0,59,BOS,27,27,28,22,0,0,0,104,20071129
2008,HOU,24,26,18,26,0,0,0,94,GSW,29,30,24,30,0,0,0,113,20071129
2008,DEN,33,24,18,24,0,0,0,99,LAL,21,34,26,46,0,0,0,127,20071129
2008,NOH,28,15,25,24,0,0,0,92,ATL,22,23,18,23,0,0,0,86,20071130
2008,POR,19,17,23,21,0,0,0,80,DAL,18,26,32,15,0,0,0,91,20071130
2008,LAC,24,26,22,35,0,0,0,107,DEN,30,33,27,33,0,0,0,123,20071130
2008,BOS,31,28,24,12,0,0,0,95,MIA,25,16,20,24,0,0,0,85,20071130
2008,SAS,22,26,26,32,0,0,0,106,MIN,24,24,32,11,0,0,0,91,20071130
2008,MIL,29,26,22,11,0,0,0,88,NYK,19,25,21,26,0,0,0,91,20071130
2008,WAS,20,23,25,16,0,0,0,84,PHI,25,17,26,17,0,0,0,85,20071130
2008,ORL,16,34,28,28,0,0,0,106,PHO,31,29,28,22,0,0,0,110,20071130
2008,IND,24,24,17,28,0,0,0,93,SEA,22,27,21,25,0,0,0,95,20071130
2008,CLE,28,21,16,17,0,0,0,82,TOR,27,27,22,15,0,0,0,91,20071130
2008,LAL,22,29,31,14,0,0,0,96,UTA,30,40,32,18,0,0,0,120,20071130
2008,CHA,23,34,18,20,0,0,0,95,CHI,31,27,28,25,0,0,0,111,20071201
2008,MIN,21,19,15,25,0,0,0,80,MEM,26,23,30,30,0,0,0,109,20071201
2008,DET,28,28,28,33,0,0,0,117,MIL,22,20,23,26,0,0,0,91,20071201
2008,PHI,28,23,10,22,9,0,0,92,NJN,19,16,25,23,11,0,0,94,20071201
2008,DAL,23,28,30,21,6,0,0,108,NOH,32,24,24,22,10,0,0,112,20071201
2008,HOU,29,21,24,25,0,0,0,99,SAC,26,23,30,28,0,0,0,107,20071201
2008,TOR,23,22,30,22,0,0,0,97,WAS,23,30,25,23,0,0,0,101,20071201
2008,CLE,19,20,11,20,0,0,0,70,BOS,17,26,21,16,0,0,0,80,20071202
2008,MIA,17,25,22,25,0,0,0,89,DEN,37,22,33,23,0,0,0,115,20071202
2008,NJN,27,17,23,28,0,0,0,95,DET,27,27,33,31,0,0,0,118,20071202
2008,IND,32,18,27,24,0,0,0,101,LAC,19,32,25,19,0,0,0,95,20071202
2008,ORL,24,39,14,27,0,0,0,104,LAL,30,25,20,22,0,0,0,97,20071202
2008,PHO,37,24,24,30,0,0,0,115,NYK,29,28,27,20,0,0,0,104,20071202
2008,POR,17,21,19,22,0,0,0,79,SAS,23,28,26,23,0,0,0,100,20071202
2008,GSW,35,25,28,21,0,0,0,109,SEA,18,23,25,30,0,0,0,96,20071202
2008,DAL,29,27,15,32,0,0,0,103,CHI,24,20,16,38,0,0,0,98,20071203
2008,ORL,30,27,27,25,14,0,0,123,GSW,21,27,31,30,8,0,0,117,20071203
2008,POR,31,19,28,28,0,0,0,106,MEM,24,33,23,25,0,0,0,105,20071203
2008,ATL,24,21,21,22,0,0,0,88,PHI,17,29,16,17,0,0,0,79,20071203
2008,CHA,16,17,26,20,0,0,0,79,TOR,27,27,22,22,0,0,0,98,20071203
2008,MIA,32,21,18,30,0,0,0,101,UTA,31,21,22,36,0,0,0,110,20071203
2008,DET,33,24,30,19,0,0,0,106,ATL,26,22,13,34,0,0,0,95,20071204
2008,NJN,19,28,27,26,0,0,0,100,CLE,22,21,16,20,0,0,0,79,20071204
2008,PHO,38,31,27,25,0,0,0,121,IND,29,35,26,27,0,0,0,117,20071204
2008,MIL,18,18,28,23,0,0,0,87,LAC,26,23,15,14,0,0,0,78,20071204
2008,LAL,30,32,24,30,0,0,0,116,MIN,24,22,22,27,0,0,0,95,20071204
2008,UTA,35,21,21,30,0,0,0,107,SAC,27,26,21,43,0,0,0,117,20071204
2008,CHI,21,18,14,38,0,0,0,91,CHA,21,21,18,22,0,0,0,82,20071205
2008,LAL,29,33,26,23,0,0,0,111,DEN,24,34,30,19,0,0,0,107,20071205
2008,MIL,25,11,27,27,0,0,0,90,GSW,30,27,28,35,0,0,0,120,20071205
2008,MEM,20,22,29,21,0,0,0,92,HOU,24,31,30,20,0,0,0,105,20071205
2008,NYK,26,25,23,26,0,0,0,100,NJN,18,24,24,27,0,0,0,93,20071205
2008,DET,16,28,22,25,0,0,0,91,NOH,26,16,18,16,0,0,0,76,20071205
2008,BOS,26,26,31,30,0,0,0,113,PHI,32,25,23,23,0,0,0,103,20071205
2008,DAL,24,25,17,29,0,0,0,95,SAS,18,24,31,24,0,0,0,97,20071205
2008,LAC,17,18,26,27,0,0,0,88,SEA,18,25,30,22,0,0,0,95,20071205
2008,PHO,33,28,45,30,0,0,0,136,TOR,28,28,29,38,0,0,0,123,20071205
2008,CLE,21,13,28,24,0,0,0,86,WAS,22,31,26,26,0,0,0,105,20071205
2008,MIN,15,25,27,22,0,0,0,89,ATL,29,24,8,29,0,0,0,90,20071206
2008,DEN,39,25,34,24,0,0,0,122,DAL,32,24,36,17,0,0,0,109,20071206
2008,MIA,25,17,31,33,0,0,0,106,POR,30,26,21,35,0,0,0,112,20071206
2008,TOR,16,24,15,29,0,0,0,84,BOS,27,35,29,21,0,0,0,112,20071207
2008,CHI,23,22,27,26,0,0,0,98,DET,17,26,28,20,0,0,0,91,20071207
2008,MIA,39,27,25,22,0,0,0,113,GSW,30,26,26,38,0,0,0,120,20071207
2008,HOU,28,20,24,24,0,0,0,96,NJN,18,15,27,29,0,0,0,89,20071207
2008,MEM,21,26,33,27,9,0,0,116,NOH,25,30,30,22,11,0,0,118,20071207
2008,IND,28,26,30,31,0,0,0,115,ORL,32,30,25,22,0,0,0,109,20071207
2008,NYK,27,22,18,23,0,0,0,90,PHI,26,27,19,29,0,0,0,101,20071207
2008,LAC,22,19,30,26,0,0,0,97,SAC,28,24,18,17,0,0,0,87,20071207
2008,UTA,29,22,25,22,0,0,0,98,SAS,21,29,22,32,0,0,0,104,20071207
2008,MIL,24,25,19,30,0,0,0,98,SEA,31,22,20,31,0,0,0,104,20071207
2008,PHO,30,30,40,22,0,0,0,122,WAS,26,29,21,31,0,0,0,107,20071207
2008,MEM,10,18,23,27,0,0,0,78,ATL,25,14,29,18,0,0,0,86,20071208
2008,CLE,26,25,17,25,0,0,0,93,CHA,25,26,18,27,0,0,0,96,20071208
2008,BOS,21,26,22,23,0,0,0,92,CHI,18,25,16,22,0,0,0,81,20071208
2008,UTA,23,25,34,35,0,0,0,117,DAL,28,30,32,35,0,0,0,125,20071208
2008,SAC,34,13,31,19,0,0,0,97,DEN,34,25,18,24,0,0,0,101,20071208
2008,PHO,32,24,24,13,0,0,0,93,MIN,28,27,32,13,0,0,0,100,20071208
2008,PHI,24,25,26,30,0,0,0,105,NYK,19,18,20,20,0,0,0,77,20071208
2008,CHA,16,29,20,20,0,0,0,85,DET,30,26,25,23,0,0,0,104,20071209
2008,MIA,30,21,26,23,0,0,0,100,LAC,26,25,20,23,0,0,0,94,20071209
2008,GSW,31,28,27,27,0,0,0,113,LAL,31,29,32,31,0,0,0,123,20071209
2008,SEA,17,24,24,23,0,0,0,88,NOH,23,29,15,24,0,0,0,91,20071209
2008,MIL,27,24,25,29,8,0,0,113,POR,30,27,27,21,12,0,0,117,20071209
2008,HOU,22,23,11,24,0,0,0,80,TOR,16,18,28,31,0,0,0,93,20071209
2008,NJN,23,25,24,17,0,0,0,89,WAS,27,15,36,26,0,0,0,104,20071209
2008,DAL,28,21,30,20,0,0,0,99,NYK,19,17,27,26,0,0,0,89,20071210
2008,ATL,29,20,20,29,0,0,0,98,ORL,19,22,22,24,0,0,0,87,20071210
2008,HOU,24,18,18,28,0,0,0,88,PHI,30,26,30,14,0,0,0,100,20071210
2008,MIA,40,27,22,28,0,0,0,117,PHO,29,34,17,33,0,0,0,113,20071210
2008,MIL,26,23,25,19,0,0,0,93,SAC,26,21,19,30,0,0,0,96,20071210
2008,TOR,19,35,15,31,0,0,0,100,ATL,21,22,25,20,0,0,0,88,20071211
2008,SEA,27,22,24,23,0,0,0,96,CHI,31,36,30,26,0,0,0,123,20071211
2008,IND,16,33,25,31,0,0,0,105,CLE,37,28,32,21,0,0,0,118,20071211
2008,SAS,25,12,27,20,0,0,0,84,GSW,23,30,26,17,0,0,0,96,20071211
2008,DET,37,24,29,23,0,0,0,113,MEM,22,26,26,29,0,0,0,103,20071211
2008,LAC,23,23,21,24,0,0,0,91,NJN,21,25,17,19,0,0,0,82,20071211
2008,POR,29,26,23,19,0,0,0,97,UTA,27,19,20,23,0,0,0,89,20071211
2008,MIN,26,20,23,19,0,0,0,88,WAS,26,30,27,19,0,0,0,102,20071211
2008,SAC,17,28,19,14,0,0,0,78,BOS,25,19,24,22,0,0,0,90,20071212
2008,LAC,21,34,17,31,0,0,0,103,CHA,20,23,36,29,0,0,0,108,20071212
2008,NOH,27,32,22,18,0,0,0,99,DEN,24,27,26,28,0,0,0,105,20071212
2008,DET,16,17,22,22,0,0,0,77,HOU,18,20,19,23,0,0,0,80,20071212
2008,CHI,29,23,25,25,0,0,0,102,IND,20,33,40,24,0,0,0,117,20071212
2008,ORL,20,20,21,25,0,0,0,86,MIL,32,21,22,25,0,0,0,100,20071212
2008,SEA,27,26,30,34,0,0,0,117,NYK,31,25,23,31,0,0,0,110,20071212
2008,MIN,21,24,29,20,0,0,0,94,PHI,28,23,28,19,0,0,0,98,20071212
2008,UTA,22,23,20,33,0,0,0,98,PHO,24,25,18,36,0,0,0,103,20071212
2008,GSW,22,27,28,18,0,0,0,95,POR,22,32,31,20,0,0,0,105,20071212
2008,DAL,17,19,23,17,0,0,0,76,TOR,21,33,21,17,0,0,0,92,20071212
2008,SAS,19,24,31,23,0,0,0,97,LAL,18,33,21,30,0,0,0,102,20071213
2008,WAS,28,31,23,22,0,0,0,104,MIA,16,33,21,21,0,0,0,91,20071213
2008,MIL,21,23,15,23,0,0,0,82,BOS,25,21,32,26,0,0,0,104,20071214
2008,ORL,23,19,30,31,0,0,0,103,CHA,24,27,13,23,0,0,0,87,20071214
2008,NYK,19,26,19,32,0,0,0,96,CHI,23,25,25,28,0,0,0,101,20071214
2008,NOH,13,22,22,23,0,0,0,80,DAL,24,19,18,28,0,0,0,89,20071214
2008,ATL,16,17,20,28,0,0,0,81,DET,21,26,17,27,0,0,0,91,20071214
2008,LAL,28,26,31,21,0,0,0,106,GSW,17,30,36,25,0,0,0,108,20071214
2008,TOR,21,20,28,35,0,0,0,104,IND,25,27,23,18,0,0,0,93,20071214
2008,LAC,24,22,22,30,0,0,0,98,MEM,19,25,22,25,0,0,0,91,20071214
2008,SEA,11,32,32,24,0,0,0,99,MIN,26,20,19,23,0,0,0,88,20071214
2008,CLE,25,32,21,19,0,0,0,97,NJN,21,29,30,25,0,0,0,105,20071214
2008,SAC,24,27,34,24,0,0,0,109,PHI,28,23,23,25,0,0,0,99,20071214
2008,UTA,26,28,20,17,0,0,0,91,POR,28,25,17,29,0,0,0,99,20071214
2008,CHA,22,19,18,25,0,0,0,84,ATL,23,26,25,19,0,0,0,93,20071215
2008,PHI,18,33,16,25,0,0,0,92,CLE,26,20,22,18,0,0,0,86,20071215
2008,DAL,25,13,30,28,0,0,0,96,HOU,21,20,20,22,0,0,0,83,20071215
2008,IND,25,27,26,28,0,0,0,106,MIA,27,28,24,24,0,0,0,103,20071215
2008,MIN,19,23,16,34,0,0,0,92,MIL,22,18,26,29,0,0,0,95,20071215
2008,PHO,26,20,34,18,0,0,0,98,NOH,31,28,21,21,0,0,0,101,20071215
2008,NJN,24,14,24,24,0,0,0,86,NYK,18,22,30,24,0,0,0,94,20071215
2008,MEM,30,25,30,38,0,0,0,123,ORL,29,30,29,31,0,0,0,119,20071215
2008,DEN,27,23,18,23,0,0,0,91,SAS,22,34,36,10,0,0,0,102,20071215
2008,SEA,27,13,26,9,0,0,0,75,UTA,20,31,25,20,0,0,0,96,20071215
2008,SAC,24,27,16,12,0,0,0,79,WAS,33,19,28,12,0,0,0,92,20071215
2008,POR,30,31,31,24,0,0,0,116,DEN,25,24,24,32,0,0,0,105,20071216
2008,GSW,22,13,32,20,0,0,0,87,DET,23,35,29,22,0,0,0,109,20071216
2008,LAC,15,29,32,16,0,0,0,92,LAL,29,28,25,31,0,0,0,113,20071216
2008,BOS,27,23,21,19,0,0,0,90,TOR,17,19,18,23,0,0,0,77,20071216
2008,UTA,31,22,33,25,0,0,0,111,ATL,25,26,35,30,0,0,0,116,20071217
2008,MIL,24,20,19,22,8,6,0,99,CLE,26,20,14,25,8,11,0,104,20071217
2008,ORL,27,27,25,29,0,0,0,108,DAL,29,28,27,27,0,0,0,111,20071217
2008,GSW,32,34,29,30,0,0,0,125,MEM,34,22,21,40,0,0,0,117,20071217
2008,MIN,24,23,17,23,0,0,0,87,MIA,27,14,19,31,0,0,0,91,20071217
2008,IND,26,27,31,35,0,0,0,119,NYK,27,19,26,20,0,0,0,92,20071217
2008,NOH,20,19,21,16,0,0,0,76,POR,20,17,27,24,0,0,0,88,20071217
2008,PHO,26,25,23,26,0,0,0,100,SAS,20,30,17,28,0,0,0,95,20071217
2008,LAL,21,28,24,30,0,0,0,103,CHI,15,30,23,23,0,0,0,91,20071218
2008,TOR,19,22,24,15,0,0,0,80,LAC,23,26,11,17,0,0,0,77,20071218
2008,SAC,28,24,25,29,0,0,0,106,NJN,25,25,28,23,0,0,0,101,20071218
2008,MIA,22,25,30,27,7,0,0,111,ATL,25,26,31,22,10,0,0,114,20071219
2008,DET,25,20,16,26,0,0,0,87,BOS,29,23,13,20,0,0,0,85,20071219
2008,UTA,19,24,26,23,0,0,0,92,CHA,21,22,24,31,0,0,0,98,20071219
2008,PHO,20,34,23,28,0,0,0,105,DAL,37,21,25,25,0,0,0,108,20071219
2008,ORL,15,29,27,26,0,0,0,97,HOU,22,18,22,30,0,0,0,92,20071219
2008,PHI,28,19,20,18,0,0,0,85,IND,26,24,31,21,0,0,0,102,20071219
2008,SAS,19,16,24,26,0,0,0,85,MEM,31,18,27,12,0,0,0,88,20071219
2008,SAC,28,18,22,34,0,0,0,102,MIL,26,21,21,21,0,0,0,89,20071219
2008,GSW,26,28,37,20,0,0,0,111,MIN,29,33,17,19,0,0,0,98,20071219
2008,CLE,30,20,20,20,0,0,0,90,NYK,31,32,24,21,0,0,0,108,20071219
2008,TOR,30,26,27,13,0,0,0,96,POR,31,20,25,25,0,0,0,101,20071219
2008,NOH,24,28,29,26,0,0,0,107,SEA,17,16,30,30,0,0,0,93,20071219
2008,CHI,20,25,20,30,0,0,0,95,WAS,27,13,23,21,0,0,0,84,20071219
2008,LAL,28,25,25,12,0,0,0,90,CLE,28,23,22,21,0,0,0,94,20071220
2008,HOU,23,19,27,25,8,9,0,111,DEN,18,26,29,21,8,10,0,112,20071220
2008,NJN,21,20,25,28,13,0,0,107,MIA,21,23,26,24,9,0,0,103,20071220
2008,CHI,19,22,26,15,0,0,0,82,BOS,26,30,31,20,0,0,0,107,20071221
2008,NYK,24,20,22,29,0,0,0,95,CHA,34,33,18,20,0,0,0,105,20071221
2008,LAC,22,20,21,26,0,0,0,89,DAL,23,31,19,29,0,0,0,102,20071221
2008,MEM,18,20,16,13,0,0,0,67,DET,21,21,26,26,0,0,0,94,20071221
2008,IND,40,15,30,33,0,0,0,118,MIN,20,40,36,35,0,0,0,131,20071221
2008,UTA,28,21,30,34,0,0,0,113,ORL,27,23,20,24,0,0,0,94,20071221
2008,LAL,32,24,28,22,0,0,0,106,PHI,24,29,28,20,0,0,0,101,20071221
2008,DEN,22,30,24,20,0,0,0,96,POR,30,20,19,30,0,0,0,99,20071221
2008,TOR,33,29,21,32,0,0,0,115,SEA,33,23,36,31,0,0,0,123,20071221
2008,ATL,25,20,23,29,0,0,0,97,WAS,21,26,20,25,0,0,0,92,20071221
2008,HOU,21,31,34,30,0,0,0,116,CHI,26,22,24,26,0,0,0,98,20071222
2008,WAS,18,16,27,24,0,0,0,85,IND,22,23,23,25,0,0,0,93,20071222
2008,PHI,25,22,22,30,0,0,0,99,MEM,30,22,22,23,0,0,0,97,20071222
2008,UTA,23,19,21,39,0,0,0,102,MIA,21,29,24,30,0,0,0,104,20071222
2008,CHA,26,21,24,28,0,0,0,99,MIL,35,23,27,18,0,0,0,103,20071222
2008,GSW,17,28,27,23,0,0,0,95,NJN,27,25,28,20,0,0,0,100,20071222
2008,MIN,20,18,15,23,0,0,0,76,NOH,30,23,26,31,0,0,0,110,20071222
2008,TOR,30,31,22,20,0,0,0,103,PHO,35,31,37,19,0,0,0,122,20071222
2008,LAC,16,23,24,27,0,0,0,90,SAS,24,36,17,22,0,0,0,99,20071222
2008,ORL,21,21,22,27,0,0,0,91,BOS,27,22,29,25,0,0,0,103,20071223
2008,GSW,38,25,28,14,0,0,0,105,CLE,22,28,17,29,0,0,0,96,20071223
2008,HOU,22,22,16,22,0,0,0,82,DET,25,26,27,16,0,0,0,94,20071223
2008,LAL,31,24,20,20,0,0,0,95,NYK,21,16,24,29,0,0,0,90,20071223
2008,DEN,23,28,26,29,0,0,0,106,SAC,31,35,21,18,0,0,0,105,20071223
2008,MIA,17,30,14,21,0,0,0,82,CLE,25,18,24,29,0,0,0,96,20071225
2008,PHO,26,36,27,26,0,0,0,115,LAL,25,37,30,30,0,0,0,122,20071225
2008,SEA,24,20,18,17,0,0,0,79,POR,24,22,24,19,0,0,0,89,20071225
2008,IND,25,20,25,25,0,0,0,95,ATL,23,29,24,31,0,0,0,107,20071226
2008,WAS,41,17,23,27,0,0,0,108,CHA,30,25,19,30,0,0,0,104,20071226
2008,MIL,17,21,28,39,0,0,0,105,DEN,28,40,27,30,0,0,0,125,20071226
2008,MIN,24,19,31,27,0,0,0,101,GSW,33,23,30,19,0,0,0,105,20071226
2008,NOH,27,25,34,30,0,0,0,116,MEM,29,21,23,25,0,0,0,98,20071226
2008,DET,26,19,31,25,0,0,0,101,NJN,24,20,18,21,0,0,0,83,20071226
2008,NYK,31,20,25,20,0,0,0,96,ORL,26,24,29,31,0,0,0,110,20071226
2008,MIA,17,21,26,21,0,0,0,85,PHI,25,30,19,22,0,0,0,96,20071226
2008,BOS,18,35,13,23,0,0,0,89,SAC,16,13,27,13,0,0,0,69,20071226
2008,CHI,22,17,20,20,0,0,0,79,SAS,21,30,21,22,0,0,0,94,20071226
2008,DAL,18,28,24,20,0,0,0,90,UTA,29,18,31,21,0,0,0,99,20071226
2008,CLE,23,24,21,20,0,0,0,88,DAL,20,18,24,19,0,0,0,81,20071227
2008,PHO,27,32,30,19,0,0,0,108,LAC,20,20,19,29,0,0,0,88,20071227
2008,BOS,24,23,23,34,0,0,0,104,SEA,19,27,21,29,0,0,0,96,20071227
2008,NOH,28,25,28,18,0,0,0,99,CHA,14,20,28,23,0,0,0,85,20071228
2008,MIL,25,22,29,23,0,0,0,99,CHI,28,18,24,33,0,0,0,103,20071228
2008,IND,19,22,29,31,0,0,0,101,DET,24,40,29,21,0,0,0,114,20071228
2008,DEN,39,32,31,22,0,0,0,124,GSW,32,32,33,23,0,0,0,120,20071228
2008,UTA,23,25,26,35,0,0,0,109,LAL,38,37,31,17,0,0,0,123,20071228
2008,HOU,22,28,28,25,0,0,0,103,MEM,15,28,22,18,0,0,0,83,20071228
2008,ORL,28,22,28,29,14,0,0,121,MIA,26,28,21,32,7,0,0,114,20071228
2008,WAS,27,32,27,20,0,0,0,106,NJN,30,23,34,22,0,0,0,109,20071228
2008,LAC,19,28,18,23,0,0,0,88,PHO,27,24,15,28,0,0,0,94,20071228
2008,MIN,19,27,23,29,0,0,0,98,POR,25,30,23,31,0,0,0,109,20071228
2008,PHI,26,24,13,29,0,0,0,92,SAC,25,21,17,17,0,0,0,80,20071228
2008,TOR,19,25,15,24,0,0,0,83,SAS,16,16,24,17,0,0,0,73,20071228
2008,ATL,21,14,25,24,0,0,0,84,DAL,34,20,21,22,0,0,0,97,20071229
2008,TOR,19,21,24,15,0,0,0,79,HOU,19,21,28,23,0,0,0,91,20071229
2008,DET,25,27,24,22,0,0,0,98,IND,25,26,19,22,0,0,0,92,20071229
2008,NJN,19,24,22,32,0,0,0,97,MIL,25,18,20,32,0,0,0,95,20071229
2008,CLE,18,24,15,19,0,0,0,76,NOH,26,20,25,15,0,0,0,86,20071229
2008,CHA,29,22,21,23,0,0,0,95,ORL,28,24,25,27,0,0,0,104,20071229
2008,MIN,30,16,13,31,0,0,0,90,SEA,21,36,27,25,0,0,0,109,20071229
2008,BOS,28,21,27,28,0,0,0,104,UTA,29,27,22,20,0,0,0,98,20071229
2008,MIA,18,21,16,19,0,0,0,74,WAS,26,32,24,14,0,0,0,96,20071229
2008,GSW,26,29,20,30,0,0,0,105,DEN,21,30,21,23,0,0,0,95,20071230
2008,BOS,32,21,29,28,0,0,0,110,LAL,23,22,21,25,0,0,0,91,20071230
2008,CHI,30,20,23,27,0,0,0,100,NYK,22,21,14,26,0,0,0,83,20071230
2008,PHI,16,29,18,9,0,0,0,72,POR,21,15,26,35,0,0,0,97,20071230
2008,PHO,32,32,29,24,0,0,0,117,SAC,28,27,31,16,0,0,0,102,20071230
2008,MEM,32,14,18,23,0,0,0,87,SAS,22,26,38,25,0,0,0,111,20071230
2008,IND,24,29,24,17,9,0,0,103,CHA,28,19,19,28,13,0,0,107,20071231
2008,ORL,29,19,29,19,16,0,0,112,CHI,30,25,20,21,14,0,0,110,20071231
2008,MIL,15,22,20,12,0,0,0,69,DET,28,28,30,28,0,0,0,114,20071231
2008,GSW,28,24,23,37,0,0,0,112,HOU,22,34,24,15,0,0,0,95,20071231
2008,MIN,23,23,24,12,0,0,0,82,LAC,21,20,18,32,0,0,0,91,20071231
2008,TOR,32,20,19,26,0,0,0,97,NOH,28,20,26,18,0,0,0,92,20071231
2008,PHI,21,25,27,25,0,0,0,98,SEA,23,11,28,28,0,0,0,90,20071231
2008,POR,29,21,29,22,0,0,0,101,UTA,23,29,35,24,0,0,0,111,20071231
2008,HOU,16,26,26,25,0,0,0,93,BOS,30,23,23,21,0,0,0,97,20080102
2008,CHI,23,26,29,31,0,0,0,109,CHA,28,29,22,18,0,0,0,97,20080102
2008,ATL,19,19,30,26,0,0,0,94,CLE,22,15,32,29,0,0,0,98,20080102
2008,GSW,23,29,33,14,0,0,0,99,DAL,36,24,29,32,0,0,0,121,20080102
2008,MEM,26,17,28,19,0,0,0,90,IND,22,22,19,9,0,0,0,72,20080102
2008,NOH,23,18,30,24,0,0,0,95,LAC,16,25,17,23,0,0,0,81,20080102
2008,MIL,22,23,26,32,0,0,0,103,MIA,26,21,20,31,0,0,0,98,20080102
2008,POR,23,29,23,15,0,0,0,90,MIN,18,24,20,17,0,0,0,79,20080102
2008,SAC,28,26,35,18,0,0,0,107,NYK,23,17,30,27,0,0,0,97,20080102
2008,NJN,18,20,28,30,0,0,0,96,ORL,31,15,31,18,0,0,0,95,20080102
2008,PHI,20,27,24,36,0,0,0,107,UTA,24,29,25,32,0,0,0,110,20080102
2008,DET,26,31,27,22,0,0,0,106,WAS,27,20,25,21,0,0,0,93,20080102
2008,POR,21,20,28,19,14,13,0,115,CHI,22,26,22,18,14,7,0,109,20080103
2008,SAS,15,25,19,18,0,0,0,77,DEN,20,22,18,20,0,0,0,80,20080103
2008,SEA,33,12,18,33,0,0,0,96,PHO,13,30,29,32,0,0,0,104,20080103
2008,MEM,24,21,20,31,0,0,0,96,BOS,22,25,27,26,0,0,0,100,20080104
2008,SAC,29,20,24,20,0,0,0,93,CLE,21,28,18,30,0,0,0,97,20080104
2008,MIA,24,32,18,15,0,0,0,89,DAL,24,24,23,23,0,0,0,94,20080104
2008,NOH,39,19,32,26,0,0,0,116,GSW,27,29,18,30,0,0,0,104,20080104
2008,ATL,20,23,18,30,0,0,0,91,IND,24,30,33,26,0,0,0,113,20080104
2008,PHI,26,14,28,25,0,0,0,93,LAL,34,30,32,28,0,0,0,124,20080104
2008,WAS,23,29,27,22,0,0,0,101,MIL,10,21,18,28,0,0,0,77,20080104
2008,DEN,30,31,26,31,0,0,0,118,MIN,25,27,28,27,0,0,0,107,20080104
2008,CHA,31,17,19,29,0,0,0,96,NJN,21,21,27,33,0,0,0,102,20080104
2008,HOU,32,19,25,20,0,0,0,96,ORL,25,24,23,22,0,0,0,94,20080104
2008,NYK,24,20,27,22,0,0,0,93,SAS,27,24,25,21,0,0,0,97,20080104
2008,DET,22,26,21,32,0,0,0,101,TOR,19,20,25,21,0,0,0,85,20080104
2008,NJN,22,28,26,37,0,0,0,113,ATL,27,30,22,28,0,0,0,107,20080105
2008,SAC,25,24,22,22,0,0,0,93,CHI,24,28,23,19,0,0,0,94,20080105
2008,BOS,12,29,22,29,0,0,0,92,DET,22,21,23,19,0,0,0,85,20080105
2008,NYK,13,29,27,22,0,0,0,91,HOU,27,28,24,24,0,0,0,103,20080105
2008,NOH,34,23,33,28,0,0,0,118,PHO,31,37,25,20,0,0,0,113,20080105
2008,UTA,23,19,22,25,0,0,0,89,POR,22,17,36,28,0,0,0,103,20080105
2008,MIL,22,24,20,27,0,0,0,93,CHA,15,32,23,19,0,0,0,89,20080106
2008,PHI,22,21,24,29,0,0,0,96,DEN,29,24,24,32,0,0,0,109,20080106
2008,SAS,21,21,22,24,0,0,0,88,LAC,24,18,20,20,0,0,0,82,20080106
2008,IND,23,30,19,24,0,0,0,96,LAL,33,22,35,22,0,0,0,112,20080106
2008,MIA,22,24,20,28,0,0,0,94,MEM,28,15,27,31,0,0,0,101,20080106
2008,DAL,31,27,25,18,0,0,0,101,MIN,16,19,23,20,0,0,0,78,20080106
2008,CLE,14,19,24,36,0,0,0,93,TOR,28,15,27,20,0,0,0,90,20080106
2008,SEA,17,29,23,17,0,0,0,86,WAS,31,21,26,30,0,0,0,108,20080106
2008,SAS,19,25,30,38,9,0,0,121,GSW,17,34,28,33,18,0,0,130,20080107
2008,DEN,34,25,31,25,0,0,0,115,PHO,46,32,28,31,0,0,0,137,20080107
2008,NJN,23,22,29,25,0,0,0,99,CHA,31,28,27,29,0,0,0,115,20080108
2008,NYK,24,29,24,28,0,0,0,105,CHI,27,25,36,12,0,0,0,100,20080108
2008,SEA,15,18,23,23,0,0,0,79,CLE,24,21,29,21,0,0,0,95,20080108
2008,LAL,39,22,26,30,0,0,0,117,MEM,23,24,24,30,0,0,0,101,20080108
2008,MIA,18,29,24,20,0,0,0,91,MIN,29,30,23,19,0,0,0,101,20080108
2008,MIL,26,20,18,23,0,0,0,87,PHI,17,19,22,25,0,0,0,83,20080108
2008,ORL,18,20,24,38,0,0,0,100,SAC,26,27,25,26,0,0,0,104,20080108
2008,IND,19,31,16,23,0,0,0,89,UTA,40,27,23,21,0,0,0,111,20080108
2008,HOU,31,21,22,18,0,0,0,92,WAS,24,19,20,21,0,0,0,84,20080108
2008,CLE,14,18,20,29,0,0,0,81,ATL,13,23,29,25,0,0,0,90,20080109
2008,CHA,20,25,27,23,0,0,0,95,BOS,24,17,24,18,0,0,0,83,20080109
2008,DET,20,23,22,21,0,0,0,86,DAL,32,16,31,23,0,0,0,102,20080109
2008,ORL,35,24,29,25,0,0,0,113,LAC,20,34,25,27,0,0,0,106,20080109
2008,MIA,23,27,16,26,0,0,0,92,MIL,25,30,13,30,0,0,0,98,20080109
2008,SEA,21,25,19,23,0,0,0,88,NJN,30,29,21,19,0,0,0,99,20080109
2008,LAL,32,22,30,25,0,0,0,109,NOH,19,24,25,12,0,0,0,80,20080109
2008,HOU,25,25,25,26,0,0,0,101,NYK,19,34,21,18,0,0,0,92,20080109
2008,IND,31,33,28,20,10,0,0,122,PHO,35,23,30,24,17,0,0,129,20080109
2008,GSW,14,27,23,27,0,0,0,91,POR,30,26,28,25,0,0,0,109,20080109
2008,PHI,25,25,16,30,0,0,0,96,TOR,25,27,27,30,0,0,0,109,20080109
2008,MEM,24,32,29,28,0,0,0,113,SAC,30,24,27,35,0,0,0,116,20080110
2008,DET,30,24,13,23,0,0,0,90,SAS,15,24,19,22,0,0,0,80,20080110
2008,PHO,28,20,12,26,0,0,0,86,UTA,35,23,28,22,0,0,0,108,20080110
2008,WAS,23,16,23,25,15,0,0,102,ATL,17,16,35,19,11,0,0,98,20080111
2008,CHA,37,14,26,16,7,6,0,106,CLE,35,23,11,24,7,13,0,113,20080111
2008,ORL,26,30,30,17,0,0,0,103,DEN,25,28,31,29,0,0,0,113,20080111
2008,MEM,25,29,25,25,0,0,0,104,GSW,33,34,32,17,0,0,0,116,20080111
2008,MIN,18,15,23,26,0,0,0,82,HOU,31,34,22,26,0,0,0,113,20080111
2008,MIL,22,28,24,31,0,0,0,105,LAL,29,25,24,32,0,0,0,110,20080111
2008,BOS,22,25,16,23,0,0,0,86,NJN,30,14,24,9,0,0,0,77,20080111
2008,MIA,24,17,25,22,0,0,0,88,NOH,32,23,31,28,0,0,0,114,20080111
2008,TOR,27,28,26,18,0,0,0,99,NYK,17,29,18,26,0,0,0,90,20080111
2008,CHI,14,31,25,30,0,0,0,100,PHI,27,13,18,39,0,0,0,97,20080111
2008,DAL,18,26,22,24,0,0,0,90,SEA,16,19,13,22,0,0,0,70,20080111
2008,DET,31,20,24,16,12,0,0,103,CHA,18,29,24,20,9,0,0,100,20080112
2008,DAL,21,26,24,24,0,0,0,95,LAC,29,22,24,19,0,0,0,94,20080112
2008,MIL,31,37,18,28,0,0,0,114,PHO,29,32,35,26,0,0,0,122,20080112
2008,IND,29,36,21,25,0,0,0,111,SAC,21,32,27,25,0,0,0,105,20080112
2008,MIN,24,21,21,22,0,0,0,88,SAS,24,20,31,30,0,0,0,105,20080112
2008,ORL,26,23,31,35,0,0,0,115,UTA,31,26,28,34,0,0,0,119,20080112
2008,BOS,19,21,25,13,0,0,0,78,WAS,23,18,19,25,0,0,0,85,20080112
2008,CHI,22,27,17,18,0,0,0,84,ATL,38,31,11,25,0,0,0,105,20080113
2008,IND,34,20,22,25,0,0,0,101,GSW,19,26,28,33,0,0,0,106,20080113
2008,NOH,26,20,12,29,0,0,0,87,HOU,18,21,24,19,0,0,0,82,20080113
2008,MEM,29,22,19,29,0,0,0,99,LAL,31,30,19,20,0,0,0,100,20080113
2008,DET,18,14,10,23,0,0,0,65,NYK,18,25,28,18,0,0,0,89,20080113
2008,POR,24,23,22,24,11,5,0,109,TOR,25,24,14,30,11,12,0,116,20080113
2008,WAS,18,17,24,29,0,0,0,88,BOS,18,19,26,20,0,0,0,83,20080114
2008,DEN,25,43,31,17,0,0,0,116,CHA,34,33,29,23,0,0,0,119,20080114
2008,POR,25,24,19,31,0,0,0,99,NJN,12,22,19,20,0,0,0,73,20080114
2008,DAL,35,22,23,40,0,0,0,120,SAC,26,29,31,36,0,0,0,122,20080114
2008,PHI,24,22,19,17,0,0,0,82,SAS,27,25,12,25,0,0,0,89,20080114
2008,LAL,28,36,23,28,8,0,0,123,SEA,29,33,29,24,6,0,0,121,20080114
2008,MIL,22,26,24,15,0,0,0,87,UTA,24,25,22,27,0,0,0,98,20080114
2008,DEN,22,22,23,26,0,0,0,93,ATL,34,31,17,22,0,0,0,104,20080115
2008,TOR,18,32,15,24,0,0,0,89,DET,20,31,26,26,0,0,0,103,20080115
2008,PHI,30,25,19,37,0,0,0,111,HOU,31,29,25,22,0,0,0,107,20080115
2008,PHO,27,21,17,25,0,0,0,90,LAC,28,21,25,23,0,0,0,97,20080115
2008,CLE,31,25,29,28,19,0,0,132,MEM,31,22,28,32,11,0,0,124,20080115
2008,GSW,28,28,27,22,0,0,0,105,MIN,24,20,22,32,0,0,0,98,20080115
2008,WAS,14,27,31,21,0,0,0,93,NYK,30,21,26,28,0,0,0,105,20080115
2008,CHI,27,25,10,26,0,0,0,88,ORL,24,33,32,13,0,0,0,102,20080115
2008,POR,19,26,24,21,0,0,0,90,BOS,19,24,31,26,0,0,0,100,20080116
2008,ORL,26,30,19,18,0,0,0,93,CHA,20,21,34,24,0,0,0,99,20080116
2008,GSW,29,26,38,24,0,0,0,117,IND,18,33,28,46,0,0,0,125,20080116
2008,CHI,34,24,35,33,0,0,0,126,MIA,23,30,26,17,0,0,0,96,20080116
2008,ATL,21,24,20,15,0,0,0,80,MIL,23,22,20,22,0,0,0,87,20080116
2008,NYK,18,34,34,25,0,0,0,111,NJN,33,22,23,27,0,0,0,105,20080116
2008,SEA,18,28,29,17,0,0,0,92,NOH,30,35,30,28,0,0,0,123,20080116
2008,SAC,28,22,20,21,0,0,0,91,TOR,22,36,32,26,0,0,0,116,20080116
2008,UTA,28,31,29,21,0,0,0,109,DEN,31,30,37,22,0,0,0,120,20080117
2008,PHO,27,29,23,27,0,0,0,106,LAL,24,19,18,37,0,0,0,98,20080117
2008,CLE,19,31,23,17,0,0,0,90,SAS,26,17,22,23,0,0,0,88,20080117
2008,PHI,29,28,16,16,0,0,0,89,BOS,29,25,24,38,0,0,0,116,20080118
2008,GSW,28,22,34,35,0,0,0,119,CHI,29,29,26,27,0,0,0,111,20080118
2008,SAC,23,33,20,24,0,0,0,100,DET,29,19,29,16,0,0,0,93,20080118
2008,SEA,25,22,25,28,0,0,0,100,MEM,32,36,34,22,0,0,0,124,20080118
2008,POR,22,28,19,29,0,0,0,98,MIA,16,25,35,15,0,0,0,91,20080118
2008,CHA,25,15,22,22,0,0,0,84,NOH,26,33,31,22,0,0,0,112,20080118
2008,MIN,32,17,23,23,0,0,0,95,PHO,28,35,28,24,0,0,0,115,20080118
2008,ATL,22,17,21,18,0,0,0,78,TOR,27,17,23,22,0,0,0,89,20080118
2008,LAC,23,22,26,17,0,0,0,88,UTA,34,25,29,18,0,0,0,106,20080118
2008,NYK,32,25,23,18,0,0,0,98,WAS,28,33,31,19,0,0,0,111,20080118
2008,MEM,22,19,26,20,0,0,0,87,CHA,28,18,34,25,0,0,0,105,20080119
2008,DET,22,19,26,14,0,0,0,81,CHI,20,30,21,26,0,0,0,97,20080119
2008,SEA,24,20,28,24,0,0,0,96,DAL,33,33,23,22,0,0,0,111,20080119
2008,MIN,31,29,30,18,0,0,0,108,DEN,34,26,27,24,0,0,0,111,20080119
2008,SAS,21,18,20,22,0,0,0,81,HOU,20,25,16,22,0,0,0,83,20080119
2008,SAC,27,21,30,32,0,0,0,110,IND,22,20,27,35,0,0,0,104,20080119
2008,NJN,19,26,27,29,6,0,0,107,LAC,21,21,29,30,19,0,0,120,20080119
2008,NYK,21,22,22,23,0,0,0,88,MIA,30,18,21,15,0,0,0,84,20080119
2008,GSW,22,31,41,25,0,0,0,119,MIL,27,25,22,25,0,0,0,99,20080119
2008,POR,18,24,22,30,0,0,0,94,ORL,26,24,21,30,0,0,0,101,20080119
2008,TOR,18,22,16,39,0,0,0,95,PHI,15,27,34,23,0,0,0,99,20080119
2008,NJN,20,25,28,19,0,0,0,92,PHO,35,21,33,27,0,0,0,116,20080120
2008,POR,18,36,23,23,11,0,0,111,ATL,27,23,26,24,9,0,0,109,20080121
2008,SAS,26,28,19,22,0,0,0,95,CHA,27,20,20,19,0,0,0,86,20080121
2008,MIN,33,16,36,24,0,0,0,109,GSW,23,29,28,28,0,0,0,108,20080121
2008,SEA,24,28,16,21,0,0,0,89,HOU,22,31,24,19,0,0,0,96,20080121
2008,UTA,23,31,25,30,0,0,0,109,LAC,20,23,24,26,0,0,0,93,20080121
2008,DEN,29,28,25,17,0,0,0,99,LAL,39,28,24,25,0,0,0,116,20080121
2008,CHI,17,18,27,28,0,0,0,90,MEM,22,26,26,30,0,0,0,104,20080121
2008,CLE,27,22,23,25,0,0,0,97,MIA,28,24,18,20,0,0,0,90,20080121
2008,MIL,24,30,15,23,0,0,0,92,NOH,17,33,26,30,0,0,0,106,20080121
2008,BOS,29,30,23,27,0,0,0,109,NYK,23,22,25,23,0,0,0,93,20080121
2008,DET,30,19,29,22,0,0,0,100,ORL,26,29,25,22,0,0,0,102,20080121
2008,IND,32,31,27,20,0,0,0,110,PHI,19,30,30,24,0,0,0,103,20080121
2008,DAL,21,20,19,24,0,0,0,84,WAS,23,23,27,29,0,0,0,102,20080121
2008,PHO,30,24,23,37,0,0,0,114,MIL,24,38,21,22,0,0,0,105,20080122
2008,NJN,25,22,26,21,0,0,0,94,SAC,36,28,33,31,0,0,0,128,20080122
2008,TOR,28,29,27,30,0,0,0,114,BOS,29,26,36,21,0,0,0,112,20080123
2008,DAL,30,27,23,22,0,0,0,102,CHA,17,32,19,27,0,0,0,95,20080123
2008,IND,24,19,30,22,0,0,0,95,CHI,27,30,22,29,0,0,0,108,20080123
2008,WAS,26,20,17,22,0,0,0,85,CLE,34,18,43,26,0,0,0,121,20080123
2008,ATL,17,25,28,30,0,0,0,100,DEN,29,23,26,29,0,0,0,107,20080123
2008,SAC,19,30,15,21,0,0,0,85,LAC,22,28,26,35,0,0,0,111,20080123
2008,ORL,27,31,28,26,0,0,0,112,MEM,28,20,24,13,0,0,0,85,20080123
2008,PHO,27,23,25,32,0,0,0,107,MIN,32,33,23,29,0,0,0,117,20080123
2008,POR,26,18,15,22,0,0,0,81,NOH,20,28,22,26,0,0,0,96,20080123
2008,DET,25,25,20,16,0,0,0,86,PHI,23,18,22,15,0,0,0,78,20080123
2008,LAL,27,27,12,25,0,0,0,91,SAS,23,22,31,27,0,0,0,103,20080123
2008,HOU,24,26,28,31,0,0,0,109,SEA,25,34,24,24,0,0,0,107,20080123
2008,NJN,26,26,38,29,0,0,0,119,GSW,33,20,29,39,0,0,0,121,20080124
2008,SAS,24,21,20,25,0,0,0,90,MIA,28,18,26,17,0,0,0,89,20080124
2008,IND,32,18,23,19,0,0,0,92,MIL,32,20,22,30,0,0,0,104,20080124
2008,MIN,30,17,21,18,0,0,0,86,BOS,29,21,17,20,0,0,0,87,20080125
2008,CHA,20,25,21,24,0,0,0,90,CHI,14,20,25,18,0,0,0,77,20080125
2008,PHO,29,27,31,23,0,0,0,110,CLE,34,35,21,18,0,0,0,108,20080125
2008,LAL,31,24,19,31,0,0,0,105,DAL,28,28,35,21,0,0,0,112,20080125
2008,NJN,11,20,36,18,0,0,0,85,DEN,19,28,26,27,0,0,0,100,20080125
2008,ORL,18,31,25,19,0,0,0,93,DET,39,29,19,14,0,0,0,101,20080125
2008,LAC,22,15,26,29,0,0,0,92,NOH,28,22,31,30,0,0,0,111,20080125
2008,PHI,23,23,20,15,0,0,0,81,NYK,28,22,22,17,0,0,0,89,20080125
2008,HOU,16,26,20,27,0,0,0,89,POR,23,27,12,17,0,0,0,79,20080125
2008,ATL,23,29,26,21,0,0,0,99,SEA,14,17,28,31,0,0,0,90,20080125
2008,MIL,20,22,11,22,0,0,0,75,TOR,23,24,32,27,0,0,0,106,20080125
2008,SAC,23,29,35,26,0,0,0,113,UTA,26,32,37,32,0,0,0,127,20080125
2008,MEM,9,29,33,22,0,0,0,93,WAS,30,29,25,20,0,0,0,104,20080125
2008,PHI,20,27,33,23,0,0,0,103,CHA,27,28,16,25,0,0,0,96,20080126
2008,LAC,28,31,23,26,12,0,0,120,MEM,36,25,29,18,17,0,0,125,20080126
2008,IND,28,29,20,19,0,0,0,96,MIA,23,25,29,21,0,0,0,98,20080126
2008,NOH,28,14,30,30,0,0,0,102,SAS,27,16,21,14,0,0,0,78,20080126
2008,PHO,20,26,22,20,0,0,0,88,CHI,15,27,22,13,0,0,0,77,20080127
2008,DEN,15,19,20,31,0,0,0,85,DAL,24,21,15,30,0,0,0,90,20080127
2008,NYK,20,32,27,25,0,0,0,104,GSW,29,18,29,30,0,0,0,106,20080127
2008,UTA,19,22,19,37,0,0,0,97,HOU,16,19,24,30,0,0,0,89,20080127
2008,CLE,24,25,20,29,0,0,0,98,LAL,26,14,31,24,0,0,0,95,20080127
2008,WAS,17,20,29,24,12,0,0,102,MIL,15,25,26,24,15,0,0,105,20080127
2008,NJN,26,22,26,21,0,0,0,95,MIN,22,16,26,34,0,0,0,98,20080127
2008,BOS,23,23,19,28,0,0,0,93,ORL,19,24,32,21,0,0,0,96,20080127
2008,ATL,29,23,21,20,0,0,0,93,POR,19,18,26,31,0,0,0,94,20080127
2008,SAC,25,29,20,29,0,0,0,103,SEA,18,30,25,28,0,0,0,101,20080127
2008,CHA,29,30,24,24,0,0,0,107,LAC,22,27,22,29,0,0,0,100,20080128
2008,DAL,33,28,23,19,0,0,0,103,MEM,19,25,19,21,0,0,0,84,20080128
2008,DEN,22,18,28,25,0,0,0,93,NOH,33,30,24,30,0,0,0,117,20080128
2008,SAS,19,26,21,25,0,0,0,91,UTA,27,28,21,21,0,0,0,97,20080128
2008,MIN,15,22,25,23,0,0,0,85,CHI,21,22,28,25,0,0,0,96,20080129
2008,GSW,18,28,26,35,0,0,0,107,HOU,33,27,23,28,0,0,0,111,20080129
2008,DET,23,36,24,27,0,0,0,110,IND,32,25,21,26,0,0,0,104,20080129
2008,NYK,29,32,26,22,0,0,0,109,LAL,28,30,27,35,0,0,0,120,20080129
2008,BOS,31,33,30,23,0,0,0,117,MIA,14,28,19,26,0,0,0,87,20080129
2008,MIL,22,13,19,26,0,0,0,80,NJN,20,20,21,26,0,0,0,87,20080129
2008,ATL,17,16,33,26,0,0,0,92,PHO,28,24,38,35,0,0,0,125,20080129
2008,SAS,26,22,18,19,0,0,0,85,SEA,25,21,17,25,0,0,0,88,20080129
2008,TOR,20,30,15,30,9,0,0,104,WAS,23,23,25,24,13,0,0,108,20080129
2008,ATL,21,20,20,27,0,0,0,88,LAC,20,28,26,21,0,0,0,95,20080130
2008,DEN,22,32,19,33,0,0,0,106,MEM,29,23,26,24,0,0,0,102,20080130
2008,CHI,14,20,18,15,0,0,0,67,MIN,8,25,30,20,0,0,0,83,20080130
2008,GSW,32,26,32,26,0,0,0,116,NOH,26,28,31,18,0,0,0,103,20080130
2008,MIA,25,27,24,15,0,0,0,91,ORL,30,33,20,24,0,0,0,107,20080130
2008,MIL,18,14,15,22,0,0,0,69,PHI,27,24,26,35,0,0,0,112,20080130
2008,CLE,20,22,20,22,0,0,0,84,POR,29,19,20,15,0,0,0,83,20080130
2008,CHA,27,25,16,23,0,0,0,91,SAC,28,27,29,21,0,0,0,105,20080130
2008,WAS,23,18,23,19,0,0,0,83,TOR,28,33,34,27,0,0,0,122,20080130
2008,NYK,18,22,28,21,0,0,0,89,UTA,26,25,29,20,0,0,0,100,20080130
2008,DAL,20,24,26,20,0,0,0,90,BOS,27,17,27,25,0,0,0,96,20080131
2008,LAL,22,23,27,17,0,0,0,89,DET,29,23,15,23,0,0,0,90,20080131
2008,SAS,18,16,21,29,0,0,0,84,PHO,25,15,20,21,0,0,0,81,20080131
2008,CLE,24,18,26,27,0,0,0,95,SEA,40,22,23,16,0,0,0,101,20080131
2008,CHA,23,25,21,27,0,0,0,96,GSW,32,37,32,26,0,0,0,127,20080201
2008,HOU,25,29,25,27,0,0,0,106,IND,23,30,26,24,0,0,0,103,20080201
2008,NJN,23,20,27,24,0,0,0,94,MIA,21,10,29,25,0,0,0,85,20080201
2008,LAC,27,29,15,12,0,0,0,83,MIN,20,32,31,21,0,0,0,104,20080201
2008,ORL,33,26,28,21,0,0,0,108,PHI,33,27,24,22,0,0,0,106,20080201
2008,NYK,28,21,20,12,7,0,0,88,POR,24,14,25,18,13,0,0,94,20080201
2008,NOH,19,25,38,21,0,0,0,103,SAC,34,32,30,16,0,0,0,112,20080201
2008,LAL,26,30,27,38,0,0,0,121,TOR,23,28,26,24,0,0,0,101,20080201
2008,UTA,11,27,29,29,0,0,0,96,WAS,21,18,27,21,0,0,0,87,20080201
2008,NJN,18,20,26,28,0,0,0,92,ATL,25,30,24,25,0,0,0,104,20080202
2008,LAC,23,24,22,15,0,0,0,84,CLE,19,26,28,25,0,0,0,98,20080202
2008,CHA,32,35,20,14,0,0,0,101,DEN,27,30,25,35,0,0,0,117,20080202
2008,ORL,34,24,36,27,0,0,0,121,IND,34,26,25,30,0,0,0,115,20080202
2008,UTA,25,28,30,27,0,0,0,110,MEM,23,17,19,32,0,0,0,91,20080202
2008,HOU,21,21,22,27,0,0,0,91,MIL,20,17,24,22,0,0,0,83,20080202
2008,CHI,33,27,17,24,0,0,0,101,SAC,31,32,15,27,0,0,0,105,20080202
2008,NYK,15,23,23,24,0,0,0,85,SEA,17,17,29,23,0,0,0,86,20080202
2008,DAL,14,24,13,16,0,0,0,67,DET,20,24,22,24,0,0,0,90,20080203
2008,LAL,30,33,23,17,0,0,0,103,WAS,15,26,21,29,0,0,0,91,20080203
2008,PHI,32,18,20,21,0,0,0,91,ATL,14,30,28,24,0,0,0,96,20080204
2008,TOR,33,26,30,25,0,0,0,114,MIA,12,29,21,20,0,0,0,82,20080204
2008,HOU,24,23,19,26,0,0,0,92,MIN,18,24,21,23,0,0,0,86,20080204
2008,LAC,31,20,28,24,0,0,0,103,NYK,30,30,14,20,0,0,0,94,20080204
2008,DAL,29,26,16,36,0,0,0,107,ORL,16,25,23,34,0,0,0,98,20080204
2008,CHA,28,23,23,30,0,0,0,104,PHO,31,23,33,31,0,0,0,118,20080204
2008,DEN,20,30,28,22,5,0,0,105,POR,14,30,34,22,3,0,0,103,20080204
2008,CHI,27,29,27,35,0,0,0,118,SEA,25,24,24,35,0,0,0,108,20080204
2008,NOH,20,19,23,26,0,0,0,88,UTA,21,29,32,28,0,0,0,110,20080204
2008,BOS,35,31,21,26,0,0,0,113,CLE,36,28,28,22,0,0,0,114,20080205
2008,SAS,34,25,22,35,0,0,0,116,IND,36,23,9,21,0,0,0,89,20080205
2008,MIL,23,27,28,24,0,0,0,102,MEM,31,23,19,24,0,0,0,97,20080205
2008,LAL,26,21,28,30,0,0,0,105,NJN,27,20,24,19,0,0,0,90,20080205
2008,WAS,25,31,27,13,0,0,0,96,PHI,23,26,24,28,0,0,0,101,20080205
2008,LAL,29,24,23,19,0,0,0,95,ATL,27,18,23,30,0,0,0,98,20080206
2008,LAC,29,19,33,19,0,0,0,100,BOS,25,34,25,27,0,0,0,111,20080206
2008,MIL,23,26,22,25,0,0,0,96,DAL,29,24,18,36,0,0,0,107,20080206
2008,UTA,23,33,22,28,12,0,0,118,DEN,26,15,31,34,9,0,0,115,20080206
2008,MIA,22,26,16,31,0,0,0,95,DET,18,30,27,25,0,0,0,100,20080206
2008,IND,29,26,20,28,0,0,0,103,NYK,26,29,22,23,0,0,0,100,20080206
2008,NJN,24,14,20,26,0,0,0,84,ORL,22,25,28,25,0,0,0,100,20080206
2008,NOH,30,33,24,24,13,8,0,132,PHO,27,28,27,29,13,6,0,130,20080206
2008,CHI,21,22,22,32,0,0,0,97,POR,27,22,24,27,0,0,0,100,20080206
2008,SEA,25,23,33,24,0,0,0,105,SAC,29,20,24,19,0,0,0,92,20080206
2008,SAS,20,18,19,28,0,0,0,85,WAS,15,22,21,19,0,0,0,77,20080206
2008,CHI,32,18,27,37,0,0,0,114,GSW,23,24,30,31,0,0,0,108,20080207
2008,CLE,19,20,20,18,0,0,0,77,HOU,23,17,32,20,0,0,0,92,20080207
2008,MIA,24,26,22,12,0,0,0,84,PHI,30,24,21,26,0,0,0,101,20080207
2008,CLE,25,34,21,20,0,0,0,100,ATL,26,24,19,26,0,0,0,95,20080208
2008,NJN,24,22,27,31,0,0,0,104,CHA,18,23,25,24,0,0,0,90,20080208
2008,MEM,20,18,17,26,0,0,0,81,DAL,20,29,29,14,0,0,0,92,20080208
2008,WAS,16,31,25,28,0,0,0,100,DEN,30,26,32,23,0,0,0,111,20080208
2008,POR,18,17,22,25,0,0,0,82,DET,27,32,22,10,0,0,0,91,20080208
2008,BOS,16,24,22,26,0,0,0,88,MIN,18,27,21,20,0,0,0,86,20080208
2008,SAS,18,14,27,29,11,0,0,99,NYK,17,31,14,26,5,0,0,93,20080208
2008,LAL,33,31,34,19,0,0,0,117,ORL,44,19,24,26,0,0,0,113,20080208
2008,SEA,23,26,25,25,0,0,0,99,PHO,26,27,25,25,0,0,0,103,20080208
2008,UTA,26,31,30,17,0,0,0,104,SAC,32,26,30,29,0,0,0,117,20080208
2008,LAC,21,29,28,24,0,0,0,102,TOR,26,32,19,21,0,0,0,98,20080208
2008,SAC,19,27,32,24,0,0,0,102,GSW,28,23,27,27,0,0,0,105,20080209
2008,ATL,21,10,24,34,0,0,0,89,HOU,31,25,32,20,0,0,0,108,20080209
2008,POR,20,28,15,30,0,0,0,93,IND,20,31,20,30,0,0,0,101,20080209
2008,NYK,26,22,26,25,0,0,0,99,MIL,25,25,31,17,0,0,0,98,20080209
2008,MEM,20,22,29,28,0,0,0,99,NOH,22,26,33,31,0,0,0,112,20080209
2008,LAC,25,15,26,14,0,0,0,80,PHI,29,30,23,19,0,0,0,101,20080209
2008,CHI,22,17,26,22,0,0,0,87,UTA,24,25,23,25,0,0,0,97,20080209
2008,SAS,23,18,20,29,0,0,0,90,BOS,20,23,25,30,0,0,0,98,20080210
2008,DEN,35,28,27,23,0,0,0,113,CLE,24,21,19,19,0,0,0,83,20080210
2008,CHA,13,25,24,25,0,0,0,87,DET,29,26,28,30,0,0,0,113,20080210
2008,LAL,25,26,31,22,0,0,0,104,MIA,24,23,26,21,0,0,0,94,20080210
2008,TOR,29,22,26,28,0,0,0,105,MIN,25,22,14,21,0,0,0,82,20080210
2008,DAL,22,18,21,21,0,0,0,82,NJN,21,25,31,24,0,0,0,101,20080210
2008,WAS,21,25,35,26,0,0,0,107,PHO,27,24,34,23,0,0,0,108,20080210
2008,LAL,30,25,22,29,0,0,0,106,CHA,22,22,25,28,0,0,0,97,20080211
2008,WAS,37,35,23,22,0,0,0,117,GSW,22,33,29,36,0,0,0,120,20080211
2008,POR,24,19,19,21,0,0,0,83,HOU,18,26,25,26,0,0,0,95,20080211
2008,LAC,31,20,25,20,0,0,0,96,MIL,29,21,24,15,0,0,0,89,20080211
2008,CLE,20,32,34,32,0,0,0,118,ORL,28,27,31,25,0,0,0,111,20080211
2008,DAL,25,28,13,10,0,0,0,76,PHI,23,27,20,14,0,0,0,84,20080211
2008,SAS,27,28,13,25,0,0,0,93,TOR,21,19,20,28,0,0,0,88,20080211
2008,DET,25,30,19,20,0,0,0,94,ATL,18,30,28,14,0,0,0,90,20080212
2008,NOH,25,18,29,28,0,0,0,100,CHI,27,23,18,18,0,0,0,86,20080212
2008,BOS,21,30,31,22,0,0,0,104,IND,25,25,27,20,0,0,0,97,20080212
2008,SAC,34,25,20,15,0,0,0,94,MEM,25,29,32,21,0,0,0,107,20080212
2008,DEN,23,34,27,18,12,0,0,114,MIA,32,31,15,24,11,0,0,113,20080212
2008,MIN,16,19,21,32,0,0,0,88,NJN,16,22,28,26,0,0,0,92,20080212
2008,NYK,24,16,32,31,0,0,0,103,BOS,21,32,32,26,0,0,0,111,20080213
2008,ATL,29,22,22,19,6,0,0,98,CHA,19,20,24,29,8,0,0,100,20080213
2008,SAS,18,28,25,41,0,0,0,112,CLE,24,23,28,30,0,0,0,105,20080213
2008,POR,15,28,16,17,0,0,0,76,DAL,28,26,19,23,0,0,0,96,20080213
2008,IND,21,21,10,28,0,0,0,80,DET,25,30,22,19,0,0,0,96,20080213
2008,PHO,32,23,35,28,0,0,0,118,GSW,38,21,28,33,0,0,0,120,20080213
2008,SAC,20,19,22,26,0,0,0,87,HOU,35,17,27,10,0,0,0,89,20080213
2008,WAS,25,20,16,30,0,0,0,91,LAC,17,15,28,29,0,0,0,89,20080213
2008,NOH,31,32,23,25,0,0,0,111,MIL,27,33,26,21,0,0,0,107,20080213
2008,LAL,30,30,39,18,0,0,0,117,MIN,21,23,24,24,0,0,0,92,20080213
2008,DEN,28,20,21,29,0,0,0,98,ORL,26,22,28,33,0,0,0,109,20080213
2008,MEM,21,24,23,20,0,0,0,88,PHI,26,29,29,18,0,0,0,102,20080213
2008,UTA,27,22,32,31,0,0,0,112,SEA,24,23,26,20,0,0,0,93,20080213
2008,NJN,17,24,22,28,0,0,0,91,TOR,30,32,30,17,0,0,0,109,20080213
2008,MIA,28,15,20,29,0,0,0,92,CHI,28,20,22,29,0,0,0,99,20080214
2008,DAL,24,29,20,24,0,0,0,97,PHO,23,29,25,32,0,0,0,109,20080214
2008,HOU,21,21,24,27,0,0,0,93,CLE,20,16,23,26,0,0,0,85,20080219
2008,BOS,31,31,22,34,0,0,0,118,DEN,36,26,26,36,0,0,0,124,20080219
2008,ORL,20,32,31,20,0,0,0,103,DET,25,20,17,23,0,0,0,85,20080219
2008,ATL,14,23,32,24,0,0,0,93,LAL,32,41,24,25,0,0,0,122,20080219
2008,PHI,17,27,18,26,0,0,0,88,MIN,23,30,21,30,0,0,0,104,20080219
2008,SAC,27,24,19,35,0,0,0,105,POR,24,27,14,29,0,0,0,94,20080219
2008,CHA,18,14,17,16,0,0,0,65,SAS,13,23,18,31,0,0,0,85,20080219
2008,MEM,31,31,16,23,0,0,0,101,SEA,27,21,32,28,0,0,0,108,20080219
2008,GSW,36,28,21,24,0,0,0,109,UTA,36,41,25,17,0,0,0,119,20080219
2008,NYK,23,23,21,23,23,0,0,113,WAS,20,30,20,20,10,0,0,100,20080219
2008,BOS,29,28,27,33,0,0,0,117,GSW,32,18,32,37,0,0,0,119,20080220
2008,CLE,34,26,19,27,0,0,0,106,IND,26,28,27,16,0,0,0,97,20080220
2008,MEM,31,16,20,19,0,0,0,86,LAC,21,30,31,18,0,0,0,100,20080220
2008,DET,25,17,22,34,0,0,0,98,MIL,29,28,24,22,0,0,0,103,20080220
2008,CHI,23,21,25,25,8,0,0,102,NJN,20,31,20,23,16,0,0,110,20080220
2008,DAL,22,22,20,29,0,0,0,93,NOH,24,23,28,29,0,0,0,104,20080220
2008,NYK,17,19,21,27,0,0,0,84,PHI,37,35,30,22,0,0,0,124,20080220
2008,LAL,32,33,30,35,0,0,0,130,PHO,29,28,34,33,0,0,0,124,20080220
2008,ATL,26,34,30,17,0,0,0,107,SAC,30,32,31,26,0,0,0,119,20080220
2008,ORL,24,26,32,28,0,0,0,110,TOR,31,33,38,25,0,0,0,127,20080220
2008,MIA,26,22,27,25,0,0,0,100,HOU,41,21,25,25,0,0,0,112,20080221
2008,SAS,22,31,21,26,0,0,0,100,MIN,21,32,19,27,0,0,0,99,20080221
2008,SEA,25,16,26,21,0,0,0,88,POR,23,28,19,22,0,0,0,92,20080221
2008,SAC,28,26,30,25,7,0,0,116,CHA,25,28,25,31,6,0,0,115,20080222
2008,DEN,22,33,32,34,0,0,0,121,CHI,33,35,33,34,0,0,0,135,20080222
2008,WAS,24,18,23,24,0,0,0,89,CLE,23,20,24,23,0,0,0,90,20080222
2008,MIL,35,11,28,26,0,0,0,100,DET,33,32,35,27,0,0,0,127,20080222
2008,ATL,35,33,26,23,0,0,0,117,GSW,23,27,39,21,0,0,0,110,20080222
2008,NJN,27,22,23,31,0,0,0,103,IND,28,22,35,28,0,0,0,113,20080222
2008,UTA,29,20,23,32,0,0,0,104,LAC,25,30,37,22,0,0,0,114,20080222
2008,DAL,30,32,16,20,0,0,0,98,MEM,21,22,24,16,0,0,0,83,20080222
2008,HOU,29,22,31,18,0,0,0,100,NOH,24,11,23,22,0,0,0,80,20080222
2008,TOR,21,32,22,24,0,0,0,99,NYK,12,40,29,22,0,0,0,103,20080222
2008,PHI,16,24,26,33,0,0,0,99,ORL,26,27,23,39,0,0,0,115,20080222
2008,BOS,13,17,19,28,0,0,0,77,PHO,24,19,20,22,0,0,0,85,20080222
2008,POR,19,19,22,27,0,0,0,87,SEA,29,23,19,28,0,0,0,99,20080222
2008,LAL,29,27,34,23,0,0,0,113,LAC,21,27,24,23,0,0,0,95,20080223
2008,PHI,24,27,22,18,10,0,0,101,MIA,19,30,24,18,5,0,0,96,20080223
2008,DEN,30,34,22,23,0,0,0,109,MIL,19,31,32,33,0,0,0,115,20080223
2008,IND,27,19,23,22,0,0,0,91,NJN,24,26,28,24,0,0,0,102,20080223
2008,NOH,21,14,32,22,0,0,0,89,SAS,26,24,26,22,0,0,0,98,20080223
2008,ATL,17,23,22,32,0,0,0,94,UTA,23,24,26,27,0,0,0,100,20080223
2008,CHA,27,25,19,24,0,0,0,95,WAS,28,23,27,32,0,0,0,110,20080223
2008,MEM,13,25,29,22,0,0,0,89,CLE,32,27,23,27,0,0,0,109,20080224
2008,CHI,18,28,22,29,0,0,0,97,HOU,20,29,28,33,0,0,0,110,20080224
2008,DAL,24,24,23,28,0,0,0,99,MIN,24,24,23,12,0,0,0,83,20080224
2008,SAC,29,17,22,25,0,0,0,93,ORL,25,21,28,38,0,0,0,112,20080224
2008,DET,27,32,31,26,0,0,0,116,PHO,16,25,17,28,0,0,0,86,20080224
2008,BOS,16,31,32,33,0,0,0,112,POR,32,22,17,31,0,0,0,102,20080224
2008,LAL,34,28,31,18,0,0,0,111,SEA,18,25,27,21,0,0,0,91,20080224
2008,NYK,23,29,15,25,0,0,0,92,TOR,27,27,30,31,0,0,0,115,20080224
2008,CHI,14,29,23,28,0,0,0,94,DAL,29,24,23,26,0,0,0,102,20080225
2008,DET,30,19,24,25,0,0,0,98,DEN,28,21,24,20,0,0,0,93,20080225
2008,TOR,19,35,23,25,0,0,0,102,IND,30,16,31,21,0,0,0,98,20080225
2008,BOS,23,22,32,27,0,0,0,104,LAC,17,19,21,19,0,0,0,76,20080225
2008,WAS,20,21,27,27,0,0,0,95,NOH,28,24,22,18,0,0,0,92,20080225
2008,ATL,16,21,11,26,0,0,0,74,SAS,5,25,27,32,0,0,0,89,20080225
2008,SEA,32,25,17,25,0,0,0,99,GSW,27,26,27,25,0,0,0,105,20080226
2008,WAS,12,11,26,20,0,0,0,69,HOU,24,27,17,26,0,0,0,94,20080226
2008,POR,27,24,14,18,0,0,0,83,LAL,17,27,23,29,0,0,0,96,20080226
2008,PHO,28,33,29,37,0,0,0,127,MEM,23,30,36,24,0,0,0,113,20080226
2008,SAC,32,20,11,23,0,0,0,86,MIA,30,28,31,18,0,0,0,107,20080226
2008,CLE,28,25,27,22,0,0,0,102,MIL,25,32,20,28,0,0,0,105,20080226
2008,UTA,25,22,25,28,0,0,0,100,MIN,27,25,20,39,0,0,0,111,20080226
2008,ORL,20,24,26,32,0,0,0,102,NJN,23,20,24,25,0,0,0,92,20080226
2008,SAC,28,30,27,32,0,0,0,117,ATL,40,19,34,30,0,0,0,123,20080227
2008,CLE,16,24,22,25,0,0,0,87,BOS,25,22,28,17,0,0,0,92,20080227
2008,CHI,27,29,26,31,0,0,0,113,IND,27,30,25,25,0,0,0,107,20080227
2008,POR,26,16,16,24,0,0,0,82,LAC,15,14,28,23,0,0,0,80,20080227
2008,PHO,29,26,22,26,0,0,0,103,NOH,25,34,38,23,0,0,0,120,20080227
2008,CHA,25,16,21,27,0,0,0,89,NYK,20,34,29,30,0,0,0,113,20080227
2008,ORL,25,17,26,21,0,0,0,89,PHI,33,28,22,18,0,0,0,101,20080227
2008,DEN,31,33,36,38,0,0,0,138,SEA,19,26,30,21,0,0,0,96,20080227
2008,MIN,28,15,22,20,0,0,0,85,TOR,26,25,33,23,0,0,0,107,20080227
2008,DET,30,23,18,24,0,0,0,95,UTA,21,21,25,36,0,0,0,103,20080227
2008,MIA,19,22,17,30,0,0,0,88,LAL,26,27,20,33,0,0,0,106,20080228
2008,MIL,23,32,30,21,0,0,0,106,NJN,32,36,23,29,0,0,0,120,20080228
2008,DAL,25,22,25,22,0,0,0,94,SAS,22,25,26,24,0,0,0,97,20080228
2008,NYK,22,28,28,15,0,0,0,93,ATL,26,22,33,18,0,0,0,99,20080229
2008,CHA,28,18,26,28,0,0,0,100,BOS,33,28,25,22,0,0,0,108,20080229
2008,WAS,23,11,35,28,0,0,0,97,CHI,30,22,14,25,0,0,0,91,20080229
2008,MIN,20,16,23,25,0,0,0,84,CLE,20,20,26,26,0,0,0,92,20080229
2008,SAC,28,26,27,25,0,0,0,106,DAL,30,27,27,31,0,0,0,115,20080229
2008,LAC,22,35,23,24,0,0,0,104,DEN,31,30,27,22,0,0,0,110,20080229
2008,PHI,18,34,21,24,0,0,0,97,GSW,26,41,23,29,0,0,0,119,20080229
2008,MEM,17,24,29,25,0,0,0,95,HOU,37,23,31,25,0,0,0,116,20080229
2008,UTA,15,30,32,21,0,0,0,98,NOH,38,20,27,25,0,0,0,110,20080229
2008,LAL,32,27,28,24,0,0,0,111,POR,27,37,22,33,0,0,0,119,20080229
2008,MIA,25,19,33,26,0,0,0,103,SEA,26,21,29,17,0,0,0,93,20080229
2008,IND,32,29,28,33,0,0,0,122,TOR,22,32,27,30,0,0,0,111,20080229
2008,DET,31,24,21,27,0,0,0,103,LAC,25,17,21,10,0,0,0,73,20080301
2008,UTA,22,31,25,35,0,0,0,113,MEM,28,21,19,24,0,0,0,92,20080301
2008,SAS,27,20,26,23,0,0,0,96,MIL,28,23,17,26,0,0,0,94,20080301
2008,NYK,29,25,20,18,0,0,0,92,ORL,31,37,26,24,0,0,0,118,20080301
2008,PHI,28,26,29,36,0,0,0,119,PHO,18,36,27,33,0,0,0,114,20080301
2008,ATL,22,22,23,21,0,0,0,88,BOS,26,15,29,28,0,0,0,98,20080302
2008,TOR,32,17,21,28,0,0,0,98,CHA,22,26,34,28,0,0,0,110,20080302
2008,CHI,17,22,29,18,0,0,0,86,CLE,24,18,23,30,0,0,0,95,20080302
2008,POR,22,27,32,23,0,0,0,104,GSW,29,25,27,29,0,0,0,110,20080302
2008,DEN,18,22,31,18,0,0,0,89,HOU,21,29,30,23,0,0,0,103,20080302
2008,MIL,29,21,35,21,0,0,0,106,IND,29,35,33,31,0,0,0,128,20080302
2008,DAL,23,24,21,25,11,0,0,104,LAL,29,21,15,28,15,0,0,108,20080302
2008,SEA,34,24,17,27,9,0,0,111,MIN,26,25,25,26,6,0,0,108,20080302
2008,SAS,27,26,19,21,0,0,0,93,NJN,20,23,20,20,0,0,0,83,20080302
2008,MIA,34,35,20,20,0,0,0,109,SAC,27,22,41,30,0,0,0,120,20080302
2008,NOH,20,20,29,15,0,0,0,84,WAS,18,35,21,27,0,0,0,101,20080302
2008,PHI,25,29,19,33,0,0,0,106,LAC,21,21,17,21,0,0,0,80,20080303
2008,NOH,27,22,26,25,0,0,0,100,NYK,31,18,24,15,0,0,0,88,20080303
2008,DAL,24,26,31,29,0,0,0,110,UTA,37,27,23,29,0,0,0,116,20080303
2008,GSW,37,31,32,35,0,0,0,135,ATL,42,28,22,26,0,0,0,118,20080304
2008,MEM,16,20,31,30,0,0,0,97,CHI,22,32,29,29,0,0,0,112,20080304
2008,SEA,41,13,24,19,0,0,0,97,DET,28,25,24,23,0,0,0,100,20080304
2008,CHA,29,27,26,27,0,0,0,109,MIN,27,23,25,14,0,0,0,89,20080304
2008,TOR,18,23,27,19,0,0,0,87,ORL,20,24,27,31,0,0,0,102,20080304
2008,PHO,29,31,19,18,0,0,0,97,POR,20,21,30,21,0,0,0,92,20080304
2008,LAL,27,26,28,36,0,0,0,117,SAC,33,25,29,18,0,0,0,105,20080304
2008,NJN,24,13,14,19,0,0,0,70,SAS,17,27,19,18,0,0,0,81,20080304
2008,DET,13,24,30,11,0,0,0,78,BOS,23,24,22,21,0,0,0,90,20080305
2008,GSW,38,19,29,23,0,0,0,109,CHA,25,34,34,25,0,0,0,118,20080305
2008,PHO,36,25,28,24,0,0,0,113,DEN,32,36,33,25,0,0,0,126,20080305
2008,IND,27,22,29,21,0,0,0,99,HOU,34,32,28,23,0,0,0,117,20080305
2008,SAC,25,29,20,17,6,12,0,109,LAC,24,19,23,25,6,19,0,116,20080305
2008,NJN,21,32,20,20,0,0,0,93,MEM,29,24,20,27,0,0,0,100,20080305
2008,TOR,29,24,27,28,0,0,0,108,MIA,17,25,16,25,0,0,0,83,20080305
2008,SEA,24,30,29,23,0,0,0,106,MIL,39,30,29,20,0,0,0,118,20080305
2008,ATL,20,29,24,28,0,0,0,101,NOH,28,30,30,28,0,0,0,116,20080305
2008,CLE,27,31,26,35,0,0,0,119,NYK,27,27,28,23,0,0,0,105,20080305
2008,MIN,20,19,16,21,0,0,0,76,UTA,26,25,29,25,0,0,0,105,20080305
2008,ORL,34,25,30,33,0,0,0,122,WAS,20,24,23,25,0,0,0,92,20080305
2008,CLE,17,34,16,29,0,0,0,96,CHI,21,26,34,26,0,0,0,107,20080306
2008,HOU,25,27,35,26,0,0,0,113,DAL,24,26,20,28,0,0,0,98,20080306
2008,IND,27,21,21,28,0,0,0,97,SAS,27,23,34,24,0,0,0,108,20080306
2008,CHI,20,23,30,20,0,0,0,93,BOS,32,31,32,21,0,0,0,116,20080307
2008,ATL,24,23,22,24,0,0,0,93,CHA,16,34,28,30,0,0,0,108,20080307
2008,SAS,26,28,19,23,0,0,0,96,DEN,26,20,34,29,0,0,0,109,20080307
2008,LAC,24,17,16,25,0,0,0,82,LAL,26,23,35,35,0,0,0,119,20080307
2008,GSW,32,31,37,34,0,0,0,134,MIA,31,20,22,26,0,0,0,99,20080307
2008,POR,30,17,30,26,0,0,0,103,MIL,32,20,26,23,0,0,0,101,20080307
2008,NJN,28,18,21,29,0,0,0,96,NOH,25,18,35,29,0,0,0,107,20080307
2008,DET,28,25,23,25,0,0,0,101,NYK,25,28,17,27,0,0,0,97,20080307
2008,SEA,22,30,14,17,0,0,0,83,PHI,33,28,27,29,0,0,0,117,20080307
2008,UTA,28,31,26,41,0,0,0,126,PHO,33,33,28,24,0,0,0,118,20080307
2008,MIN,25,32,23,31,0,0,0,111,SAC,24,20,27,32,0,0,0,103,20080307
2008,WAS,29,24,15,30,12,0,0,110,TOR,20,25,29,24,8,0,0,106,20080307
2008,MIA,33,26,11,24,0,0,0,94,ATL,26,30,21,20,0,0,0,97,20080308
2008,IND,17,20,27,31,0,0,0,95,CLE,34,17,26,26,0,0,0,103,20080308
2008,NJN,15,19,29,28,0,0,0,91,DAL,24,28,32,27,0,0,0,111,20080308
2008,NOH,23,23,26,24,0,0,0,96,HOU,20,39,22,25,0,0,0,106,20080308
2008,MIN,25,14,34,26,0,0,0,99,LAC,23,24,31,18,0,0,0,96,20080308
2008,BOS,37,14,40,28,0,0,0,119,MEM,20,17,28,24,0,0,0,89,20080308
2008,POR,36,20,32,20,12,0,0,120,NYK,24,27,33,24,6,0,0,114,20080308
2008,GSW,27,20,33,24,0,0,0,104,ORL,36,19,16,24,0,0,0,95,20080308
2008,DEN,26,28,21,30,0,0,0,105,UTA,34,43,31,24,0,0,0,132,20080308
2008,CHA,35,19,26,20,0,0,0,100,WAS,21,26,23,27,0,0,0,97,20080308
2008,CHI,19,24,35,31,0,0,0,109,DET,29,25,27,35,0,0,0,116,20080309
2008,SAC,31,40,21,22,0,0,0,114,LAL,29,31,29,24,0,0,0,113,20080309
2008,PHI,33,32,23,31,0,0,0,119,MIL,22,21,31,23,0,0,0,97,20080309
2008,SAS,25,23,22,17,0,0,0,87,PHO,22,23,24,25,0,0,0,94,20080309
2008,SEA,31,27,21,27,0,0,0,106,TOR,24,30,35,25,0,0,0,114,20080309
2008,POR,25,18,19,18,0,0,0,80,CLE,14,25,23,26,0,0,0,88,20080310
2008,NYK,15,16,27,21,0,0,0,79,DAL,32,22,26,28,0,0,0,108,20080310
2008,NJN,15,13,19,26,0,0,0,73,HOU,22,24,24,21,0,0,0,91,20080310
2008,LAC,29,29,15,26,0,0,0,99,MIA,23,24,33,18,0,0,0,98,20080310
2008,ATL,26,27,32,27,0,0,0,112,ORL,38,36,25,24,0,0,0,123,20080310
2008,BOS,26,27,23,24,0,0,0,100,PHI,20,27,15,24,0,0,0,86,20080310
2008,DEN,23,35,22,23,0,0,0,103,SAS,27,28,29,23,0,0,0,107,20080310
2008,UTA,23,19,29,25,0,0,0,96,CHI,25,30,31,22,0,0,0,108,20080311
2008,SEA,24,31,27,25,0,0,0,107,IND,31,25,30,28,0,0,0,114,20080311
2008,TOR,25,27,25,31,0,0,0,108,LAL,22,36,25,34,0,0,0,117,20080311
2008,POR,26,24,27,26,0,0,0,103,MIN,26,28,25,17,0,0,0,96,20080311
2008,MEM,22,19,38,32,0,0,0,111,PHO,41,31,37,23,0,0,0,132,20080311
2008,MIL,22,22,33,20,0,0,0,97,WAS,26,31,22,26,0,0,0,105,20080311
2008,HOU,18,14,27,24,0,0,0,83,ATL,18,15,24,18,0,0,0,75,20080312
2008,SEA,24,20,16,22,0,0,0,82,BOS,34,30,28,19,0,0,0,111,20080312
2008,CHA,28,17,21,27,0,0,0,93,DAL,36,31,30,21,0,0,0,118,20080312
2008,MEM,22,14,22,28,0,0,0,86,DEN,23,23,38,24,0,0,0,108,20080312
2008,PHI,26,22,18,17,0,0,0,83,DET,18,24,25,15,0,0,0,82,20080312
2008,TOR,17,31,31,27,0,0,0,106,GSW,35,23,30,29,0,0,0,117,20080312
2008,NYK,24,20,28,19,0,0,0,91,MIA,24,21,20,23,0,0,0,88,20080312
2008,UTA,40,23,22,29,0,0,0,114,MIL,26,36,22,26,0,0,0,110,20080312
2008,CLE,23,24,20,32,0,0,0,99,NJN,38,20,22,24,0,0,0,104,20080312
2008,SAS,23,18,26,8,0,0,0,75,NOH,25,23,28,24,0,0,0,100,20080312
2008,LAC,19,29,28,12,0,0,0,88,ORL,32,31,27,20,0,0,0,110,20080312
2008,GSW,39,23,22,31,0,0,0,115,PHO,34,23,38,28,0,0,0,123,20080313
2008,POR,27,17,19,22,0,0,0,85,SAC,34,24,14,24,0,0,0,96,20080313
2008,CLE,24,30,25,20,0,0,0,99,WAS,27,19,34,21,0,0,0,101,20080313
2008,LAC,22,26,23,22,0,0,0,93,ATL,36,27,33,21,0,0,0,117,20080314
2008,UTA,33,29,17,31,0,0,0,110,BOS,23,26,25,18,0,0,0,92,20080314
2008,PHI,25,18,27,40,0,0,0,110,CHI,26,32,28,20,0,0,0,106,20080314
2008,IND,17,29,17,34,0,0,0,97,DAL,31,31,21,33,0,0,0,116,20080314
2008,TOR,23,34,21,27,0,0,0,105,DEN,44,35,29,29,0,0,0,137,20080314
2008,SAS,26,18,11,25,0,0,0,80,DET,20,23,22,19,0,0,0,84,20080314
2008,CHA,23,20,19,18,0,0,0,80,HOU,18,18,28,25,0,0,0,89,20080314
2008,ORL,25,25,27,26,0,0,0,103,MIA,25,26,23,20,0,0,0,94,20080314
2008,LAL,21,28,23,26,0,0,0,98,NOH,23,23,34,28,0,0,0,108,20080314
2008,MIN,32,25,40,24,0,0,0,121,SEA,30,30,28,28,0,0,0,116,20080314
2008,MEM,17,24,25,41,0,0,0,107,GSW,29,25,26,30,0,0,0,110,20080315
2008,BOS,25,28,22,24,0,0,0,99,MIL,19,16,17,25,0,0,0,77,20080315
2008,UTA,29,28,29,29,0,0,0,115,NJN,32,18,31,36,0,0,0,117,20080315
2008,IND,18,35,27,31,0,0,0,111,ORL,28,33,30,31,0,0,0,122,20080315
2008,SAS,23,22,28,23,0,0,0,96,PHI,28,25,30,20,0,0,0,103,20080315
2008,SAC,34,14,31,20,0,0,0,99,PHO,37,42,22,26,0,0,0,127,20080315
2008,MIN,29,24,21,22,0,0,0,96,POR,28,26,29,24,0,0,0,107,20080315
2008,LAC,25,30,23,22,9,0,0,109,WAS,25,30,20,25,19,0,0,119,20080315
2008,CHA,19,21,23,28,0,0,0,91,CLE,27,20,28,23,0,0,0,98,20080316
2008,SEA,29,29,27,31,0,0,0,116,DEN,48,36,43,41,0,0,0,168,20080316
2008,NOH,26,18,22,18,0,0,0,84,DET,21,34,22,28,0,0,0,105,20080316
2008,LAL,23,21,22,26,0,0,0,92,HOU,24,35,12,33,0,0,0,104,20080316
2008,DAL,35,17,32,14,0,0,0,98,MIA,12,18,23,20,0,0,0,73,20080316
2008,ATL,21,32,32,24,0,0,0,109,NYK,20,29,30,19,0,0,0,98,20080316
2008,TOR,23,26,24,27,0,0,0,100,SAC,32,21,23,30,0,0,0,106,20080316
2008,NYK,32,24,23,19,0,0,0,98,IND,38,22,21,29,0,0,0,110,20080317
2008,CHA,24,23,17,16,0,0,0,80,MEM,21,21,30,26,0,0,0,98,20080317
2008,LAC,23,21,22,24,0,0,0,90,MIN,23,24,21,31,0,0,0,99,20080317
2008,CHI,27,23,34,13,0,0,0,97,NOH,27,24,24,33,0,0,0,108,20080317
2008,CLE,23,22,27,18,0,0,0,90,ORL,20,20,33,31,0,0,0,104,20080317
2008,BOS,11,32,25,25,0,0,0,93,SAS,28,25,17,21,0,0,0,91,20080317
2008,TOR,16,22,27,14,0,0,0,79,UTA,16,31,18,31,0,0,0,96,20080317
2008,ATL,29,25,30,21,0,0,0,105,WAS,24,29,24,19,0,0,0,96,20080317
2008,NJN,26,8,34,28,0,0,0,96,CHI,29,29,21,33,0,0,0,112,20080318
2008,LAL,28,31,18,25,0,0,0,102,DAL,21,17,27,35,0,0,0,100,20080318
2008,DEN,25,26,38,31,0,0,0,120,DET,34,39,27,36,0,0,0,136,20080318
2008,BOS,21,19,32,22,0,0,0,94,HOU,22,18,16,18,0,0,0,74,20080318
2008,MIA,24,20,28,40,0,0,0,112,MIL,26,24,27,29,0,0,0,106,20080318
2008,PHO,28,29,30,24,0,0,0,111,POR,27,22,27,22,0,0,0,98,20080318
2008,GSW,31,26,25,23,0,0,0,105,SAC,29,32,40,21,0,0,0,122,20080318
2008,DET,25,13,19,16,0,0,0,73,CLE,22,23,18,26,0,0,0,89,20080319
2008,CHA,28,25,15,27,0,0,0,95,IND,25,21,29,27,0,0,0,102,20080319
2008,GSW,37,27,28,24,0,0,0,116,LAC,26,20,28,26,0,0,0,100,20080319
2008,MEM,28,24,16,26,0,0,0,94,MIN,23,15,24,36,0,0,0,98,20080319
2008,ATL,35,35,20,27,0,0,0,117,NJN,37,23,34,31,0,0,0,125,20080319
2008,HOU,24,20,15,10,0,0,0,69,NOH,16,23,20,31,0,0,0,90,20080319
2008,WAS,20,16,31,20,0,0,0,87,ORL,26,17,22,21,0,0,0,86,20080319
2008,DEN,31,27,35,20,0,0,0,113,PHI,34,31,27,23,0,0,0,115,20080319
2008,PHO,34,30,20,26,0,0,0,110,SEA,23,32,23,20,0,0,0,98,20080319
2008,MIA,16,10,19,9,0,0,0,54,TOR,29,29,20,18,0,0,0,96,20080319
2008,SAS,22,33,31,16,0,0,0,102,CHI,23,14,27,16,0,0,0,80,20080320
2008,BOS,24,22,20,28,0,0,0,94,DAL,29,19,22,20,0,0,0,90,20080320
2008,LAL,38,22,21,25,0,0,0,106,UTA,18,27,24,26,0,0,0,95,20080320
2008,TOR,25,17,25,16,0,0,0,83,CLE,24,21,18,27,0,0,0,90,20080321
2008,HOU,26,26,23,34,0,0,0,109,GSW,29,21,23,33,0,0,0,106,20080321
2008,MIN,27,22,33,31,0,0,0,113,IND,35,31,27,31,0,0,0,124,20080321
2008,SEA,21,33,22,29,0,0,0,105,LAL,34,28,31,37,0,0,0,130,20080321
2008,WAS,26,26,35,16,0,0,0,103,MIA,20,19,23,24,0,0,0,86,20080321
2008,DEN,33,34,26,32,0,0,0,125,NJN,25,30,35,24,0,0,0,114,20080321
2008,MEM,35,34,23,28,0,0,0,120,NYK,28,22,40,16,0,0,0,106,20080321
2008,PHI,19,16,25,35,0,0,0,95,ORL,33,25,30,25,0,0,0,113,20080321
2008,LAC,24,33,18,27,0,0,0,102,POR,32,25,30,20,0,0,0,107,20080321
2008,SAC,19,28,21,21,0,0,0,89,SAS,23,31,25,23,0,0,0,102,20080321
2008,ORL,17,28,22,23,0,0,0,90,ATL,27,17,19,35,0,0,0,98,20080322
2008,MIA,17,22,25,18,0,0,0,82,CHA,16,30,27,21,0,0,0,94,20080322
2008,IND,27,28,18,35,0,0,0,108,CHI,28,27,29,17,0,0,0,101,20080322
2008,POR,22,22,22,17,0,0,0,83,LAC,17,17,22,16,0,0,0,72,20080322
2008,SAC,29,27,31,24,0,0,0,111,MEM,40,27,27,23,0,0,0,117,20080322
2008,CLE,14,32,21,31,0,0,0,98,MIL,29,17,32,30,0,0,0,108,20080322
2008,NYK,24,32,21,16,0,0,0,93,MIN,42,27,25,20,0,0,0,114,20080322
2008,BOS,36,29,24,17,0,0,0,106,NOH,23,32,26,32,0,0,0,113,20080322
2008,NJN,19,23,33,12,0,0,0,87,PHI,23,26,19,23,0,0,0,91,20080322
2008,HOU,21,36,28,28,0,0,0,113,PHO,38,36,21,27,0,0,0,122,20080322
2008,SEA,34,27,20,20,0,0,0,101,UTA,23,29,33,30,0,0,0,115,20080322
2008,SAS,15,21,29,23,0,0,0,88,DAL,21,19,18,23,0,0,0,81,20080323
2008,GSW,34,38,15,28,0,0,0,115,LAL,30,19,32,30,0,0,0,111,20080323
2008,DEN,23,23,25,38,0,0,0,109,TOR,35,19,19,27,0,0,0,100,20080323
2008,DET,20,20,25,18,0,0,0,83,WAS,28,19,24,24,0,0,0,95,20080323
2008,PHI,22,26,18,29,0,0,0,95,BOS,28,24,19,19,0,0,0,90,20080324
2008,PHO,25,25,23,23,9,0,0,105,DET,26,25,25,20,14,0,0,110,20080324
2008,LAL,20,32,35,24,12,0,0,123,GSW,28,35,23,25,8,0,0,119,20080324
2008,SAC,24,25,23,28,0,0,0,100,HOU,26,27,24,31,0,0,0,108,20080324
2008,DEN,28,23,37,32,0,0,0,120,MEM,31,26,22,27,0,0,0,106,20080324
2008,MIL,25,12,13,23,0,0,0,73,MIA,17,15,22,24,0,0,0,78,20080324
2008,NJN,30,26,26,24,0,0,0,106,NYK,22,23,18,28,0,0,0,91,20080324
2008,POR,25,28,10,21,0,0,0,84,SEA,21,28,22,26,0,0,0,97,20080324
2008,ATL,30,23,14,27,0,0,0,94,CHI,26,25,28,24,0,0,0,103,20080325
2008,LAC,24,20,24,22,0,0,0,90,DAL,28,23,31,21,0,0,0,103,20080325
2008,NOH,29,30,27,28,0,0,0,114,IND,27,29,23,27,0,0,0,106,20080325
2008,SAS,28,30,22,27,0,0,0,107,ORL,29,27,17,24,0,0,0,97,20080325
2008,WAS,22,21,23,16,0,0,0,82,POR,31,28,23,20,0,0,0,102,20080325
2008,CHA,24,20,28,34,0,0,0,106,UTA,27,31,34,36,0,0,0,128,20080325
2008,MIL,37,23,22,14,0,0,0,96,ATL,32,33,29,21,0,0,0,115,20080326
2008,PHO,20,37,16,24,0,0,0,97,BOS,33,24,27,33,0,0,0,117,20080326
2008,NOH,25,31,17,27,0,0,0,100,CLE,23,27,21,28,0,0,0,99,20080326
2008,MIN,23,19,18,26,0,0,0,86,HOU,24,22,23,28,0,0,0,97,20080326
2008,CHA,27,30,25,26,0,0,0,108,LAL,24,20,24,27,0,0,0,95,20080326
2008,IND,29,31,28,29,0,0,0,117,NJN,42,26,30,26,0,0,0,124,20080326
2008,MIA,20,20,25,27,4,0,0,96,NYK,26,22,15,29,11,0,0,103,20080326
2008,CHI,19,30,28,22,0,0,0,99,PHI,34,31,26,30,0,0,0,121,20080326
2008,MEM,24,26,23,25,8,0,0,106,SAC,23,19,38,18,9,0,0,107,20080326
2008,LAC,18,26,27,17,0,0,0,88,SAS,27,21,26,23,0,0,0,97,20080326
2008,WAS,29,21,18,36,0,0,0,104,SEA,23,33,19,24,0,0,0,99,20080326
2008,DET,20,15,16,31,0,0,0,82,TOR,19,14,28,28,0,0,0,89,20080326
2008,DAL,39,31,16,19,0,0,0,105,DEN,28,32,34,24,0,0,0,118,20080327
2008,MIA,23,22,10,14,0,0,0,69,DET,18,25,23,19,0,0,0,85,20080327
2008,POR,30,22,20,23,0,0,0,95,GSW,22,29,40,20,0,0,0,111,20080327
2008,CHI,20,26,23,34,0,0,0,103,ATL,31,26,24,25,0,0,0,106,20080328
2008,NOH,24,36,15,17,0,0,0,92,BOS,30,26,32,24,0,0,0,112,20080328
2008,NJN,33,30,28,24,0,0,0,115,IND,33,23,36,31,0,0,0,123,20080328
2008,MEM,32,21,36,25,0,0,0,114,LAL,30,23,27,31,0,0,0,111,20080328
2008,ORL,34,26,27,16,0,0,0,103,MIL,23,20,20,23,0,0,0,86,20080328
2008,PHO,38,23,23,23,0,0,0,107,PHI,19,25,27,22,0,0,0,93,20080328
2008,WAS,27,20,35,32,0,0,0,114,SAC,31,27,21,29,0,0,0,108,20080328
2008,MIN,17,17,28,22,0,0,0,84,SAS,14,35,19,31,0,0,0,99,20080328
2008,CHA,38,17,17,24,0,0,0,96,SEA,27,26,23,17,0,0,0,93,20080328
2008,NYK,23,21,24,27,0,0,0,95,TOR,32,17,27,27,0,0,0,103,20080328
2008,LAC,24,19,28,30,0,0,0,101,UTA,31,25,34,31,0,0,0,121,20080328
2008,MIL,22,32,23,34,0,0,0,111,CHI,31,36,27,20,0,0,0,114,20080329
2008,GSW,32,29,25,26,0,0,0,112,DEN,38,27,23,31,0,0,0,119,20080329
2008,CLE,18,15,17,21,0,0,0,71,DET,29,20,23,13,0,0,0,85,20080329
2008,MEM,17,26,28,26,0,0,0,97,LAC,20,27,28,35,0,0,0,110,20080329
2008,PHO,21,31,30,28,0,0,0,110,NJN,31,20,20,33,0,0,0,104,20080329
2008,CHA,24,25,21,23,0,0,0,93,POR,30,18,23,14,0,0,0,85,20080329
2008,NYK,23,31,26,29,0,0,0,109,ATL,26,29,29,30,0,0,0,114,20080330
2008,MIA,13,17,18,14,0,0,0,62,BOS,32,18,18,20,0,0,0,88,20080330
2008,PHI,27,21,20,20,0,0,0,88,CLE,22,21,25,23,0,0,0,91,20080330
2008,DAL,26,25,25,28,0,0,0,104,GSW,27,32,25,30,0,0,0,114,20080330
2008,WAS,25,22,39,25,9,0,0,120,LAL,27,31,28,25,15,0,0,126,20080330
2008,UTA,23,21,30,29,0,0,0,103,MIN,20,23,33,34,0,0,0,110,20080330
2008,HOU,24,24,17,23,0,0,0,88,SAS,35,31,19,24,0,0,0,109,20080330
2008,SAC,34,28,32,26,0,0,0,120,SEA,39,26,18,24,0,0,0,107,20080330
2008,NOH,37,32,32,17,0,0,0,118,TOR,28,30,21,32,0,0,0,111,20080330
2008,TOR,39,19,21,25,0,0,0,104,CHA,32,31,10,27,0,0,0,100,20080331
2008,MIA,25,18,22,20,0,0,0,85,IND,27,24,27,27,0,0,0,105,20080331
2008,DAL,29,23,17,24,0,0,0,93,LAC,24,16,20,26,0,0,0,86,20080331
2008,ATL,40,33,30,13,0,0,0,116,MEM,19,27,26,27,0,0,0,99,20080331
2008,DEN,39,31,22,25,0,0,0,117,PHO,25,26,35,46,0,0,0,132,20080331
2008,WAS,22,19,25,21,0,0,0,87,UTA,31,42,32,24,0,0,0,129,20080331
2008,BOS,22,28,29,27,0,0,0,106,CHI,17,26,30,19,0,0,0,92,20080401
2008,PHO,28,37,30,25,0,0,0,120,DEN,36,34,31,25,0,0,0,126,20080401
2008,NYK,31,30,27,21,6,0,0,115,MIL,27,32,18,32,10,0,0,119,20080401
2008,DET,18,26,21,29,0,0,0,94,MIN,30,19,23,18,0,0,0,90,20080401
2008,PHI,35,22,21,30,0,0,0,108,NJN,32,25,16,26,0,0,0,99,20080401
2008,NOH,21,23,30,24,0,0,0,98,ORL,27,26,23,21,0,0,0,97,20080401
2008,HOU,29,17,30,22,0,0,0,98,SAC,28,21,28,22,0,0,0,99,20080401
2008,GSW,34,17,22,19,0,0,0,92,SAS,35,25,26,30,0,0,0,116,20080401
2008,TOR,27,32,32,16,13,0,0,120,ATL,31,24,25,27,20,0,0,127,20080402
2008,IND,17,13,22,25,0,0,0,77,BOS,29,20,19,24,0,0,0,92,20080402
2008,CLE,25,33,34,26,0,0,0,118,CHA,34,28,27,25,0,0,0,114,20080402
2008,GSW,25,25,19,17,0,0,0,86,DAL,29,31,29,22,0,0,0,111,20080402
2008,POR,31,19,13,28,0,0,0,91,LAL,26,24,23,31,0,0,0,104,20080402
2008,NYK,23,37,29,25,0,0,0,114,MEM,34,40,27,29,0,0,0,130,20080402
2008,NOH,26,28,20,32,0,0,0,106,MIA,14,27,25,11,0,0,0,77,20080402
2008,LAC,27,21,21,33,0,0,0,102,SEA,22,28,20,14,0,0,0,84,20080402
2008,MIN,27,23,22,28,0,0,0,100,UTA,29,24,38,26,0,0,0,117,20080402
2008,MIL,30,24,24,32,0,0,0,110,WAS,33,28,25,23,0,0,0,109,20080402
2008,CHI,26,19,32,24,0,0,0,101,CLE,26,29,30,13,0,0,0,98,20080403
2008,HOU,23,29,22,21,0,0,0,95,POR,22,21,20,23,0,0,0,86,20080403
2008,LAC,25,18,27,28,0,0,0,98,SAC,20,30,34,26,0,0,0,110,20080403
2008,PHI,28,23,26,32,0,0,0,109,ATL,19,27,28,30,0,0,0,104,20080404
2008,NJN,20,21,19,27,0,0,0,87,DET,25,30,26,25,0,0,0,106,20080404
2008,DAL,31,33,23,21,0,0,0,108,LAL,31,23,26,32,0,0,0,112,20080404
2008,GSW,33,27,30,27,0,0,0,117,MEM,25,21,20,20,0,0,0,86,20080404
2008,IND,30,23,24,28,0,0,0,105,MIL,22,24,23,32,0,0,0,101,20080404
2008,NYK,29,27,31,23,0,0,0,110,NOH,29,31,27,31,0,0,0,118,20080404
2008,MIN,15,26,23,24,0,0,0,88,PHO,36,26,24,31,0,0,0,117,20080404
2008,HOU,22,18,29,10,0,0,0,79,SEA,17,24,13,12,0,0,0,66,20080404
2008,CHA,27,24,23,31,0,0,0,105,TOR,22,24,30,24,0,0,0,100,20080404
2008,SAS,24,14,17,9,0,0,0,64,UTA,18,22,24,26,0,0,0,90,20080404
2008,MIA,23,21,28,23,0,0,0,95,WAS,29,31,28,21,0,0,0,109,20080404
2008,BOS,37,27,18,19,0,0,0,101,CHA,25,25,19,9,0,0,0,78,20080405
2008,WAS,25,17,34,23,0,0,0,99,CHI,22,21,21,23,0,0,0,87,20080405
2008,ORL,30,17,22,32,0,0,0,101,CLE,26,29,17,14,0,0,0,86,20080405
2008,SAC,25,34,29,30,0,0,0,118,DEN,34,22,23,36,0,0,0,115,20080405
2008,TOR,26,22,26,16,0,0,0,90,NJN,33,23,20,23,0,0,0,99,20080405
2008,ATL,24,31,15,22,0,0,0,92,PHI,15,29,13,28,0,0,0,85,20080405
2008,MIL,25,27,25,20,0,0,0,97,IND,26,23,18,38,0,0,0,105,20080406
2008,HOU,30,32,18,25,0,0,0,105,LAC,22,20,25,12,0,0,0,79,20080406
2008,DET,19,20,29,23,0,0,0,91,MIA,16,11,27,21,0,0,0,75,20080406
2008,MEM,27,27,27,32,0,0,0,113,MIN,19,36,26,20,0,0,0,101,20080406
2008,GSW,31,20,27,18,0,0,0,96,NOH,22,37,29,20,0,0,0,108,20080406
2008,ORL,12,28,21,29,0,0,0,90,NYK,26,15,24,35,0,0,0,100,20080406
2008,DAL,26,26,26,27,0,0,0,105,PHO,28,29,32,9,0,0,0,98,20080406
2008,SAS,17,22,22,11,0,0,0,72,POR,13,21,18,13,0,0,0,65,20080406
2008,LAL,23,28,36,27,0,0,0,114,SAC,27,18,24,23,0,0,0,92,20080406
2008,DEN,36,28,31,31,9,12,0,147,SEA,31,39,29,27,9,16,0,151,20080406
2008,MIN,17,30,38,34,0,0,0,119,CHA,32,27,35,27,0,0,0,121,20080408
2008,SEA,21,23,19,20,0,0,0,83,DAL,23,23,24,29,0,0,0,99,20080408
2008,NYK,28,29,22,19,0,0,0,98,DET,16,18,26,34,0,0,0,94,20080408
2008,SAC,32,34,30,36,0,0,0,132,GSW,39,38,26,37,0,0,0,140,20080408
2008,ATL,27,25,20,26,0,0,0,98,IND,38,29,26,19,0,0,0,112,20080408
2008,DEN,23,40,28,26,0,0,0,117,LAC,23,24,27,25,0,0,0,99,20080408
2008,PHO,30,24,35,38,0,0,0,127,MEM,33,15,27,38,0,0,0,113,20080408
2008,CHI,21,28,18,21,0,0,0,88,MIA,18,25,26,26,0,0,0,95,20080408
2008,BOS,32,28,20,19,8,0,0,107,MIL,29,16,21,33,5,0,0,104,20080408
2008,UTA,27,16,25,9,0,0,0,77,NOH,24,11,15,16,0,0,0,66,20080408
2008,LAL,24,23,26,30,0,0,0,103,POR,28,30,31,23,0,0,0,112,20080408
2008,NJN,22,31,21,9,0,0,0,83,CLE,20,29,27,28,0,0,0,104,20080409
2008,SEA,26,11,22,21,0,0,0,80,HOU,21,25,29,28,0,0,0,103,20080409
2008,NOH,28,20,41,33,0,0,0,122,MIN,30,16,27,17,0,0,0,90,20080409
2008,CHA,26,24,33,24,0,0,0,107,NYK,27,37,22,23,0,0,0,109,20080409
2008,CHI,26,23,21,13,0,0,0,83,ORL,26,36,19,34,0,0,0,115,20080409
2008,DET,25,27,21,21,0,0,0,94,PHI,29,29,23,20,0,0,0,101,20080409
2008,PHO,16,29,27,24,0,0,0,96,SAS,24,21,23,11,0,0,0,79,20080409
2008,MIL,18,30,20,25,0,0,0,93,TOR,23,27,33,28,0,0,0,111,20080409
2008,BOS,25,28,18,24,0,0,0,95,WAS,30,25,27,27,0,0,0,109,20080409
2008,UTA,15,25,26,28,0,0,0,94,DAL,24,23,20,30,0,0,0,97,20080410
2008,DEN,22,39,28,25,0,0,0,114,GSW,37,23,22,23,0,0,0,105,20080410
2008,LAL,27,24,22,33,0,0,0,106,LAC,25,17,19,17,0,0,0,78,20080410
2008,MIL,21,18,19,28,0,0,0,86,BOS,31,26,22,23,0,0,0,102,20080411
2008,CLE,33,14,18,30,0,0,0,95,CHI,25,28,29,18,0,0,0,100,20080411
2008,WAS,19,23,13,19,0,0,0,74,DET,23,24,34,21,0,0,0,102,20080411
2008,PHO,28,19,19,24,0,0,0,90,HOU,29,30,23,19,0,0,0,101,20080411
2008,NOH,20,25,30,29,0,0,0,104,LAL,39,26,17,25,0,0,0,107,20080411
2008,MEM,31,27,16,22,0,0,0,96,MIA,23,20,26,22,0,0,0,91,20080411
2008,ATL,34,28,23,31,0,0,0,116,NYK,23,20,28,33,0,0,0,104,20080411
2008,MIN,31,23,20,28,0,0,0,102,ORL,37,26,18,20,0,0,0,101,20080411
2008,IND,17,26,24,18,0,0,0,85,PHI,18,19,24,15,0,0,0,76,20080411
2008,POR,18,23,21,24,0,0,0,86,SAC,29,22,27,25,0,0,0,103,20080411
2008,SEA,20,17,20,17,0,0,0,74,SAS,13,32,27,23,0,0,0,95,20080411
2008,NJN,30,18,19,18,0,0,0,85,TOR,18,28,37,30,0,0,0,113,20080411
2008,BOS,30,25,19,25,0,0,0,99,ATL,22,22,30,15,0,0,0,89,20080412
2008,LAC,26,35,23,32,0,0,0,116,GSW,42,26,25,29,0,0,0,122,20080412
2008,CHA,32,25,27,23,0,0,0,107,IND,33,19,22,29,0,0,0,103,20080412
2008,MIN,43,19,27,25,0,0,0,114,MEM,25,30,22,28,0,0,0,105,20080412
2008,NJN,26,28,30,27,0,0,0,111,MIL,27,26,19,26,0,0,0,98,20080412
2008,DAL,21,29,30,25,0,0,0,105,POR,37,27,23,21,0,0,0,108,20080412
2008,NOH,27,22,24,18,0,0,0,91,SAC,26,26,16,26,0,0,0,94,20080412
2008,DEN,25,34,20,18,0,0,0,97,UTA,40,22,28,34,0,0,0,124,20080412
2008,PHI,30,23,31,9,0,0,0,93,WAS,23,34,21,31,0,0,0,109,20080412
2008,ORL,36,17,29,22,0,0,0,104,CHI,24,24,26,10,0,0,0,84,20080413
2008,MIA,21,17,21,17,0,0,0,76,CLE,19,21,17,27,0,0,0,84,20080413
2008,HOU,18,26,23,27,0,0,0,94,DEN,24,37,27,23,0,0,0,111,20080413
2008,TOR,21,24,18,21,0,0,0,84,DET,26,24,15,26,0,0,0,91,20080413
2008,SAS,23,30,14,18,0,0,0,85,LAL,25,28,26,27,0,0,0,106,20080413
2008,DAL,25,26,27,17,0,0,0,95,SEA,19,31,31,18,0,0,0,99,20080413
2008,CHI,39,42,39,31,0,0,0,151,MIL,45,26,30,34,0,0,0,135,20080414
2008,BOS,21,28,24,26,0,0,0,99,NYK,20,34,21,18,0,0,0,93,20080414
2008,CLE,19,28,20,24,0,0,0,91,PHI,22,19,18,31,0,0,0,90,20080414
2008,GSW,27,30,38,21,0,0,0,116,PHO,31,40,19,32,0,0,0,122,20080414
2008,SAS,36,20,27,18,0,0,0,101,SAC,26,25,25,22,0,0,0,98,20080414
2008,MIA,28,19,17,11,0,0,0,75,TOR,25,18,27,21,0,0,0,91,20080414
2008,HOU,22,19,26,29,0,0,0,96,UTA,21,35,28,21,0,0,0,105,20080414
2008,IND,28,26,27,29,0,0,0,110,WAS,35,31,32,19,0,0,0,117,20080414
2008,ORL,28,23,36,34,0,0,0,121,ATL,20,35,23,27,0,0,0,105,20080415
2008,MIN,23,20,29,31,0,0,0,103,DET,24,28,34,29,0,0,0,115,20080415
2008,SAC,27,21,24,29,0,0,0,101,LAL,34,28,39,23,0,0,0,124,20080415
2008,CHA,33,28,14,19,14,0,0,108,NJN,18,26,22,28,18,0,0,112,20080415
2008,LAC,26,25,17,24,0,0,0,92,NOH,26,23,34,31,0,0,0,114,20080415
2008,MEM,27,21,21,22,0,0,0,91,POR,24,31,28,30,0,0,0,113,20080415
2008,NJN,20,27,24,23,0,0,0,94,BOS,25,28,22,30,0,0,0,105,20080416
2008,PHI,25,26,29,29,0,0,0,109,CHA,21,40,26,28,0,0,0,115,20080416
2008,TOR,33,21,21,22,0,0,0,97,CHI,27,24,25,31,0,0,0,107,20080416
2008,DET,13,19,24,28,0,0,0,84,CLE,21,18,20,15,0,0,0,74,20080416
2008,NOH,27,23,28,20,0,0,0,98,DAL,25,23,35,28,0,0,0,111,20080416
2008,MEM,30,24,30,27,0,0,0,111,DEN,34,33,32,21,0,0,0,120,20080416
2008,SEA,35,33,27,31,0,0,0,126,GSW,24,36,20,41,0,0,0,121,20080416
2008,LAC,17,25,18,15,0,0,0,75,HOU,35,23,20,15,0,0,0,93,20080416
2008,NYK,29,31,36,27,0,0,0,123,IND,29,37,37,29,0,0,0,132,20080416
2008,ATL,30,31,22,16,0,0,0,99,MIA,24,31,34,24,0,0,0,113,20080416
2008,MIL,24,29,21,20,7,0,0,101,MIN,32,13,22,27,16,0,0,110,20080416
2008,WAS,19,22,19,23,0,0,0,83,ORL,24,23,23,33,0,0,0,103,20080416
2008,POR,25,24,19,23,0,0,0,91,PHO,30,28,21,21,0,0,0,100,20080416
2008,UTA,21,18,21,20,0,0,0,80,SAS,30,35,20,24,0,0,0,109,20080416
2008,WAS,24,22,23,17,0,0,0,86,CLE,19,27,19,28,0,0,0,93,20080419
2008,UTA,23,24,21,25,0,0,0,93,HOU,18,23,19,22,0,0,0,82,20080419
2008,DAL,26,26,20,20,0,0,0,92,NOH,19,21,36,28,0,0,0,104,20080419
2008,PHO,24,24,23,22,11,11,0,115,SAS,20,20,25,28,11,13,0,117,20080419
2008,ATL,21,19,15,26,0,0,0,81,BOS,29,20,24,31,0,0,0,104,20080420
2008,PHI,22,16,25,27,0,0,0,90,DET,27,24,19,16,0,0,0,86,20080420
2008,DEN,22,34,22,36,0,0,0,114,LAL,26,32,39,31,0,0,0,128,20080420
2008,TOR,23,24,28,25,0,0,0,100,ORL,43,17,25,29,0,0,0,114,20080420
2008,WAS,22,18,23,23,0,0,0,86,CLE,27,26,33,30,0,0,0,116,20080421
2008,UTA,26,21,22,21,0,0,0,90,HOU,17,24,26,17,0,0,0,84,20080421
2008,DAL,29,22,28,24,0,0,0,103,NOH,39,28,32,28,0,0,0,127,20080422
2008,TOR,18,39,21,25,0,0,0,103,ORL,35,24,24,21,0,0,0,104,20080422
2008,PHO,35,26,11,24,0,0,0,96,SAS,26,28,27,21,0,0,0,102,20080422
2008,ATL,20,22,16,19,0,0,0,77,BOS,24,28,24,20,0,0,0,96,20080423
2008,PHI,18,18,26,26,0,0,0,88,DET,25,28,31,21,0,0,0,105,20080423
2008,DEN,32,17,30,28,0,0,0,107,LAL,33,26,30,33,0,0,0,122,20080423
2008,ORL,20,20,29,25,0,0,0,94,TOR,28,33,19,28,0,0,0,108,20080424
2008,HOU,27,17,26,24,0,0,0,94,UTA,23,21,32,16,0,0,0,92,20080424
2008,CLE,17,16,18,21,0,0,0,72,WAS,21,28,28,31,0,0,0,108,20080424
2008,NOH,16,24,23,24,0,0,0,87,DAL,23,24,27,23,0,0,0,97,20080425
2008,DET,20,20,15,20,0,0,0,75,PHI,20,24,26,25,0,0,0,95,20080425
2008,SAS,33,28,30,24,0,0,0,115,PHO,19,28,25,27,0,0,0,99,20080425
2008,BOS,26,30,18,19,0,0,0,93,ATL,32,24,28,18,0,0,0,102,20080426
2008,LAL,23,30,30,19,0,0,0,102,DEN,20,26,18,20,0,0,0,84,20080426
2008,ORL,31,17,25,33,0,0,0,106,TOR,26,27,21,20,0,0,0,94,20080426
2008,HOU,23,15,23,21,0,0,0,82,UTA,21,25,20,20,0,0,0,86,20080426
2008,NOH,23,25,28,21,0,0,0,97,DAL,30,14,22,18,0,0,0,84,20080427
2008,DET,19,17,34,23,0,0,0,93,PHI,25,21,16,22,0,0,0,84,20080427
2008,SAS,13,30,22,21,0,0,0,86,PHO,34,31,28,12,0,0,0,105,20080427
2008,CLE,24,30,26,20,0,0,0,100,WAS,28,16,29,24,0,0,0,97,20080427
2008,BOS,24,24,27,17,0,0,0,92,ATL,29,22,14,32,0,0,0,97,20080428
2008,LAL,32,32,15,28,0,0,0,107,DEN,23,31,23,24,0,0,0,101,20080428
2008,TOR,26,24,18,24,0,0,0,92,ORL,22,27,25,28,0,0,0,102,20080428
2008,PHI,21,21,17,22,0,0,0,81,DET,35,19,25,19,0,0,0,98,20080429
2008,UTA,16,16,23,14,0,0,0,69,HOU,18,25,31,21,0,0,0,95,20080429
2008,DAL,22,17,24,31,0,0,0,94,NOH,28,26,17,28,0,0,0,99,20080429
2008,PHO,26,19,27,15,0,0,0,87,SAS,30,24,15,23,0,0,0,92,20080429
2008,ATL,19,24,21,21,0,0,0,85,BOS,27,31,23,29,0,0,0,110,20080430
2008,WAS,23,22,24,19,0,0,0,88,CLE,16,27,22,22,0,0,0,87,20080430
2008,DET,30,21,28,21,0,0,0,100,PHI,12,21,18,26,0,0,0,77,20080501
2008,BOS,32,18,32,18,0,0,0,100,ATL,20,29,30,24,0,0,0,103,20080502
2008,HOU,22,32,11,26,0,0,0,91,UTA,32,26,27,28,0,0,0,113,20080502
2008,CLE,27,29,23,26,0,0,0,105,WAS,31,17,16,24,0,0,0,88,20080502
2008,ORL,22,20,16,14,0,0,0,72,DET,22,21,22,26,0,0,0,91,20080503
2008,SAS,27,22,17,16,0,0,0,82,NOH,23,22,29,27,0,0,0,101,20080503
2008,ATL,16,10,17,22,0,0,0,65,BOS,27,17,35,20,0,0,0,99,20080504
2008,UTA,24,17,31,26,0,0,0,98,LAL,25,29,25,30,0,0,0,109,20080504
2008,ORL,29,11,36,17,0,0,0,93,DET,29,21,28,22,0,0,0,100,20080505
2008,SAS,23,20,18,23,0,0,0,84,NOH,22,20,36,24,0,0,0,102,20080505
2008,CLE,15,22,15,20,0,0,0,72,BOS,25,16,12,23,0,0,0,76,20080506
2008,UTA,18,31,34,27,0,0,0,110,LAL,33,30,30,27,0,0,0,120,20080507
2008,DET,16,26,27,17,0,0,0,86,ORL,30,24,19,38,0,0,0,111,20080507
2008,CLE,24,12,15,22,0,0,0,73,BOS,17,27,26,19,0,0,0,89,20080508
2008,NOH,23,33,22,21,0,0,0,99,SAS,21,33,29,27,0,0,0,110,20080508
2008,LAL,23,20,29,27,0,0,0,99,UTA,23,29,27,25,0,0,0,104,20080509
2008,BOS,13,22,28,21,0,0,0,84,CLE,32,20,27,29,0,0,0,108,20080510
2008,DET,21,23,26,20,0,0,0,90,ORL,27,28,15,19,0,0,0,89,20080510
2008,NOH,22,20,19,19,0,0,0,80,SAS,24,31,30,15,0,0,0,100,20080511
2008,LAL,21,34,20,33,7,0,0,115,UTA,31,24,24,29,15,0,0,123,20080511
2008,BOS,21,22,22,12,0,0,0,77,CLE,23,22,23,20,0,0,0,88,20080512
2008,ORL,20,21,27,18,0,0,0,86,DET,20,27,18,26,0,0,0,91,20080513
2008,SAS,23,24,11,21,0,0,0,79,NOH,21,23,28,29,0,0,0,101,20080513
2008,CLE,23,23,17,26,0,0,0,89,BOS,18,25,29,24,0,0,0,96,20080514
2008,UTA,26,28,27,23,0,0,0,104,LAL,29,32,20,30,0,0,0,111,20080514
2008,NOH,24,27,12,17,0,0,0,80,SAS,36,22,20,21,0,0,0,99,20080515
2008,BOS,18,15,17,19,0,0,0,69,CLE,18,24,17,15,0,0,0,74,20080516
2008,LAL,33,29,24,22,0,0,0,108,UTA,20,23,27,35,0,0,0,105,20080516
2008,CLE,13,27,28,24,0,0,0,92,BOS,18,32,23,24,0,0,0,97,20080518
2008,SAS,23,28,20,20,0,0,0,91,NOH,20,22,14,26,0,0,0,82,20080519
2008,DET,17,23,17,22,0,0,0,79,BOS,22,19,28,19,0,0,0,88,20080520
2008,SAS,27,24,21,13,0,0,0,85,LAL,24,19,22,24,0,0,0,89,20080521
2008,DET,18,32,28,25,0,0,0,103,BOS,20,23,26,28,0,0,0,97,20080522
2008,SAS,16,21,20,14,0,0,0,71,LAL,21,25,28,27,0,0,0,101,20080523
2008,BOS,25,25,23,21,0,0,0,94,DET,17,15,23,25,0,0,0,80,20080524
2008,LAL,24,15,18,27,0,0,0,84,SAS,21,28,20,34,0,0,0,103,20080525
2008,BOS,17,22,19,17,0,0,0,75,DET,22,21,22,29,0,0,0,94,20080526
2008,LAL,28,25,24,16,0,0,0,93,SAS,23,24,23,21,0,0,0,91,20080527
2008,DET,23,23,25,31,0,0,0,102,BOS,23,29,32,22,0,0,0,106,20080528
2008,SAS,28,20,15,29,0,0,0,92,LAL,15,27,22,36,0,0,0,100,20080529
2008,BOS,24,16,20,29,0,0,0,89,DET,21,16,31,13,0,0,0,81,20080530
2008,LAL,21,30,22,15,0,0,0,88,BOS,23,23,31,21,0,0,0,98,20080605
2008,LAL,22,20,19,41,0,0,0,102,BOS,20,34,29,25,0,0,0,108,20080608
2008,BOS,20,17,25,19,0,0,0,81,LAL,20,23,17,27,0,0,0,87,20080610
2008,BOS,14,26,31,26,0,0,0,97,LAL,35,23,15,18,0,0,0,91,20080612
2008,BOS,22,30,18,28,0,0,0,98,LAL,39,16,24,24,0,0,0,103,20080615
2008,LAL,20,15,25,32,0,0,0,92,BOS,24,34,31,42,0,0,0,131,20080617
2009,CLE,28,22,13,22,0,0,0,85,BOS,22,21,24,23,0,0,0,90,20081028
2009,MIL,26,26,23,20,0,0,0,95,CHI,26,29,27,26,0,0,0,108,20081028
2009,POR,14,20,19,23,0,0,0,76,LAL,24,25,23,24,0,0,0,96,20081028
2009,IND,17,23,24,30,0,0,0,94,DET,23,27,25,25,0,0,0,100,20081029
2009,NOH,27,29,29,23,0,0,0,108,GSW,34,23,27,19,0,0,0,103,20081029
2009,MEM,18,19,20,14,0,0,0,71,HOU,26,17,15,24,0,0,0,82,20081029
2009,LAL,30,29,26,32,0,0,0,117,LAC,27,17,13,22,0,0,0,79,20081029
2009,SAC,32,17,28,19,0,0,0,96,MIN,33,23,20,22,0,0,0,98,20081029
2009,MIA,27,18,30,40,0,0,0,115,NYK,28,32,31,29,0,0,0,120,20081029
2009,MIL,24,26,29,19,0,0,0,98,OKC,14,21,24,28,0,0,0,87,20081029
2009,ATL,26,21,27,25,0,0,0,99,ORL,13,27,15,30,0,0,0,85,20081029
2009,TOR,18,33,23,21,0,0,0,95,PHI,21,24,20,19,0,0,0,84,20081029
2009,PHO,19,30,25,29,0,0,0,103,SAS,16,30,27,25,0,0,0,98,20081029
2009,DEN,27,19,21,27,0,0,0,94,UTA,28,22,25,23,0,0,0,98,20081029
2009,NJN,23,21,25,26,0,0,0,95,WAS,23,23,21,18,0,0,0,85,20081029
2009,CHA,16,17,26,20,0,0,0,79,CLE,25,25,18,28,0,0,0,96,20081030
2009,HOU,32,30,23,27,0,0,0,112,DAL,33,26,27,16,0,0,0,102,20081030
2009,NOH,30,26,25,27,0,0,0,108,PHO,23,21,25,26,0,0,0,95,20081030
2009,CHI,13,18,23,26,0,0,0,80,BOS,24,25,21,26,0,0,0,96,20081031
2009,DEN,20,17,31,26,19,0,0,113,LAC,28,27,21,18,9,0,0,103,20081031
2009,ORL,25,30,13,16,0,0,0,84,MEM,26,17,18,25,0,0,0,86,20081031
2009,SAC,14,17,16,30,0,0,0,77,MIA,22,27,29,25,0,0,0,103,20081031
2009,NYK,24,24,24,15,0,0,0,87,PHI,31,29,31,25,0,0,0,116,20081031
2009,SAS,22,23,25,29,0,0,0,99,POR,21,30,27,22,0,0,0,100,20081031
2009,GSW,22,28,23,23,12,0,0,108,TOR,28,23,24,21,16,0,0,112,20081031
2009,PHI,34,23,18,13,0,0,0,88,ATL,18,26,22,29,0,0,0,95,20081101
2009,MIA,18,23,27,19,0,0,0,87,CHA,24,28,25,23,0,0,0,100,20081101
2009,MEM,19,31,20,16,0,0,0,86,CHI,19,23,33,21,0,0,0,96,20081101
2009,LAL,23,23,30,28,0,0,0,104,DEN,21,31,24,21,0,0,0,97,20081101
2009,WAS,21,31,24,33,0,0,0,109,DET,31,20,30,36,0,0,0,117,20081101
2009,OKC,17,24,18,18,0,0,0,77,HOU,20,22,23,24,0,0,0,89,20081101
2009,BOS,17,24,17,21,0,0,0,79,IND,27,21,21,26,0,0,0,95,20081101
2009,TOR,24,17,29,21,0,0,0,91,MIL,22,17,21,27,0,0,0,87,20081101
2009,DAL,31,22,14,28,0,0,0,95,MIN,20,29,15,21,0,0,0,85,20081101
2009,GSW,24,28,33,20,0,0,0,105,NJN,25,26,18,28,0,0,0,97,20081101
2009,CLE,27,21,24,20,0,0,0,92,NOH,19,30,24,31,0,0,0,104,20081101
2009,SAC,28,21,27,27,0,0,0,103,ORL,32,27,29,33,0,0,0,121,20081101
2009,POR,23,27,22,24,0,0,0,96,PHO,29,20,31,27,0,0,0,107,20081101
2009,LAC,25,23,12,19,0,0,0,79,UTA,24,24,27,26,0,0,0,101,20081101
2009,MIL,27,22,26,19,0,0,0,94,NYK,23,22,16,25,0,0,0,86,20081102
2009,MIN,20,27,26,12,0,0,0,85,OKC,20,26,24,18,0,0,0,88,20081102
2009,DET,23,22,31,25,0,0,0,101,CHA,14,29,20,20,0,0,0,83,20081103
2009,CLE,28,23,21,28,0,0,0,100,DAL,16,26,24,15,0,0,0,81,20081103
2009,UTA,16,20,29,24,0,0,0,89,LAC,20,15,25,13,0,0,0,73,20081103
2009,GSW,24,21,22,12,0,0,0,79,MEM,29,20,24,17,0,0,0,90,20081103
2009,CHI,21,26,21,25,0,0,0,93,ORL,31,19,26,20,0,0,0,96,20081103
2009,SAC,23,25,17,26,0,0,0,91,PHI,35,33,25,32,0,0,0,125,20081103
2009,BOS,28,30,23,22,0,0,0,103,HOU,22,31,25,21,0,0,0,99,20081104
2009,PHO,32,33,27,22,0,0,0,114,NJN,27,28,22,9,0,0,0,86,20081104
2009,DAL,23,31,22,22,0,0,0,98,SAS,16,20,22,23,0,0,0,81,20081104
2009,CHI,24,21,26,22,0,0,0,93,CLE,30,27,26,24,0,0,0,107,20081105
2009,DEN,35,24,21,21,0,0,0,101,GSW,28,30,26,27,0,0,0,111,20081105
2009,PHO,27,32,31,23,0,0,0,113,IND,38,28,18,19,0,0,0,103,20081105
2009,LAC,29,22,17,20,0,0,0,88,LAL,27,20,25,34,0,0,0,106,20081105
2009,PHI,17,21,25,20,0,0,0,83,MIA,24,35,16,31,0,0,0,106,20081105
2009,WAS,17,28,33,20,6,0,0,104,MIL,30,9,27,32,14,0,0,112,20081105
2009,SAS,18,27,29,32,10,13,0,129,MIN,18,31,22,35,10,9,0,125,20081105
2009,ATL,24,22,12,29,0,0,0,87,NOH,16,24,22,17,0,0,0,79,20081105
2009,CHA,20,31,25,22,0,0,0,98,NYK,19,32,30,20,0,0,0,101,20081105
2009,BOS,21,30,19,26,0,0,0,96,OKC,29,15,11,28,0,0,0,83,20081105
2009,MEM,17,24,27,27,0,0,0,95,SAC,24,24,33,19,0,0,0,100,20081105
2009,DET,20,34,22,24,0,0,0,100,TOR,23,23,25,22,0,0,0,93,20081105
2009,POR,23,29,26,18,0,0,0,96,UTA,23,22,29,29,0,0,0,103,20081105
2009,PHI,16,27,23,22,0,0,0,88,ORL,30,24,21,23,0,0,0,98,20081106
2009,HOU,18,33,20,19,9,0,0,99,POR,21,31,22,16,11,0,0,101,20081106
2009,TOR,26,24,19,23,0,0,0,92,ATL,31,31,21,27,0,0,0,110,20081107
2009,MIL,30,17,23,19,0,0,0,89,BOS,23,32,20,26,0,0,0,101,20081107
2009,NOH,28,7,26,28,0,0,0,89,CHA,26,21,19,26,0,0,0,92,20081107
2009,PHO,17,17,25,24,0,0,0,83,CHI,20,28,31,21,0,0,0,100,20081107
2009,IND,29,19,26,33,0,0,0,107,CLE,20,23,28,40,0,0,0,111,20081107
2009,DAL,25,24,23,33,0,0,0,105,DEN,26,22,31,29,0,0,0,108,20081107
2009,MEM,28,20,33,28,0,0,0,109,GSW,30,20,24,30,0,0,0,104,20081107
2009,HOU,25,24,22,21,0,0,0,92,LAC,18,23,25,17,0,0,0,83,20081107
2009,DET,27,17,26,26,0,0,0,96,NJN,14,25,33,31,0,0,0,103,20081107
2009,MIN,27,28,24,30,0,0,0,109,SAC,36,26,30,29,0,0,0,121,20081107
2009,MIA,26,24,25,24,0,0,0,99,SAS,12,20,24,27,0,0,0,83,20081107
2009,OKC,15,14,34,34,0,0,0,97,UTA,29,29,20,26,0,0,0,104,20081107
2009,NYK,29,35,25,25,0,0,0,114,WAS,28,30,30,20,0,0,0,108,20081107
2009,CLE,32,22,20,32,0,0,0,106,CHI,27,30,20,20,0,0,0,97,20081108
2009,NJN,27,24,15,14,0,0,0,80,IND,32,17,25,24,0,0,0,98,20081108
2009,PHO,29,23,24,28,0,0,0,104,MIL,19,23,25,29,0,0,0,96,20081108
2009,MIA,23,13,30,23,0,0,0,89,NOH,24,23,27,26,0,0,0,100,20081108
2009,WAS,21,18,19,23,0,0,0,81,ORL,27,31,26,22,0,0,0,106,20081108
2009,MIN,24,25,21,23,0,0,0,93,POR,18,25,26,28,0,0,0,97,20081108
2009,TOR,20,20,23,26,0,0,0,89,CHA,19,26,22,12,0,0,0,79,20081109
2009,MEM,34,20,15,21,0,0,0,90,DEN,28,25,20,27,0,0,0,100,20081109
2009,BOS,17,30,22,19,0,0,0,88,DET,19,10,20,27,0,0,0,76,20081109
2009,DAL,24,21,24,23,0,0,0,92,LAC,25,22,26,30,0,0,0,103,20081109
2009,HOU,28,20,17,17,0,0,0,82,LAL,16,34,22,39,0,0,0,111,20081109
2009,UTA,29,25,15,30,0,0,0,99,NYK,26,23,27,31,0,0,0,107,20081109
2009,ATL,22,16,20,31,0,0,0,89,OKC,14,27,21,23,0,0,0,85,20081109
2009,GSW,33,24,17,24,0,0,0,98,SAC,36,27,27,25,0,0,0,115,20081109
2009,TOR,23,25,17,22,0,0,0,87,BOS,18,18,23,35,0,0,0,94,20081110
2009,OKC,34,17,27,21,0,0,0,99,IND,24,24,30,29,0,0,0,107,20081110
2009,NJN,20,20,28,26,0,0,0,94,MIA,18,22,21,38,0,0,0,99,20081110
2009,POR,36,19,17,34,0,0,0,106,ORL,28,26,19,26,0,0,0,99,20081110
2009,MEM,19,25,26,32,0,0,0,102,PHO,19,25,38,25,0,0,0,107,20081110
2009,DEN,18,24,29,17,0,0,0,88,CHA,24,22,16,18,0,0,0,80,20081111
2009,ATL,26,29,29,29,0,0,0,113,CHI,22,30,22,34,0,0,0,108,20081111
2009,MIL,18,24,29,22,0,0,0,93,CLE,23,25,26,25,0,0,0,99,20081111
2009,LAL,26,28,22,30,0,0,0,106,DAL,35,25,19,20,0,0,0,99,20081111
2009,MIN,27,23,37,19,4,0,0,110,GSW,27,31,25,23,7,0,0,113,20081111
2009,UTA,26,23,14,30,0,0,0,93,PHI,20,17,30,13,0,0,0,80,20081111
2009,DET,18,32,25,25,0,0,0,100,SAC,31,19,27,15,0,0,0,92,20081111
2009,NYK,20,21,23,16,0,0,0,80,SAS,20,18,29,25,0,0,0,92,20081111
2009,ATL,31,20,26,25,0,0,0,102,BOS,24,27,25,27,0,0,0,103,20081112
2009,SAC,27,23,31,22,0,0,0,103,LAC,20,25,24,29,0,0,0,98,20081112
2009,NYK,23,37,35,37,0,0,0,132,MEM,24,25,28,26,0,0,0,103,20081112
2009,POR,27,23,23,31,0,0,0,104,MIA,19,28,28,21,0,0,0,96,20081112
2009,SAS,18,25,16,19,0,0,0,78,MIL,15,16,22,29,0,0,0,82,20081112
2009,IND,28,22,19,29,0,0,0,98,NJN,24,19,16,28,0,0,0,87,20081112
2009,LAL,28,23,20,22,0,0,0,93,NOH,17,13,22,34,0,0,0,86,20081112
2009,ORL,39,32,16,22,0,0,0,109,OKC,19,23,29,21,0,0,0,92,20081112
2009,HOU,23,21,30,20,0,0,0,94,PHO,22,15,18,27,0,0,0,82,20081112
2009,PHI,26,25,27,28,0,0,0,106,TOR,13,32,26,25,0,0,0,96,20081112
2009,UTA,26,15,25,21,0,0,0,87,WAS,23,23,19,30,0,0,0,95,20081112
2009,DAL,32,18,20,21,0,0,0,91,CHI,22,29,27,20,0,0,0,98,20081113
2009,DEN,36,25,20,18,0,0,0,99,CLE,33,25,30,22,0,0,0,110,20081113
2009,DET,21,25,34,27,0,0,0,107,GSW,23,30,20,29,0,0,0,102,20081113
2009,DEN,23,25,16,30,0,0,0,94,BOS,29,13,23,20,0,0,0,85,20081114
2009,UTA,25,18,25,28,0,0,0,96,CHA,18,26,27,33,0,0,0,104,20081114
2009,ORL,17,29,26,30,0,0,0,102,DAL,21,35,24,20,0,0,0,100,20081114
2009,PHI,13,36,22,23,0,0,0,94,IND,38,19,21,14,0,0,0,92,20081114
2009,DET,23,30,24,29,0,0,0,106,LAL,16,28,18,33,0,0,0,95,20081114
2009,MIL,21,16,27,23,14,0,0,101,MEM,25,24,15,23,9,0,0,96,20081114
2009,WAS,20,16,17,24,0,0,0,77,MIA,27,22,27,21,0,0,0,97,20081114
2009,ATL,22,28,26,32,0,0,0,108,NJN,27,22,24,42,0,0,0,115,20081114
2009,POR,19,25,18,20,0,0,0,82,NOH,21,20,23,23,0,0,0,87,20081114
2009,OKC,20,24,33,29,0,0,0,106,NYK,37,31,25,23,0,0,0,116,20081114
2009,PHO,27,26,17,16,11,0,0,97,SAC,23,19,19,25,9,0,0,95,20081114
2009,HOU,23,20,19,13,0,0,0,75,SAS,21,19,15,22,0,0,0,77,20081114
2009,NJN,29,26,30,34,0,0,0,119,ATL,28,22,23,34,0,0,0,107,20081115
2009,IND,19,28,26,18,0,0,0,91,CHI,27,28,26,23,0,0,0,104,20081115
2009,UTA,21,32,23,17,0,0,0,93,CLE,25,21,34,25,0,0,0,105,20081115
2009,NOH,21,15,17,29,0,0,0,82,HOU,26,22,22,21,0,0,0,91,20081115
2009,GSW,36,22,32,31,0,0,0,121,LAC,31,19,33,20,0,0,0,103,20081115
2009,BOS,21,29,21,22,9,0,0,102,MIL,20,18,21,34,4,0,0,97,20081115
2009,POR,27,14,24,23,0,0,0,88,MIN,25,26,20,12,0,0,0,83,20081115
2009,OKC,22,20,18,25,0,0,0,85,PHI,24,22,33,31,0,0,0,110,20081115
2009,ORL,19,19,27,25,0,0,0,90,CHA,21,22,18,24,0,0,0,85,20081116
2009,MIN,17,23,27,17,0,0,0,84,DEN,27,17,21,25,0,0,0,90,20081116
2009,DAL,26,31,32,23,12,0,0,124,NYK,35,29,27,21,2,0,0,114,20081116
2009,DET,23,23,21,19,0,0,0,86,PHO,31,30,20,23,0,0,0,104,20081116
2009,SAS,15,28,25,22,0,0,0,90,SAC,23,19,30,16,0,0,0,88,20081116
2009,MIA,27,27,24,18,0,0,0,96,TOR,29,21,30,27,0,0,0,107,20081116
2009,SAS,21,22,25,18,0,0,0,86,LAC,23,15,26,19,0,0,0,83,20081117
2009,HOU,32,24,25,19,0,0,0,100,OKC,30,20,19,20,0,0,0,89,20081117
2009,PHO,32,22,23,20,0,0,0,97,UTA,23,34,26,26,0,0,0,109,20081117
2009,NYK,28,19,30,24,0,0,0,101,BOS,26,30,33,21,0,0,0,110,20081118
2009,DAL,28,27,19,26,0,0,0,100,CHA,10,25,23,25,0,0,0,83,20081118
2009,MIL,28,22,23,32,0,0,0,105,DEN,34,30,27,23,0,0,0,114,20081118
2009,POR,27,22,24,33,0,0,0,106,GSW,24,27,29,31,0,0,0,111,20081118
2009,ATL,25,23,25,23,0,0,0,96,IND,32,29,27,25,0,0,0,113,20081118
2009,CHI,29,27,18,35,0,0,0,109,LAL,30,31,29,26,0,0,0,116,20081118
2009,SAC,25,22,24,23,0,0,0,94,MEM,32,32,26,19,0,0,0,109,20081118
2009,CLE,26,23,28,29,0,0,0,106,NJN,28,24,13,17,0,0,0,82,20081118
2009,TOR,26,19,22,23,0,0,0,90,ORL,21,24,28,30,0,0,0,103,20081118
2009,MIA,23,20,30,21,0,0,0,94,WAS,17,24,26,20,0,0,0,87,20081118
2009,WAS,26,24,17,20,0,0,0,87,ATL,28,16,26,21,0,0,0,91,20081119
2009,CLE,24,25,19,21,0,0,0,89,DET,16,22,28,30,0,0,0,96,20081119
2009,DAL,31,22,19,24,0,0,0,96,HOU,25,21,15,25,0,0,0,86,20081119
2009,TOR,25,22,30,24,0,0,0,101,MIA,23,20,24,28,0,0,0,95,20081119
2009,PHI,27,25,13,31,0,0,0,96,MIN,24,32,20,26,0,0,0,102,20081119
2009,SAC,23,28,26,28,0,0,0,105,NOH,29,25,22,20,0,0,0,96,20081119
2009,LAC,20,29,32,27,0,0,0,108,OKC,26,26,16,20,0,0,0,88,20081119
2009,CHI,13,24,20,17,0,0,0,74,POR,34,28,26,28,0,0,0,116,20081119
2009,DEN,22,28,25,16,0,0,0,91,SAS,21,19,14,27,0,0,0,81,20081119
2009,MIL,16,37,23,18,0,0,0,94,UTA,26,25,23,31,0,0,0,105,20081119
2009,DET,21,19,17,23,0,0,0,80,BOS,21,28,28,21,0,0,0,98,20081120
2009,LAL,26,24,30,25,0,0,0,105,PHO,24,20,23,25,0,0,0,92,20081120
2009,CHA,24,19,20,20,0,0,0,83,ATL,16,31,15,26,0,0,0,88,20081121
2009,MEM,22,19,15,20,0,0,0,76,DAL,22,22,24,23,0,0,0,91,20081121
2009,CHI,27,30,28,30,0,0,0,115,GSW,28,31,28,23,0,0,0,110,20081121
2009,ORL,28,22,20,21,9,0,0,100,IND,34,20,23,14,7,0,0,98,20081121
2009,DEN,20,27,20,23,0,0,0,90,LAL,35,32,21,16,0,0,0,104,20081121
2009,NYK,19,28,13,27,0,0,0,87,MIL,28,22,22,32,0,0,0,104,20081121
2009,BOS,22,14,35,24,0,0,0,95,MIN,21,18,10,29,0,0,0,78,20081121
2009,NOH,26,34,23,22,0,0,0,105,OKC,17,22,18,23,0,0,0,80,20081121
2009,LAC,16,33,23,16,0,0,0,88,PHI,28,18,22,21,0,0,0,89,20081121
2009,POR,28,29,37,23,0,0,0,117,SAC,25,26,18,27,0,0,0,96,20081121
2009,UTA,24,29,18,23,0,0,0,94,SAS,29,32,34,24,0,0,0,119,20081121
2009,NJN,22,25,29,35,18,0,0,129,TOR,33,28,24,26,16,0,0,127,20081121
2009,HOU,17,32,21,33,0,0,0,103,WAS,29,21,27,14,0,0,0,91,20081121
2009,MIL,22,13,27,17,0,0,0,79,CHA,21,15,16,22,0,0,0,74,20081122
2009,ATL,12,20,26,38,0,0,0,96,CLE,28,21,30,31,0,0,0,110,20081122
2009,UTA,28,22,27,26,0,0,0,103,MEM,25,18,26,25,0,0,0,94,20081122
2009,IND,31,29,19,21,0,0,0,100,MIA,20,28,31,30,0,0,0,109,20081122
2009,LAC,29,18,24,24,0,0,0,95,NJN,31,24,29,28,0,0,0,112,20081122
2009,OKC,30,18,24,25,0,0,0,97,NOH,28,25,29,27,0,0,0,109,20081122
2009,WAS,29,29,31,28,0,0,0,117,NYK,35,25,31,31,0,0,0,122,20081122
2009,HOU,25,26,22,27,0,0,0,100,ORL,17,36,18,24,0,0,0,95,20081122
2009,POR,17,19,26,30,0,0,0,92,PHO,21,20,31,30,0,0,0,102,20081122
2009,CHI,18,36,31,16,0,0,0,101,DEN,27,31,25,31,0,0,0,114,20081123
2009,MIN,22,22,32,30,0,0,0,106,DET,19,15,18,28,0,0,0,80,20081123
2009,SAC,27,25,28,28,0,0,0,108,LAL,32,29,35,22,0,0,0,118,20081123
2009,GSW,17,22,23,19,0,0,0,81,PHI,27,30,15,17,0,0,0,89,20081123
2009,BOS,32,27,36,23,0,0,0,118,TOR,20,29,24,30,0,0,0,103,20081123
2009,PHI,25,16,23,20,0,0,0,84,CHA,20,21,27,25,0,0,0,93,20081124
2009,NOH,25,24,27,23,0,0,0,99,LAC,24,22,19,22,0,0,0,87,20081124
2009,SAS,22,19,31,22,0,0,0,94,MEM,17,19,19,26,0,0,0,81,20081124
2009,HOU,30,26,24,27,0,0,0,107,MIA,21,27,27,23,0,0,0,98,20081124
2009,MIL,23,24,27,27,0,0,0,101,ORL,33,25,27,23,0,0,0,108,20081124
2009,SAC,21,23,27,19,0,0,0,90,POR,27,21,27,16,0,0,0,91,20081124
2009,CHI,28,25,19,29,0,0,0,101,UTA,26,19,30,25,0,0,0,100,20081124
2009,IND,26,30,27,23,0,0,0,106,DAL,26,23,28,32,0,0,0,109,20081125
2009,NJN,28,26,22,17,0,0,0,93,LAL,24,32,34,30,0,0,0,120,20081125
2009,CLE,34,33,28,24,0,0,0,119,NYK,22,16,28,35,0,0,0,101,20081125
2009,PHO,26,15,29,29,0,0,0,99,OKC,25,29,27,17,0,0,0,98,20081125
2009,GSW,26,23,23,28,0,0,0,100,WAS,32,31,30,31,0,0,0,124,20081125
2009,MIL,24,24,19,29,0,0,0,96,ATL,28,20,23,31,0,0,0,102,20081126
2009,GSW,28,39,16,28,0,0,0,111,BOS,35,19,32,33,0,0,0,119,20081126
2009,OKC,14,18,20,30,0,0,0,82,CLE,33,33,26,25,0,0,0,117,20081126
2009,NYK,20,23,25,28,0,0,0,96,DET,29,30,27,24,0,0,0,110,20081126
2009,IND,18,29,17,27,0,0,0,91,HOU,25,19,30,16,0,0,0,90,20081126
2009,DEN,32,24,23,27,0,0,0,106,LAC,22,33,16,34,0,0,0,105,20081126
2009,PHO,28,31,21,30,0,0,0,110,MIN,23,20,29,30,0,0,0,102,20081126
2009,ORL,26,29,16,25,0,0,0,96,PHI,19,26,27,22,0,0,0,94,20081126
2009,MIA,17,23,17,11,0,0,0,68,POR,37,22,17,30,0,0,0,106,20081126
2009,NJN,29,27,26,23,11,0,0,116,SAC,23,22,32,28,9,0,0,114,20081126
2009,CHI,24,21,26,17,0,0,0,88,SAS,25,20,31,22,0,0,0,98,20081126
2009,CHA,25,21,22,18,0,0,0,86,TOR,24,27,24,18,0,0,0,93,20081126
2009,MEM,19,27,25,29,0,0,0,100,UTA,33,26,36,22,0,0,0,117,20081126
2009,NOH,32,20,24,29,0,0,0,105,DEN,22,24,23,32,0,0,0,101,20081127
2009,ORL,38,17,31,19,0,0,0,105,WAS,25,19,21,25,0,0,0,90,20081127
2009,PHI,16,12,19,31,0,0,0,78,BOS,22,24,27,29,0,0,0,102,20081128
2009,GSW,32,20,16,29,0,0,0,97,CLE,29,29,36,18,0,0,0,112,20081128
2009,MIL,24,25,23,25,0,0,0,97,DET,28,34,20,25,0,0,0,107,20081128
2009,CHA,28,25,24,22,16,0,0,115,IND,18,30,33,18,9,0,0,108,20081128
2009,DAL,27,30,21,29,0,0,0,107,LAL,30,21,29,34,0,0,0,114,20081128
2009,MIN,16,28,35,26,0,0,0,105,OKC,18,30,22,33,0,0,0,103,20081128
2009,MIA,32,25,24,26,0,0,0,107,PHO,19,25,26,22,0,0,0,92,20081128
2009,NOH,26,22,21,17,0,0,0,86,POR,31,19,27,24,0,0,0,101,20081128
2009,MEM,16,20,34,28,0,0,0,98,SAS,17,29,27,36,0,0,0,109,20081128
2009,ATL,21,29,15,23,0,0,0,88,TOR,24,22,23,24,0,0,0,93,20081128
2009,SAC,23,27,17,27,0,0,0,94,UTA,29,21,44,26,0,0,0,120,20081128
2009,BOS,17,28,21,23,0,0,0,89,CHA,22,21,19,22,0,0,0,84,20081129
2009,SAS,20,29,21,14,0,0,0,84,HOU,33,23,28,19,0,0,0,103,20081129
2009,MIA,28,28,17,23,0,0,0,96,LAC,29,25,14,29,0,0,0,97,20081129
2009,OKC,22,21,33,35,0,0,0,111,MEM,28,26,26,23,0,0,0,103,20081129
2009,CLE,20,28,24,25,0,0,0,97,MIL,16,22,29,18,0,0,0,85,20081129
2009,DEN,25,35,27,19,0,0,0,106,MIN,31,23,16,27,0,0,0,97,20081129
2009,GSW,33,31,32,29,0,0,0,125,NYK,39,43,34,22,0,0,0,138,20081129
2009,IND,22,25,20,29,0,0,0,96,ORL,27,31,29,23,0,0,0,110,20081129
2009,DAL,29,17,30,25,0,0,0,101,SAC,20,18,19,21,0,0,0,78,20081129
2009,NJN,28,31,24,22,0,0,0,105,UTA,29,22,16,21,0,0,0,88,20081129
2009,ATL,28,27,25,22,0,0,0,102,WAS,17,28,26,27,0,0,0,98,20081129
2009,HOU,21,23,24,26,0,0,0,94,DEN,21,27,30,26,0,0,0,104,20081130
2009,POR,25,25,20,26,0,0,0,96,DET,13,29,22,21,0,0,0,85,20081130
2009,TOR,29,22,30,18,0,0,0,99,LAL,34,27,29,22,0,0,0,112,20081130
2009,CHI,24,28,31,20,0,0,0,103,PHI,34,21,11,26,0,0,0,92,20081130
2009,NJN,24,32,18,43,0,0,0,117,PHO,35,27,23,24,0,0,0,109,20081130
2009,ORL,18,28,19,23,0,0,0,88,BOS,28,20,29,30,0,0,0,107,20081201
2009,MIN,20,16,25,29,0,0,0,90,CHA,21,22,23,34,0,0,0,100,20081201
2009,MIA,30,30,31,24,15,0,0,130,GSW,27,37,30,21,14,0,0,129,20081201
2009,PHI,23,17,27,23,13,0,0,103,CHI,13,24,24,29,5,0,0,95,20081202
2009,LAC,27,28,26,17,0,0,0,98,DAL,21,26,21,32,0,0,0,100,20081202
2009,TOR,19,26,23,25,0,0,0,93,DEN,33,31,36,32,0,0,0,132,20081202
2009,LAL,30,36,35,16,0,0,0,117,IND,28,33,25,32,0,0,0,118,20081202
2009,WAS,28,23,35,22,0,0,0,108,NJN,27,23,12,26,0,0,0,88,20081202
2009,POR,24,25,22,33,0,0,0,104,NYK,31,20,24,22,0,0,0,97,20081202
2009,UTA,20,19,25,35,0,0,0,99,SAC,24,14,28,28,0,0,0,94,20081202
2009,DET,17,23,21,28,0,0,0,89,SAS,22,23,18,14,0,0,0,77,20081202
2009,MEM,24,15,30,26,0,0,0,95,ATL,24,26,33,22,0,0,0,105,20081203
2009,IND,27,24,22,23,0,0,0,96,BOS,28,29,31,26,0,0,0,114,20081203
2009,OKC,21,24,27,25,0,0,0,97,CHA,24,25,29,25,0,0,0,103,20081203
2009,NYK,20,15,24,23,0,0,0,82,CLE,31,30,24,33,0,0,0,118,20081203
2009,LAC,19,27,30,20,0,0,0,96,HOU,27,26,24,26,0,0,0,103,20081203
2009,CHI,20,22,30,18,0,0,0,90,MIL,19,35,22,21,0,0,0,97,20081203
2009,PHO,21,29,19,22,0,0,0,91,NOH,35,16,31,22,0,0,0,104,20081203
2009,MIN,17,21,12,39,0,0,0,89,ORL,23,21,26,30,0,0,0,100,20081203
2009,LAL,31,30,24,29,0,0,0,114,PHI,25,26,18,33,0,0,0,102,20081203
2009,MIA,19,28,27,19,0,0,0,93,UTA,24,21,20,24,0,0,0,89,20081203
2009,POR,19,26,32,21,0,0,0,98,WAS,26,17,29,20,0,0,0,92,20081203
2009,PHO,24,22,28,23,0,0,0,97,DAL,33,31,24,24,0,0,0,112,20081204
2009,SAS,30,31,22,25,0,0,0,108,DEN,26,15,26,24,0,0,0,91,20081204
2009,NYK,30,25,16,24,0,0,0,95,ATL,31,26,17,24,0,0,0,98,20081205
2009,POR,21,15,15,27,0,0,0,78,BOS,24,25,25,19,0,0,0,93,20081205
2009,IND,20,18,16,19,0,0,0,73,CLE,21,31,18,27,0,0,0,97,20081205
2009,PHI,19,19,20,38,0,0,0,96,DET,25,23,19,24,0,0,0,91,20081205
2009,GSW,32,25,27,28,0,0,0,112,HOU,30,32,26,43,0,0,0,131,20081205
2009,LAC,25,19,17,20,0,0,0,81,MEM,24,27,21,21,0,0,0,93,20081205
2009,CHA,24,32,18,22,0,0,0,96,MIL,29,25,22,25,0,0,0,101,20081205
2009,MIN,17,24,25,18,0,0,0,84,NJN,31,19,33,30,0,0,0,113,20081205
2009,OKC,18,21,27,23,0,0,0,89,ORL,23,22,25,28,0,0,0,98,20081205
2009,TOR,23,25,19,20,0,0,0,87,UTA,33,31,27,23,0,0,0,114,20081205
2009,LAL,35,23,29,19,0,0,0,106,WAS,24,29,19,32,0,0,0,104,20081205
2009,CLE,30,25,19,20,0,0,0,94,CHA,14,21,13,26,0,0,0,74,20081206
2009,WAS,25,27,22,36,0,0,0,110,CHI,24,33,31,29,0,0,0,117,20081206
2009,ATL,23,20,16,39,0,0,0,98,DAL,21,20,33,26,0,0,0,100,20081206
2009,OKC,27,27,16,29,0,0,0,99,MIA,36,23,26,20,0,0,0,105,20081206
2009,LAC,29,26,24,28,0,0,0,107,MIN,15,26,15,28,0,0,0,84,20081206
2009,MEM,16,23,22,26,0,0,0,87,NOH,37,21,32,16,0,0,0,106,20081206
2009,NJN,26,21,22,26,0,0,0,95,PHI,21,23,21,19,0,0,0,84,20081206
2009,UTA,26,24,28,26,0,0,0,104,PHO,26,24,28,28,0,0,0,106,20081206
2009,DEN,37,23,29,29,0,0,0,118,SAC,18,21,23,23,0,0,0,85,20081206
2009,GSW,21,28,18,21,0,0,0,88,SAS,35,30,39,19,0,0,0,123,20081206
2009,BOS,32,23,23,27,17,0,0,122,IND,22,35,24,24,12,0,0,117,20081207
2009,MIL,16,15,23,38,0,0,0,92,LAL,24,19,31,31,0,0,0,105,20081207
2009,DET,12,31,20,29,0,0,0,92,NYK,29,36,16,23,0,0,0,104,20081207
2009,POR,20,28,30,20,0,0,0,98,TOR,31,19,25,22,0,0,0,97,20081207
2009,ORL,26,16,24,29,0,0,0,95,LAC,19,29,27,13,0,0,0,88,20081208
2009,HOU,19,28,28,22,0,0,0,97,MEM,32,24,27,26,0,0,0,109,20081208
2009,CHA,25,23,20,28,0,0,0,96,MIA,22,29,15,34,0,0,0,100,20081208
2009,GSW,29,32,25,26,0,0,0,112,OKC,23,19,26,34,0,0,0,102,20081208
2009,NYK,22,26,29,23,0,0,0,100,CHI,28,22,28,27,0,0,0,105,20081209
2009,TOR,19,32,16,27,0,0,0,94,CLE,29,30,31,24,0,0,0,114,20081209
2009,SAS,17,30,34,26,9,17,0,133,DAL,22,23,34,28,9,10,0,126,20081209
2009,ATL,16,22,24,22,0,0,0,84,HOU,27,19,14,32,0,0,0,92,20081209
2009,UTA,32,14,29,24,0,0,0,99,MIN,24,23,24,25,0,0,0,96,20081209
2009,MIL,35,29,26,20,0,0,0,110,PHO,36,38,22,29,0,0,0,125,20081209
2009,ORL,29,20,32,28,0,0,0,109,POR,25,23,32,28,0,0,0,108,20081209
2009,LAL,22,29,29,21,0,0,0,101,SAC,27,29,31,26,0,0,0,113,20081209
2009,DET,29,17,22,26,0,0,0,94,WAS,14,29,31,33,0,0,0,107,20081209
2009,MIN,30,26,22,27,0,0,0,105,DEN,22,22,40,32,0,0,0,116,20081210
2009,MIL,22,28,31,15,0,0,0,96,GSW,30,25,27,37,0,0,0,119,20081210
2009,PHO,25,23,33,29,0,0,0,110,LAL,29,24,29,33,0,0,0,115,20081210
2009,NYK,23,34,33,31,0,0,0,121,NJN,33,30,21,25,0,0,0,109,20081210
2009,CHA,21,19,17,32,0,0,0,89,NOH,29,30,29,17,0,0,0,105,20081210
2009,MEM,23,25,28,32,0,0,0,108,OKC,29,26,28,19,0,0,0,102,20081210
2009,CLE,25,23,36,17,0,0,0,101,PHI,28,18,19,28,0,0,0,93,20081210
2009,ATL,17,18,20,34,0,0,0,89,SAS,25,18,19,33,0,0,0,95,20081210
2009,IND,18,27,20,23,0,0,0,88,TOR,20,31,26,24,0,0,0,101,20081210
2009,CHA,26,28,20,16,0,0,0,90,DAL,26,27,21,21,0,0,0,95,20081211
2009,POR,27,19,20,22,0,0,0,88,UTA,29,28,21,19,0,0,0,97,20081211
2009,BOS,36,27,26,33,0,0,0,122,WAS,21,18,35,14,0,0,0,88,20081211
2009,NOH,21,19,24,18,0,0,0,82,BOS,21,18,30,25,0,0,0,94,20081212
2009,PHI,25,14,19,14,0,0,0,72,CLE,25,27,17,19,0,0,0,88,20081212
2009,IND,26,31,23,30,0,0,0,110,DET,32,31,23,28,0,0,0,114,20081212
2009,HOU,31,30,31,27,0,0,0,119,GSW,29,21,25,33,0,0,0,108,20081212
2009,SAC,27,25,20,31,0,0,0,103,LAL,33,19,32,28,0,0,0,112,20081212
2009,CHI,30,24,20,22,0,0,0,96,MEM,22,30,31,20,0,0,0,103,20081212
2009,ATL,20,23,32,12,0,0,0,87,MIA,25,15,15,18,0,0,0,73,20081212
2009,SAS,19,22,25,32,0,0,0,98,MIN,19,22,16,29,0,0,0,86,20081212
2009,TOR,24,16,31,30,0,0,0,101,NJN,18,16,19,26,0,0,0,79,20081212
2009,ORL,33,28,16,35,0,0,0,112,PHO,28,32,27,26,0,0,0,113,20081212
2009,LAC,26,31,20,20,9,14,0,120,POR,32,22,29,14,9,6,0,112,20081212
2009,CLE,24,14,28,26,0,0,0,92,ATL,31,16,21,29,0,0,0,97,20081213
2009,DET,24,27,27,12,0,0,0,90,CHA,13,20,23,30,0,0,0,86,20081213
2009,NJN,31,29,20,24,0,0,0,104,CHI,22,28,25,38,0,0,0,113,20081213
2009,OKC,28,26,26,19,0,0,0,99,DAL,23,27,29,24,0,0,0,103,20081213
2009,GSW,22,29,23,31,0,0,0,105,DEN,36,29,34,24,0,0,0,123,20081213
2009,HOU,22,26,16,18,0,0,0,82,LAC,28,17,25,25,0,0,0,95,20081213
2009,IND,24,22,37,20,0,0,0,103,MIL,33,31,22,35,0,0,0,121,20081213
2009,WAS,20,20,25,24,0,0,0,89,PHI,25,26,28,25,0,0,0,104,20081213
2009,NYK,43,26,24,21,0,0,0,114,SAC,21,24,26,19,0,0,0,90,20081213
2009,ORL,25,21,34,23,0,0,0,103,UTA,26,30,12,26,0,0,0,94,20081213
2009,MIN,18,19,25,24,0,0,0,86,LAL,20,22,27,29,0,0,0,98,20081214
2009,MIA,22,24,20,20,0,0,0,86,MEM,25,21,35,21,0,0,0,102,20081214
2009,OKC,19,25,25,35,0,0,0,104,SAS,39,23,21,26,0,0,0,109,20081214
2009,NOH,22,29,29,19,0,0,0,99,TOR,24,22,26,19,0,0,0,91,20081214
2009,CHA,27,21,20,11,0,0,0,79,ATL,23,19,26,15,0,0,0,83,20081215
2009,UTA,16,27,22,26,0,0,0,91,BOS,28,15,26,31,0,0,0,100,20081215
2009,DEN,27,29,19,23,0,0,0,98,DAL,15,28,28,17,0,0,0,88,20081215
2009,ORL,21,25,31,32,0,0,0,109,GSW,20,20,27,31,0,0,0,98,20081215
2009,MIL,27,29,21,21,0,0,0,98,MIA,18,18,29,18,0,0,0,83,20081215
2009,NYK,21,30,30,22,0,0,0,103,PHO,32,30,29,20,0,0,0,111,20081215
2009,MIN,26,24,17,36,0,0,0,103,SAC,20,33,33,32,0,0,0,118,20081215
2009,NJN,20,26,17,31,0,0,0,94,TOR,28,18,24,17,0,0,0,87,20081215
2009,IND,33,29,25,31,0,0,0,118,WAS,27,21,35,15,0,0,0,98,20081215
2009,CHI,25,20,18,31,7,0,0,101,CHA,16,26,25,27,16,0,0,110,20081216
2009,DEN,25,36,18,17,0,0,0,96,HOU,30,26,29,23,0,0,0,108,20081216
2009,NYK,37,28,23,26,0,0,0,114,LAL,26,24,34,32,0,0,0,116,20081216
2009,NOH,26,23,12,30,0,0,0,91,MEM,11,31,18,24,0,0,0,84,20081216
2009,LAC,28,22,20,28,0,0,0,98,OKC,16,32,17,23,0,0,0,88,20081216
2009,SAC,27,15,18,17,0,0,0,77,POR,28,26,27,28,0,0,0,109,20081216
2009,BOS,22,20,17,29,0,0,0,88,ATL,21,22,19,23,0,0,0,85,20081217
2009,LAC,26,21,33,26,3,0,0,109,CHI,26,30,21,29,9,0,0,115,20081217
2009,WAS,21,13,24,16,0,0,0,74,DET,23,21,17,27,0,0,0,88,20081217
2009,GSW,29,33,31,27,0,0,0,120,IND,40,28,27,32,0,0,0,127,20081217
2009,CLE,24,20,19,30,0,0,0,93,MIN,21,17,18,14,0,0,0,70,20081217
2009,UTA,7,24,32,40,0,0,0,103,NJN,27,12,30,23,0,0,0,92,20081217
2009,SAS,15,27,28,13,0,0,0,83,NOH,14,23,26,27,0,0,0,90,20081217
2009,MIL,26,27,20,15,0,0,0,88,PHI,24,22,21,26,0,0,0,93,20081217
2009,DAL,21,23,25,27,0,0,0,96,TOR,33,16,14,23,0,0,0,86,20081217
2009,SAS,13,16,23,26,0,0,0,78,ORL,19,25,21,25,0,0,0,90,20081218
2009,PHO,28,38,27,26,0,0,0,119,POR,31,28,39,26,0,0,0,124,20081218
2009,GSW,21,33,27,18,0,0,0,99,ATL,31,21,27,36,0,0,0,115,20081219
2009,CHI,21,34,27,26,0,0,0,108,BOS,31,26,41,28,0,0,0,126,20081219
2009,CLE,37,27,20,21,0,0,0,105,DEN,21,32,12,23,0,0,0,88,20081219
2009,UTA,19,24,26,29,8,14,0,120,DET,29,19,22,28,8,8,0,114,20081219
2009,SAC,33,22,18,23,0,0,0,96,HOU,30,25,27,25,0,0,0,107,20081219
2009,LAC,18,30,22,27,8,12,0,117,IND,25,24,20,28,8,4,0,109,20081219
2009,CHA,36,22,28,26,0,0,0,112,MEM,26,18,16,23,0,0,0,83,20081219
2009,LAL,26,20,17,24,0,0,0,87,MIA,26,20,29,14,0,0,0,89,20081219
2009,DAL,30,21,26,20,0,0,0,97,NJN,33,31,26,31,0,0,0,121,20081219
2009,MIL,24,29,30,22,0,0,0,105,NYK,15,22,26,18,0,0,0,81,20081219
2009,TOR,17,19,23,24,0,0,0,83,OKC,26,20,22,23,0,0,0,91,20081219
2009,PHI,27,29,28,25,0,0,0,109,WAS,28,29,29,17,0,0,0,103,20081219
2009,GSW,27,29,31,23,0,0,0,110,CHA,29,27,23,24,0,0,0,103,20081220
2009,UTA,29,23,27,19,0,0,0,98,CHI,27,24,27,28,0,0,0,106,20081220
2009,LAC,15,17,26,27,0,0,0,85,MIL,37,25,31,26,0,0,0,119,20081220
2009,HOU,30,30,22,27,0,0,0,109,MIN,32,19,20,31,0,0,0,102,20081220
2009,MIA,27,35,18,26,0,0,0,106,NJN,29,27,21,26,0,0,0,103,20081220
2009,SAC,21,25,17,27,0,0,0,90,NOH,29,17,26,27,0,0,0,99,20081220
2009,LAL,24,34,26,19,0,0,0,103,ORL,23,26,36,21,0,0,0,106,20081220
2009,IND,16,28,25,26,0,0,0,95,PHI,29,19,25,21,0,0,0,94,20081220
2009,DEN,28,30,24,19,0,0,0,101,PHO,29,29,27,23,0,0,0,108,20081220
2009,TOR,25,23,25,24,0,0,0,97,SAS,20,36,28,23,0,0,0,107,20081220
2009,DET,25,16,22,15,0,0,0,78,ATL,22,30,17,16,0,0,0,85,20081221
2009,NYK,21,37,29,18,0,0,0,105,BOS,40,26,32,26,0,0,0,124,20081221
2009,CLE,27,25,30,20,0,0,0,102,OKC,25,22,25,19,0,0,0,91,20081221
2009,DAL,22,20,28,27,0,0,0,97,WAS,21,23,24,18,0,0,0,86,20081221
2009,POR,27,20,28,14,0,0,0,89,DEN,29,24,25,19,0,0,0,97,20081222
2009,TOR,25,26,18,28,0,0,0,97,LAC,18,14,28,15,0,0,0,75,20081222
2009,LAL,25,24,28,28,0,0,0,105,MEM,25,32,23,16,0,0,0,96,20081222
2009,HOU,29,32,25,28,0,0,0,114,NJN,13,27,25,26,0,0,0,91,20081222
2009,GSW,16,29,21,15,0,0,0,81,ORL,25,28,34,26,0,0,0,113,20081222
2009,SAC,22,23,16,24,0,0,0,85,SAS,33,29,18,21,0,0,0,101,20081222
2009,OKC,24,19,25,20,0,0,0,88,ATL,23,22,24,30,0,0,0,99,20081223
2009,PHI,25,19,22,25,0,0,0,91,BOS,29,29,20,32,0,0,0,110,20081223
2009,WAS,18,18,17,19,0,0,0,72,CHA,26,10,19,25,0,0,0,80,20081223
2009,HOU,23,24,19,24,0,0,0,90,CLE,26,21,26,26,0,0,0,99,20081223
2009,MEM,12,20,28,22,0,0,0,82,DAL,22,20,28,30,0,0,0,100,20081223
2009,CHI,19,26,24,29,0,0,0,98,DET,32,26,22,24,0,0,0,104,20081223
2009,NJN,30,26,27,25,0,0,0,108,IND,30,27,24,26,0,0,0,107,20081223
2009,GSW,24,17,15,32,0,0,0,88,MIA,21,26,20,29,0,0,0,96,20081223
2009,UTA,18,20,26,22,0,0,0,86,MIL,26,24,19,25,0,0,0,94,20081223
2009,LAL,24,32,24,20,0,0,0,100,NOH,20,17,27,23,0,0,0,87,20081223
2009,DEN,25,17,24,26,0,0,0,92,POR,25,22,20,34,0,0,0,101,20081223
2009,MIN,21,19,27,26,0,0,0,93,SAS,30,18,35,16,0,0,0,99,20081223
2009,WAS,25,22,24,18,0,0,0,89,CLE,22,27,19,25,0,0,0,93,20081225
2009,BOS,24,21,22,16,0,0,0,83,LAL,23,28,20,21,0,0,0,92,20081225
2009,NOH,14,17,24,13,0,0,0,68,ORL,29,32,13,14,0,0,0,88,20081225
2009,SAS,18,21,32,20,0,0,0,91,PHO,27,18,31,14,0,0,0,90,20081225
2009,DAL,33,26,18,25,0,0,0,102,POR,29,26,25,14,0,0,0,94,20081225
2009,PHI,21,31,27,22,0,0,0,101,DEN,21,28,19,37,0,0,0,105,20081226
2009,OKC,17,27,19,25,0,0,0,88,DET,19,27,20,24,0,0,0,90,20081226
2009,BOS,29,22,21,17,0,0,0,89,GSW,19,20,25,35,0,0,0,99,20081226
2009,IND,36,32,19,18,0,0,0,105,MEM,23,36,27,22,0,0,0,108,20081226
2009,CHI,21,24,19,13,0,0,0,77,MIA,18,22,24,26,0,0,0,90,20081226
2009,CHA,23,27,23,22,0,0,0,95,NJN,21,20,24,22,0,0,0,87,20081226
2009,HOU,18,26,20,15,0,0,0,79,NOH,23,23,20,22,0,0,0,88,20081226
2009,MIN,25,38,31,26,0,0,0,120,NYK,30,25,20,32,0,0,0,107,20081226
2009,TOR,30,21,34,22,0,0,0,107,SAC,26,30,26,19,0,0,0,101,20081226
2009,DAL,24,20,20,24,0,0,0,88,UTA,25,28,23,21,0,0,0,97,20081226
2009,CHI,35,28,32,22,0,0,0,117,ATL,32,36,30,31,0,0,0,129,20081227
2009,NJN,22,25,25,24,18,0,0,114,CHA,26,21,19,30,7,0,0,103,20081227
2009,UTA,24,19,27,26,5,14,0,115,HOU,34,22,24,16,5,19,0,120,20081227
2009,DET,27,19,27,14,0,0,0,87,MIL,21,23,11,21,0,0,0,76,20081227
2009,ORL,31,22,26,39,0,0,0,118,MIN,22,33,19,20,0,0,0,94,20081227
2009,TOR,28,29,10,22,0,0,0,89,POR,26,23,20,33,0,0,0,102,20081227
2009,MEM,18,31,17,24,9,4,0,103,SAS,23,19,24,24,9,7,0,106,20081227
2009,OKC,31,23,22,19,0,0,0,95,WAS,33,23,20,28,0,0,0,104,20081227
2009,MIA,22,20,25,19,0,0,0,86,CLE,22,22,14,35,0,0,0,93,20081228
2009,NOH,27,22,27,29,0,0,0,105,IND,29,27,19,28,0,0,0,103,20081228
2009,DAL,24,21,31,22,0,0,0,98,LAC,13,21,27,15,0,0,0,76,20081228
2009,GSW,27,31,27,28,0,0,0,113,LAL,34,31,37,28,0,0,0,130,20081228
2009,DEN,27,39,27,24,0,0,0,117,NYK,27,29,33,21,0,0,0,110,20081228
2009,BOS,23,36,25,24,0,0,0,108,SAC,17,17,14,15,0,0,0,63,20081228
2009,DEN,24,29,18,20,0,0,0,91,ATL,29,25,24,31,0,0,0,109,20081229
2009,ORL,19,24,23,16,0,0,0,82,DET,24,28,18,18,0,0,0,88,20081229
2009,TOR,29,23,27,32,0,0,0,111,GSW,28,32,26,31,0,0,0,117,20081229
2009,WAS,21,24,27,17,0,0,0,89,HOU,22,14,26,25,0,0,0,87,20081229
2009,MEM,19,20,26,24,9,0,0,98,MIN,24,8,29,28,19,0,0,108,20081229
2009,CHI,32,22,16,30,0,0,0,100,NJN,20,29,23,15,0,0,0,87,20081229
2009,PHO,34,26,32,18,0,0,0,110,OKC,34,21,32,15,0,0,0,102,20081229
2009,PHI,20,23,21,31,0,0,0,95,UTA,24,27,28,33,0,0,0,112,20081229
2009,NYK,36,20,18,19,0,0,0,93,CHA,25,23,20,21,0,0,0,89,20081230
2009,MIN,27,35,22,16,0,0,0,100,DAL,20,20,33,34,0,0,0,107,20081230
2009,ATL,26,24,35,25,0,0,0,110,IND,25,21,37,21,0,0,0,104,20081230
2009,PHO,21,25,24,31,0,0,0,101,MEM,27,22,29,11,0,0,0,89,20081230
2009,CLE,19,15,33,28,0,0,0,95,MIA,26,24,24,30,0,0,0,104,20081230
2009,WAS,17,29,17,22,0,0,0,85,NOH,25,21,22,29,0,0,0,97,20081230
2009,BOS,23,22,19,22,0,0,0,86,POR,13,27,24,27,0,0,0,91,20081230
2009,LAC,12,29,32,17,0,0,0,90,SAC,27,22,23,20,0,0,0,92,20081230
2009,MIL,31,20,29,20,0,0,0,100,SAS,26,23,25,24,0,0,0,98,20081230
2009,ORL,33,32,23,25,0,0,0,113,CHI,17,21,22,34,0,0,0,94,20081231
2009,NJN,18,11,23,23,0,0,0,75,DET,22,18,22,21,0,0,0,83,20081231
2009,MIL,22,14,24,21,0,0,0,81,HOU,27,20,18,20,0,0,0,85,20081231
2009,PHI,26,24,19,31,0,0,0,100,LAC,27,20,18,27,0,0,0,92,20081231
2009,GSW,28,27,15,30,0,0,0,100,OKC,22,29,27,29,0,0,0,107,20081231
2009,DEN,29,24,32,29,0,0,0,114,TOR,31,19,27,30,0,0,0,107,20081231
2009,WAS,14,20,21,28,0,0,0,83,BOS,28,30,28,22,0,0,0,108,20090102
2009,CHI,17,30,25,20,0,0,0,92,CLE,32,29,28,28,0,0,0,117,20090102
2009,PHI,20,24,22,20,0,0,0,86,DAL,16,24,24,32,0,0,0,96,20090102
2009,SAC,18,26,22,26,0,0,0,92,DET,29,16,28,25,0,0,0,98,20090102
2009,UTA,20,23,23,34,0,0,0,100,LAL,37,20,24,32,0,0,0,113,20090102
2009,SAS,28,16,23,24,0,0,0,91,MEM,20,20,16,24,0,0,0,80,20090102
2009,CHA,25,19,13,18,0,0,0,75,MIL,29,27,20,27,0,0,0,103,20090102
2009,GSW,26,31,27,24,0,0,0,108,MIN,32,26,33,24,0,0,0,115,20090102
2009,ATL,21,28,20,16,6,0,0,91,NJN,16,13,32,24,8,0,0,93,20090102
2009,IND,27,26,30,22,0,0,0,105,NYK,23,21,33,26,0,0,0,103,20090102
2009,DEN,32,21,36,33,0,0,0,122,OKC,26,38,32,24,0,0,0,120,20090102
2009,MIA,21,23,21,11,0,0,0,76,ORL,24,21,22,19,0,0,0,86,20090102
2009,LAC,15,34,23,26,0,0,0,98,PHO,33,29,21,23,0,0,0,106,20090102
2009,NOH,21,24,16,31,0,0,0,92,POR,16,27,18,16,0,0,0,77,20090102
2009,HOU,14,24,11,24,0,0,0,73,TOR,25,23,20,26,0,0,0,94,20090102
2009,HOU,27,19,31,23,0,0,0,100,ATL,22,32,25,24,0,0,0,103,20090103
2009,MIL,22,20,21,29,0,0,0,92,CHA,21,30,25,26,0,0,0,102,20090103
2009,MIN,18,27,27,30,0,0,0,102,CHI,17,21,27,27,0,0,0,92,20090103
2009,NOH,23,17,31,29,0,0,0,100,DEN,28,30,25,22,0,0,0,105,20090103
2009,SAC,37,30,22,28,0,0,0,117,IND,33,35,21,33,0,0,0,122,20090103
2009,NJN,27,19,17,22,11,0,0,96,MIA,14,24,23,24,16,0,0,101,20090103
2009,PHI,19,31,31,25,0,0,0,106,SAS,40,26,18,24,0,0,0,108,20090103
2009,DET,23,29,15,21,0,0,0,88,LAC,22,32,12,21,0,0,0,87,20090104
2009,POR,25,25,16,20,0,0,0,86,LAL,19,32,30,19,0,0,0,100,20090104
2009,DAL,25,20,23,14,0,0,0,82,MEM,35,15,26,26,0,0,0,102,20090104
2009,BOS,24,29,15,20,0,0,0,88,NYK,25,25,28,22,0,0,0,100,20090104
2009,ORL,22,27,29,24,0,0,0,102,TOR,34,22,21,31,0,0,0,108,20090104
2009,CLE,23,20,11,23,0,0,0,77,WAS,26,21,21,12,0,0,0,80,20090104
2009,IND,28,42,22,23,0,0,0,115,DEN,40,34,23,38,0,0,0,135,20090105
2009,SAS,21,18,26,26,0,0,0,91,MIA,15,24,21,24,0,0,0,84,20090105
2009,TOR,27,21,23,26,0,0,0,97,MIL,19,26,29,33,0,0,0,107,20090105
2009,SAC,18,37,19,16,0,0,0,90,NJN,23,20,29,26,0,0,0,98,20090105
2009,GSW,29,30,32,23,0,0,0,114,UTA,28,37,29,25,0,0,0,119,20090105
2009,BOS,23,24,25,25,9,0,0,106,CHA,28,25,19,25,17,0,0,114,20090106
2009,SAC,23,19,25,27,0,0,0,94,CHI,22,27,26,24,0,0,0,99,20090106
2009,LAC,24,30,30,18,0,0,0,102,DAL,37,27,23,20,0,0,0,107,20090106
2009,NOH,32,29,28,27,0,0,0,116,LAL,26,30,36,13,0,0,0,105,20090106
2009,MIN,31,14,27,22,0,0,0,94,MEM,23,16,29,19,0,0,0,87,20090106
2009,NYK,23,27,29,20,0,0,0,99,OKC,35,28,28,16,0,0,0,107,20090106
2009,WAS,24,6,33,17,0,0,0,80,ORL,30,16,24,19,0,0,0,89,20090106
2009,HOU,27,28,16,25,0,0,0,96,PHI,24,29,26,25,0,0,0,104,20090106
2009,ORL,29,31,26,20,0,0,0,106,ATL,24,21,25,32,0,0,0,102,20090107
2009,HOU,22,30,19,18,0,0,0,89,BOS,31,18,25,11,0,0,0,85,20090107
2009,CHA,12,30,14,25,0,0,0,81,CLE,29,31,24,27,0,0,0,111,20090107
2009,MIA,21,27,24,25,0,0,0,97,DEN,27,32,24,25,0,0,0,108,20090107
2009,LAL,28,28,21,37,0,0,0,114,GSW,20,31,29,26,0,0,0,106,20090107
2009,PHI,30,25,24,31,0,0,0,110,MIL,25,34,26,20,0,0,0,105,20090107
2009,OKC,24,19,23,21,0,0,0,87,MIN,42,30,26,31,0,0,0,129,20090107
2009,MEM,18,24,29,18,0,0,0,89,NJN,32,23,26,19,0,0,0,100,20090107
2009,IND,28,33,34,18,0,0,0,113,PHO,21,36,29,24,0,0,0,110,20090107
2009,DET,26,23,19,15,0,0,0,83,POR,20,22,23,19,0,0,0,84,20090107
2009,NOH,33,13,18,26,0,0,0,90,UTA,29,29,26,32,0,0,0,116,20090107
2009,TOR,27,23,23,26,0,0,0,99,WAS,16,22,22,33,0,0,0,93,20090107
2009,NYK,29,30,19,16,0,0,0,94,DAL,27,27,26,19,0,0,0,99,20090108
2009,LAC,22,22,25,15,0,0,0,84,SAS,16,27,32,31,0,0,0,106,20090108
2009,WAS,16,18,23,29,0,0,0,86,CHI,30,22,19,27,0,0,0,98,20090109
2009,BOS,23,17,20,23,0,0,0,83,CLE,33,16,23,26,0,0,0,98,20090109
2009,DET,17,21,23,32,0,0,0,93,DEN,25,23,19,23,0,0,0,90,20090109
2009,IND,36,30,18,35,0,0,0,119,LAL,41,27,28,25,0,0,0,121,20090109
2009,NJN,28,21,26,27,0,0,0,102,MIL,28,33,18,25,0,0,0,104,20090109
2009,LAC,23,26,18,13,0,0,0,80,NOH,32,30,25,20,0,0,0,107,20090109
2009,HOU,24,29,24,21,0,0,0,98,OKC,24,16,32,24,0,0,0,96,20090109
2009,ATL,18,15,27,27,0,0,0,87,ORL,41,30,32,18,0,0,0,121,20090109
2009,CHA,27,18,20,22,0,0,0,87,PHI,24,19,31,19,0,0,0,93,20090109
2009,DAL,31,27,19,23,0,0,0,100,PHO,29,35,40,24,0,0,0,128,20090109
2009,MIA,25,33,16,30,15,0,0,119,SAC,30,32,20,22,11,0,0,115,20090109
2009,MEM,19,25,17,21,0,0,0,82,TOR,23,24,25,31,0,0,0,103,20090109
2009,OKC,31,23,22,18,15,0,0,109,CHI,29,22,23,20,4,0,0,98,20090110
2009,NYK,24,21,14,17,0,0,0,76,HOU,26,20,31,19,0,0,0,96,20090110
2009,MIL,28,32,23,21,0,0,0,104,MIN,19,32,27,28,0,0,0,106,20090110
2009,GSW,25,24,21,30,0,0,0,100,POR,16,39,28,30,0,0,0,113,20090110
2009,DET,21,26,17,18,0,0,0,82,UTA,32,25,22,20,0,0,0,99,20090110
2009,CHA,23,22,24,23,0,0,0,92,WAS,31,18,21,19,0,0,0,89,20090110
2009,PHI,30,29,24,26,0,0,0,109,ATL,30,22,26,16,0,0,0,94,20090111
2009,IND,32,29,24,32,0,0,0,117,GSW,23,32,31,34,0,0,0,120,20090111
2009,PHO,31,28,27,23,0,0,0,109,LAC,25,28,20,30,0,0,0,103,20090111
2009,MIA,21,30,22,32,0,0,0,105,LAL,26,24,27,31,0,0,0,108,20090111
2009,DAL,27,28,23,17,0,0,0,95,SAC,29,20,28,25,0,0,0,102,20090111
2009,ORL,34,21,19,31,0,0,0,105,SAS,28,22,22,26,0,0,0,98,20090111
2009,BOS,32,22,21,19,0,0,0,94,TOR,20,21,14,33,0,0,0,88,20090111
2009,TOR,23,31,24,15,16,0,0,109,BOS,19,26,29,19,22,0,0,115,20090112
2009,POR,21,28,28,32,0,0,0,109,CHI,28,17,21,29,0,0,0,95,20090112
2009,OKC,25,26,14,23,11,0,0,99,NJN,25,19,23,21,15,0,0,103,20090112
2009,NYK,23,24,22,32,0,0,0,101,NOH,23,17,23,32,0,0,0,95,20090112
2009,IND,32,31,24,26,0,0,0,113,UTA,36,34,26,24,0,0,0,120,20090112
2009,MIL,25,16,28,28,0,0,0,97,WAS,19,33,22,17,0,0,0,91,20090112
2009,DAL,26,21,25,25,0,0,0,97,DEN,33,27,18,21,0,0,0,99,20090113
2009,CHA,25,16,21,18,0,0,0,80,DET,27,21,20,10,0,0,0,78,20090113
2009,LAL,25,29,24,27,0,0,0,105,HOU,26,28,28,18,0,0,0,100,20090113
2009,CLE,26,21,29,26,0,0,0,102,MEM,20,24,22,21,0,0,0,87,20090113
2009,MIA,20,26,27,26,0,0,0,99,MIN,21,31,24,20,0,0,0,96,20090113
2009,ATL,16,30,29,27,0,0,0,102,PHO,31,19,31,26,0,0,0,107,20090113
2009,ORL,41,34,32,32,0,0,0,139,SAC,29,27,29,22,0,0,0,107,20090113
2009,NJN,23,18,19,26,0,0,0,86,BOS,30,21,37,30,0,0,0,118,20090114
2009,NOH,26,25,28,25,0,0,0,104,DAL,30,26,23,18,0,0,0,97,20090114
2009,SAC,31,26,28,20,10,12,8,135,GSW,20,28,29,28,10,12,6,133,20090114
2009,DET,29,19,26,19,13,0,0,106,IND,31,22,21,19,17,0,0,110,20090114
2009,ATL,15,28,23,31,0,0,0,97,LAC,12,19,27,22,0,0,0,80,20090114
2009,MIA,28,27,25,22,0,0,0,102,MIL,24,31,18,26,0,0,0,99,20090114
2009,WAS,30,36,21,35,0,0,0,122,NYK,36,31,27,34,0,0,0,128,20090114
2009,UTA,22,26,23,22,0,0,0,93,OKC,27,23,36,28,0,0,0,114,20090114
2009,POR,15,18,26,20,0,0,0,79,PHI,31,24,14,31,0,0,0,100,20090114
2009,LAL,29,32,26,24,0,0,0,111,SAS,30,33,32,17,0,0,0,112,20090114
2009,CHI,27,20,21,34,0,0,0,102,TOR,18,30,23,27,0,0,0,98,20090114
2009,CLE,28,20,23,16,6,0,0,93,CHI,20,26,25,16,15,0,0,102,20090115
2009,PHO,35,27,20,21,10,0,0,113,DEN,26,30,26,21,16,0,0,119,20090115
2009,POR,27,19,22,37,0,0,0,105,NJN,29,21,21,28,0,0,0,99,20090115
2009,NOH,17,19,22,20,0,0,0,78,CLE,28,23,17,24,0,0,0,92,20090116
2009,ATL,20,31,30,33,0,0,0,114,GSW,23,33,29,34,0,0,0,119,20090116
2009,TOR,20,22,23,39,0,0,0,104,IND,20,36,33,22,0,0,0,111,20090116
2009,ORL,20,24,30,35,0,0,0,109,LAL,23,29,23,28,0,0,0,103,20090116
2009,UTA,26,28,26,21,0,0,0,101,MEM,21,22,26,22,0,0,0,91,20090116
2009,DET,18,28,21,12,0,0,0,79,OKC,21,28,22,18,0,0,0,89,20090116
2009,SAS,18,29,23,17,0,0,0,87,PHI,28,26,31,24,0,0,0,109,20090116
2009,MIN,27,22,24,32,0,0,0,105,PHO,23,30,26,24,0,0,0,103,20090116
2009,MIL,37,30,31,31,0,0,0,129,SAC,18,29,36,39,0,0,0,122,20090116
2009,NYK,25,12,35,17,0,0,0,89,WAS,31,18,21,26,0,0,0,96,20090116
2009,POR,18,27,22,23,7,0,0,97,CHA,24,26,17,23,12,0,0,102,20090117
2009,SAS,28,15,22,27,0,0,0,92,CHI,17,26,16,28,0,0,0,87,20090117
2009,UTA,23,28,30,27,0,0,0,108,DAL,17,38,28,32,0,0,0,115,20090117
2009,ORL,26,21,32,27,0,0,0,106,DEN,23,25,22,18,0,0,0,88,20090117
2009,NOH,18,21,28,24,0,0,0,91,DET,20,17,31,17,0,0,0,85,20090117
2009,MIA,21,15,28,22,0,0,0,86,HOU,25,20,24,24,0,0,0,93,20090117
2009,MIL,30,23,23,16,0,0,0,92,LAC,32,20,25,24,0,0,0,101,20090117
2009,BOS,29,39,15,22,0,0,0,105,NJN,15,24,24,22,0,0,0,85,20090117
2009,PHI,26,26,24,31,0,0,0,107,NYK,25,25,16,31,0,0,0,97,20090117
2009,MIA,31,26,27,20,0,0,0,104,OKC,27,23,23,21,0,0,0,94,20090118
2009,PHO,36,35,24,22,0,0,0,117,TOR,34,29,24,26,0,0,0,113,20090118
2009,TOR,24,27,13,20,0,0,0,84,ATL,23,19,20,25,0,0,0,87,20090119
2009,PHO,15,19,24,29,0,0,0,87,BOS,30,34,25,15,0,0,0,104,20090119
2009,SAS,29,17,17,23,0,0,0,86,CHA,21,20,27,16,0,0,0,84,20090119
2009,WAS,23,25,31,19,0,0,0,98,GSW,28,32,26,33,0,0,0,119,20090119
2009,DEN,36,32,19,26,0,0,0,113,HOU,36,29,25,25,0,0,0,115,20090119
2009,MIN,26,21,24,23,0,0,0,94,LAC,16,20,28,22,0,0,0,86,20090119
2009,CLE,24,26,16,22,0,0,0,88,LAL,26,23,26,30,0,0,0,105,20090119
2009,DET,20,23,24,20,0,0,0,87,MEM,17,22,30,10,0,0,0,79,20090119
2009,IND,28,27,10,35,0,0,0,100,NOH,26,30,18,29,0,0,0,103,20090119
2009,CHI,20,34,23,21,0,0,0,98,NYK,22,35,21,24,0,0,0,102,20090119
2009,DAL,16,26,32,21,0,0,0,95,PHI,22,24,17,30,0,0,0,93,20090119
2009,MIL,19,21,24,21,0,0,0,85,POR,22,23,26,31,0,0,0,102,20090119
2009,ATL,22,28,27,28,0,0,0,105,CHI,22,31,24,25,0,0,0,102,20090120
2009,SAC,31,16,28,24,0,0,0,99,DEN,23,34,37,24,0,0,0,118,20090120
2009,IND,17,23,17,24,0,0,0,81,SAS,22,31,28,18,0,0,0,99,20090120
2009,MIN,25,24,31,27,0,0,0,107,UTA,32,26,25,29,0,0,0,112,20090120
2009,MEM,15,26,23,22,0,0,0,86,CHA,21,25,24,31,0,0,0,101,20090121
2009,TOR,22,21,19,14,0,0,0,76,DET,17,29,30,19,0,0,0,95,20090121
2009,OKC,37,35,17,33,0,0,0,122,GSW,34,34,27,26,0,0,0,121,20090121
2009,UTA,19,23,31,26,0,0,0,99,HOU,31,24,25,28,0,0,0,108,20090121
2009,LAL,25,33,30,20,0,0,0,108,LAC,27,28,18,24,0,0,0,97,20090121
2009,BOS,29,28,21,20,0,0,0,98,MIA,10,24,30,19,0,0,0,83,20090121
2009,DAL,30,28,27,14,0,0,0,99,MIL,22,42,37,32,0,0,0,133,20090121
2009,NJN,28,18,16,30,0,0,0,92,NOH,22,25,28,27,0,0,0,102,20090121
2009,PHO,30,28,21,30,0,0,0,109,NYK,26,28,30,30,0,0,0,114,20090121
2009,CLE,28,25,21,30,0,0,0,104,POR,25,20,24,29,0,0,0,98,20090121
2009,WAS,31,23,35,21,0,0,0,110,SAC,21,23,26,37,0,0,0,107,20090121
2009,WAS,24,23,21,29,0,0,0,97,LAL,31,41,25,20,0,0,0,117,20090122
2009,BOS,24,20,21,25,0,0,0,90,ORL,19,17,18,26,0,0,0,80,20090122
2009,MIL,19,28,20,20,0,0,0,87,ATL,27,31,28,31,0,0,0,117,20090123
2009,PHO,13,24,18,21,0,0,0,76,CHA,21,38,22,17,0,0,0,98,20090123
2009,TOR,28,26,29,31,0,0,0,114,CHI,25,29,20,20,0,0,0,94,20090123
2009,DAL,31,32,27,22,0,0,0,112,DET,25,26,21,19,0,0,0,91,20090123
2009,CLE,28,27,29,22,0,0,0,106,GSW,26,28,27,24,0,0,0,105,20090123
2009,HOU,24,16,25,37,0,0,0,102,IND,21,29,22,35,0,0,0,107,20090123
2009,OKC,29,24,19,32,0,0,0,104,LAC,25,25,27,30,0,0,0,107,20090123
2009,NOH,30,26,25,27,0,0,0,108,MIN,25,26,28,37,0,0,0,116,20090123
2009,MEM,30,15,17,26,0,0,0,88,NYK,27,29,16,36,0,0,0,108,20090123
2009,NJN,24,26,16,25,0,0,0,91,SAS,26,18,28,22,0,0,0,94,20090123
2009,NJN,25,22,25,27,0,0,0,99,MEM,17,23,30,18,0,0,0,88,20090124
2009,ORL,29,23,16,29,0,0,0,97,MIA,32,24,27,20,0,0,0,103,20090124
2009,SAC,36,27,19,22,0,0,0,104,MIL,33,29,22,22,0,0,0,106,20090124
2009,NYK,30,36,15,29,0,0,0,110,PHI,36,27,23,30,0,0,0,116,20090124
2009,WAS,17,14,24,32,0,0,0,87,POR,22,17,34,27,0,0,0,100,20090124
2009,CLE,33,14,34,21,0,0,0,102,UTA,23,26,24,24,0,0,0,97,20090124
2009,PHO,27,28,28,21,0,0,0,104,ATL,26,31,23,19,0,0,0,99,20090125
2009,DAL,23,24,31,22,0,0,0,100,BOS,38,36,29,21,0,0,0,124,20090125
2009,UTA,26,25,26,20,0,0,0,97,DEN,35,25,31,26,0,0,0,117,20090125
2009,HOU,39,22,28,19,0,0,0,108,DET,27,30,24,24,0,0,0,105,20090125
2009,LAC,18,26,20,28,0,0,0,92,GSW,28,27,29,23,0,0,0,107,20090125
2009,CHA,25,19,26,23,0,0,0,93,IND,26,28,23,21,0,0,0,98,20090125
2009,SAS,23,22,21,19,0,0,0,85,LAL,22,29,28,20,0,0,0,99,20090125
2009,CHI,30,25,27,15,11,0,0,108,MIN,19,30,28,20,12,0,0,109,20090125
2009,SAC,28,25,21,23,0,0,0,97,TOR,26,30,31,26,0,0,0,113,20090125
2009,POR,21,28,28,36,0,0,0,113,LAC,22,26,25,15,0,0,0,88,20090126
2009,ATL,14,13,24,28,0,0,0,79,MIA,17,29,18,31,0,0,0,95,20090126
2009,MIN,20,27,27,16,0,0,0,90,MIL,21,22,17,23,0,0,0,83,20090126
2009,PHI,23,24,16,23,0,0,0,86,NOH,20,20,29,32,0,0,0,101,20090126
2009,HOU,23,35,22,18,0,0,0,98,NYK,29,26,19,30,0,0,0,104,20090126
2009,NJN,23,17,14,31,0,0,0,85,OKC,24,27,31,12,0,0,0,94,20090126
2009,PHO,22,29,24,28,0,0,0,103,WAS,24,27,22,14,0,0,0,87,20090126
2009,SAC,27,29,26,28,0,0,0,110,CLE,26,34,28,29,0,0,0,117,20090127
2009,CHA,23,26,27,17,10,14,0,117,LAL,16,32,22,23,10,7,0,110,20090127
2009,DEN,24,30,21,25,0,0,0,100,MEM,25,20,23,17,0,0,0,85,20090127
2009,IND,18,32,37,24,0,0,0,111,ORL,36,32,34,33,0,0,0,135,20090127
2009,SAS,25,25,30,26,0,0,0,106,UTA,28,21,31,20,0,0,0,100,20090127
2009,SAC,30,19,29,22,0,0,0,100,BOS,28,40,24,27,0,0,0,119,20090128
2009,GSW,25,22,23,23,0,0,0,93,DAL,31,38,23,25,0,0,0,117,20090128
2009,PHI,27,18,26,24,0,0,0,95,HOU,26,25,25,17,0,0,0,93,20090128
2009,MIL,22,29,27,21,0,0,0,99,IND,38,25,19,25,0,0,0,107,20090128
2009,CHI,24,23,26,22,0,0,0,95,LAC,19,25,9,22,0,0,0,75,20090128
2009,WAS,23,16,17,15,0,0,0,71,MIA,18,23,29,23,0,0,0,93,20090128
2009,DET,22,28,21,27,0,0,0,98,MIN,24,28,20,17,0,0,0,89,20090128
2009,TOR,21,29,34,23,0,0,0,107,NJN,27,27,23,29,0,0,0,106,20090128
2009,DEN,20,24,21,16,0,0,0,81,NOH,19,27,22,26,0,0,0,94,20090128
2009,ATL,26,29,19,30,0,0,0,104,NYK,25,22,35,30,0,0,0,112,20090128
2009,MEM,37,20,14,29,2,0,0,102,OKC,24,32,25,19,14,0,0,114,20090128
2009,CHA,18,22,18,16,0,0,0,74,POR,32,24,18,14,0,0,0,88,20090128
2009,CLE,32,24,16,16,0,0,0,88,ORL,25,30,24,20,0,0,0,99,20090129
2009,SAS,32,25,32,25,0,0,0,114,PHO,31,26,27,20,0,0,0,104,20090129
2009,NJN,28,25,18,17,0,0,0,88,ATL,25,30,25,25,0,0,0,105,20090130
2009,LAC,26,28,19,22,0,0,0,95,CLE,26,28,29,29,0,0,0,112,20090130
2009,CHA,19,23,29,28,0,0,0,99,DEN,24,33,29,24,0,0,0,110,20090130
2009,BOS,23,20,19,24,0,0,0,86,DET,16,25,15,22,0,0,0,78,20090130
2009,MIA,26,23,24,30,0,0,0,103,IND,29,37,27,21,0,0,0,114,20090130
2009,LAL,33,31,36,32,0,0,0,132,MIN,31,29,25,34,0,0,0,119,20090130
2009,GSW,19,28,18,26,0,0,0,91,NOH,27,17,21,22,0,0,0,87,20090130
2009,WAS,17,22,31,24,0,0,0,94,PHI,32,14,28,30,0,0,0,104,20090130
2009,CHI,34,20,29,26,0,0,0,109,SAC,22,21,20,25,0,0,0,88,20090130
2009,MIL,24,25,21,26,0,0,0,96,TOR,30,17,12,26,0,0,0,85,20090130
2009,OKC,26,25,24,15,0,0,0,90,UTA,28,36,31,15,0,0,0,110,20090130
2009,GSW,20,31,24,18,0,0,0,93,HOU,25,28,28,29,0,0,0,110,20090131
2009,NYK,29,38,32,23,0,0,0,122,IND,28,27,32,26,0,0,0,113,20090131
2009,LAL,26,29,36,24,0,0,0,115,MEM,29,32,21,16,0,0,0,98,20090131
2009,DAL,24,33,28,26,0,0,0,111,MIA,15,34,21,26,0,0,0,96,20090131
2009,ATL,22,26,26,33,0,0,0,107,MIL,29,24,34,23,0,0,0,110,20090131
2009,NJN,31,19,15,20,0,0,0,85,PHI,31,27,17,8,0,0,0,83,20090131
2009,CHI,30,32,26,34,0,0,0,122,PHO,25,34,24,28,0,0,0,111,20090131
2009,UTA,26,21,26,35,0,0,0,108,POR,33,19,38,32,0,0,0,122,20090131
2009,NOH,22,20,29,22,0,0,0,93,SAS,28,22,30,26,0,0,0,106,20090131
2009,LAC,22,25,28,19,0,0,0,94,WAS,26,32,23,25,0,0,0,106,20090131
2009,MIN,24,20,29,28,0,0,0,101,BOS,29,33,25,22,0,0,0,109,20090201
2009,CLE,16,20,22,32,0,0,0,90,DET,18,21,27,14,0,0,0,80,20090201
2009,OKC,31,26,33,22,6,0,0,118,SAC,33,30,29,20,10,0,0,122,20090201
2009,ORL,31,22,34,26,0,0,0,113,TOR,25,22,18,25,0,0,0,90,20090201
2009,SAS,27,21,27,20,15,0,0,110,GSW,25,27,27,16,10,0,0,105,20090202
2009,LAC,24,23,26,22,0,0,0,95,MIA,30,28,32,29,0,0,0,119,20090202
2009,POR,17,22,20,38,0,0,0,97,NOH,25,23,26,15,0,0,0,89,20090202
2009,LAL,31,34,31,30,0,0,0,126,NYK,26,28,32,31,0,0,0,117,20090202
2009,DAL,25,29,23,28,0,0,0,105,ORL,27,20,16,32,0,0,0,95,20090202
2009,SAC,19,24,14,24,0,0,0,81,PHO,40,33,32,24,0,0,0,129,20090202
2009,CHA,25,26,19,16,0,0,0,86,UTA,19,30,27,29,0,0,0,105,20090202
2009,MEM,32,29,33,19,0,0,0,113,WAS,29,28,24,16,0,0,0,97,20090202
2009,TOR,15,25,26,17,0,0,0,83,CLE,37,22,15,27,0,0,0,101,20090203
2009,SAS,25,19,24,28,0,0,0,96,DEN,31,25,22,26,0,0,0,104,20090203
2009,CHI,18,27,21,34,0,0,0,100,HOU,20,28,31,28,0,0,0,107,20090203
2009,MIN,27,29,22,38,0,0,0,116,IND,32,27,23,29,0,0,0,111,20090203
2009,MIL,16,21,26,22,0,0,0,85,NJN,23,22,29,25,0,0,0,99,20090203
2009,BOS,32,18,19,31,0,0,0,100,PHI,20,29,21,29,0,0,0,99,20090203
2009,POR,29,16,27,27,0,0,0,99,DAL,27,30,25,22,0,0,0,104,20090204
2009,MIA,21,21,20,28,0,0,0,90,DET,20,25,25,23,0,0,0,93,20090204
2009,PHO,30,25,28,29,0,0,0,112,GSW,43,29,32,20,0,0,0,124,20090204
2009,HOU,31,24,19,19,0,0,0,93,MEM,31,27,30,16,0,0,0,104,20090204
2009,ATL,22,23,30,19,0,0,0,94,MIN,18,19,25,24,0,0,0,86,20090204
2009,CHI,31,31,18,27,0,0,0,107,NOH,20,24,17,32,0,0,0,93,20090204
2009,CLE,36,21,25,25,0,0,0,107,NYK,24,28,26,24,0,0,0,102,20090204
2009,DEN,32,27,30,25,0,0,0,114,OKC,31,39,24,19,0,0,0,113,20090204
2009,LAC,22,26,23,25,0,0,0,96,ORL,34,38,32,21,0,0,0,125,20090204
2009,LAL,26,32,27,30,0,0,0,115,TOR,31,32,24,20,0,0,0,107,20090204
2009,NJN,27,31,35,22,0,0,0,115,WAS,22,31,18,17,0,0,0,88,20090204
2009,LAL,23,28,26,24,9,0,0,110,BOS,20,32,29,20,8,0,0,109,20090205
2009,IND,22,34,13,25,0,0,0,94,PHI,29,25,26,19,0,0,0,99,20090205
2009,DAL,20,27,19,21,0,0,0,87,UTA,24,33,37,21,0,0,0,115,20090205
2009,ATL,19,24,35,24,0,0,0,102,CHA,22,33,22,20,0,0,0,97,20090206
2009,ORL,29,22,23,28,0,0,0,102,IND,32,29,19,27,0,0,0,107,20090206
2009,LAC,33,35,34,24,0,0,0,126,MEM,20,29,28,28,0,0,0,105,20090206
2009,TOR,16,32,21,23,0,0,0,92,NOH,26,16,22,37,0,0,0,101,20090206
2009,BOS,27,19,26,38,0,0,0,110,NYK,26,21,29,24,0,0,0,100,20090206
2009,POR,25,15,26,27,0,0,0,93,OKC,37,23,21,21,0,0,0,102,20090206
2009,GSW,21,33,31,20,0,0,0,105,PHO,31,28,27,29,0,0,0,115,20090206
2009,UTA,28,17,35,31,0,0,0,111,SAC,25,30,22,30,0,0,0,107,20090206
2009,DEN,30,38,34,22,0,0,0,124,WAS,23,25,22,33,0,0,0,103,20090206
2009,LAC,27,28,35,31,0,0,0,121,ATL,17,24,31,25,0,0,0,97,20090207
2009,CHI,24,26,22,25,17,0,0,114,DAL,20,28,29,20,18,0,0,115,20090207
2009,MIN,27,23,21,19,0,0,0,90,HOU,20,30,28,29,0,0,0,107,20090207
2009,TOR,21,14,20,15,0,0,0,70,MEM,18,25,17,18,0,0,0,78,20090207
2009,DET,30,24,25,30,17,0,0,126,MIL,19,26,37,27,12,0,0,121,20090207
2009,DEN,19,20,16,15,0,0,0,70,NJN,24,35,33,22,0,0,0,114,20090207
2009,MIA,23,21,25,15,0,0,0,84,PHI,26,18,19,31,0,0,0,94,20090207
2009,SAS,22,38,14,31,0,0,0,105,BOS,23,29,24,23,0,0,0,99,20090208
2009,LAL,30,21,31,19,0,0,0,101,CLE,32,29,16,14,0,0,0,91,20090208
2009,PHO,29,33,21,24,0,0,0,107,DET,29,21,24,23,0,0,0,97,20090208
2009,UTA,21,24,24,27,0,0,0,96,GSW,23,25,38,30,0,0,0,116,20090208
2009,CHA,20,19,22,31,0,0,0,92,MIA,18,25,26,27,0,0,0,96,20090208
2009,MIN,31,21,28,17,0,0,0,97,NOH,24,25,27,25,0,0,0,101,20090208
2009,SAC,23,23,34,33,0,0,0,113,OKC,34,25,25,32,0,0,0,116,20090208
2009,NJN,18,27,20,19,0,0,0,84,ORL,32,27,20,22,0,0,0,101,20090208
2009,NYK,27,23,32,26,0,0,0,108,POR,36,23,23,27,0,0,0,109,20090208
2009,IND,37,26,31,23,0,0,0,117,WAS,29,32,31,27,0,0,0,119,20090208
2009,LAC,21,22,18,12,0,0,0,73,CHA,22,24,21,27,0,0,0,94,20090209
2009,NOH,22,17,19,22,0,0,0,80,MEM,21,19,24,21,0,0,0,85,20090209
2009,HOU,23,35,18,36,0,0,0,112,MIL,32,32,34,26,0,0,0,124,20090209
2009,PHO,25,19,22,25,0,0,0,91,PHI,30,25,25,28,0,0,0,108,20090209
2009,WAS,17,20,24,29,0,0,0,90,ATL,26,27,24,34,0,0,0,111,20090210
2009,DET,22,29,34,17,0,0,0,102,CHI,30,20,21,36,0,0,0,107,20090210
2009,SAC,31,26,14,29,0,0,0,100,DAL,38,24,26,30,0,0,0,118,20090210
2009,NYK,29,36,30,32,0,0,0,127,GSW,41,24,40,39,0,0,0,144,20090210
2009,CLE,24,19,25,27,0,0,0,95,IND,24,18,25,29,0,0,0,96,20090210
2009,OKC,25,22,26,25,0,0,0,98,LAL,25,35,20,25,0,0,0,105,20090210
2009,DEN,32,24,18,25,0,0,0,99,MIA,20,20,25,17,0,0,0,82,20090210
2009,TOR,23,18,32,37,0,0,0,110,MIN,16,32,32,22,0,0,0,102,20090210
2009,SAS,28,26,28,26,0,0,0,108,NJN,21,30,18,24,0,0,0,93,20090210
2009,WAS,21,24,18,26,0,0,0,89,CHA,24,32,21,24,0,0,0,101,20090211
2009,PHO,29,23,19,21,0,0,0,92,CLE,29,35,23,22,0,0,0,109,20090211
2009,ATL,24,24,28,23,0,0,0,99,DET,24,22,22,27,0,0,0,95,20090211
2009,SAC,25,10,21,26,0,0,0,82,HOU,22,17,35,20,0,0,0,94,20090211
2009,NYK,34,25,27,24,14,0,0,124,LAC,28,30,27,25,18,0,0,128,20090211
2009,IND,28,31,25,26,0,0,0,110,MIL,31,26,33,32,0,0,0,122,20090211
2009,BOS,23,19,22,25,0,0,0,89,NOH,21,23,20,13,0,0,0,77,20090211
2009,DEN,24,22,17,19,0,0,0,82,ORL,17,12,22,22,0,0,0,73,20090211
2009,MEM,18,19,22,28,0,0,0,87,PHI,26,15,23,27,0,0,0,91,20090211
2009,OKC,20,26,28,18,0,0,0,92,POR,23,30,27,26,0,0,0,106,20090211
2009,SAS,22,21,26,20,0,0,0,89,TOR,20,29,18,24,0,0,0,91,20090211
2009,LAL,29,34,22,24,0,0,0,109,UTA,31,30,26,26,0,0,0,113,20090211
2009,MIA,23,27,26,19,0,0,0,95,CHI,24,15,26,28,0,0,0,93,20090212
2009,BOS,17,23,29,30,0,0,0,99,DAL,21,30,24,17,0,0,0,92,20090212
2009,POR,20,26,16,36,0,0,0,98,GSW,32,25,23,25,0,0,0,105,20090212
2009,MIL,29,21,24,18,0,0,0,92,DET,17,20,24,25,0,0,0,86,20090217
2009,NJN,17,23,25,23,0,0,0,88,HOU,27,29,28,30,0,0,0,114,20090217
2009,PHI,18,26,19,28,0,0,0,91,IND,28,27,25,20,0,0,0,100,20090217
2009,ATL,24,12,24,23,0,0,0,83,LAL,23,22,40,11,0,0,0,96,20090217
2009,SAS,27,29,21,25,5,0,0,107,NYK,27,30,20,25,10,0,0,112,20090217
2009,NOH,32,21,25,22,0,0,0,100,OKC,18,29,24,27,0,0,0,98,20090217
2009,CHA,21,29,24,21,7,0,0,102,ORL,25,18,25,27,12,0,0,107,20090217
2009,LAC,26,23,23,28,0,0,0,100,PHO,41,40,37,22,0,0,0,140,20090217
2009,MEM,25,31,24,19,0,0,0,99,UTA,33,23,32,29,0,0,0,117,20090217
2009,MIN,16,26,34,27,0,0,0,103,WAS,27,24,25,35,0,0,0,111,20090217
2009,IND,25,25,19,25,0,0,0,94,CHA,32,21,26,24,0,0,0,103,20090218
2009,NJN,28,27,15,28,0,0,0,98,DAL,28,24,40,21,0,0,0,113,20090218
2009,LAL,30,32,30,37,0,0,0,129,GSW,34,34,26,27,0,0,0,121,20090218
2009,PHO,30,37,36,39,0,0,0,142,LAC,29,24,37,29,0,0,0,119,20090218
2009,MIN,20,26,36,29,0,0,0,111,MIA,31,18,24,31,0,0,0,104,20090218
2009,CHI,23,26,30,34,0,0,0,113,MIL,22,29,24,29,0,0,0,104,20090218
2009,ORL,20,23,19,23,0,0,0,85,NOH,35,21,30,31,0,0,0,117,20090218
2009,DEN,13,24,34,30,0,0,0,101,PHI,25,22,21,21,0,0,0,89,20090218
2009,MEM,27,26,19,18,0,0,0,90,POR,30,27,18,19,0,0,0,94,20090218
2009,ATL,30,25,28,22,0,0,0,105,SAC,27,32,18,23,0,0,0,100,20090218
2009,CLE,24,23,24,22,0,0,0,93,TOR,23,18,15,20,0,0,0,76,20090218
2009,SAS,20,25,19,19,0,0,0,83,DET,24,16,18,21,0,0,0,79,20090219
2009,BOS,22,17,27,19,0,0,0,85,UTA,13,25,22,30,0,0,0,90,20090219
2009,ORL,21,28,28,15,0,0,0,92,CHA,18,17,26,19,0,0,0,80,20090220
2009,DEN,31,23,23,22,0,0,0,99,CHI,21,33,29,33,0,0,0,116,20090220
2009,DAL,28,23,13,22,0,0,0,86,HOU,19,25,30,19,0,0,0,93,20090220
2009,NOH,20,21,25,32,13,0,0,111,LAL,28,17,34,19,17,0,0,115,20090220
2009,SAC,27,27,27,34,0,0,0,115,MEM,28,22,28,28,0,0,0,106,20090220
2009,CLE,25,26,35,25,0,0,0,111,MIL,27,30,25,21,0,0,0,103,20090220
2009,IND,33,28,25,26,0,0,0,112,MIN,26,22,23,34,0,0,0,105,20090220
2009,WAS,20,25,35,27,0,0,0,107,NJN,18,24,23,31,0,0,0,96,20090220
2009,TOR,22,28,25,22,0,0,0,97,NYK,42,33,26,26,0,0,0,127,20090220
2009,OKC,23,34,36,25,0,0,0,118,PHO,38,41,24,37,0,0,0,140,20090220
2009,ATL,26,22,24,26,0,0,0,98,POR,23,27,30,28,0,0,0,108,20090220
2009,SAC,20,30,21,24,0,0,0,95,DAL,30,40,28,18,0,0,0,116,20090221
2009,OKC,38,32,24,26,0,0,0,120,GSW,34,36,31,32,0,0,0,133,20090221
2009,PHI,16,24,23,28,0,0,0,91,MIA,20,20,27,30,0,0,0,97,20090221
2009,NOH,21,30,25,12,0,0,0,88,UTA,28,33,23,18,0,0,0,102,20090221
2009,SAS,25,27,26,20,0,0,0,98,WAS,18,20,19,10,0,0,0,67,20090221
2009,DET,17,17,24,20,0,0,0,78,CLE,31,36,21,11,0,0,0,99,20090222
2009,CHA,20,22,14,22,0,0,0,78,HOU,27,17,29,26,0,0,0,99,20090222
2009,CHI,27,24,23,17,0,0,0,91,IND,27,25,23,23,0,0,0,98,20090222
2009,DEN,35,37,24,21,0,0,0,117,MIL,36,33,27,24,0,0,0,120,20090222
2009,LAL,29,25,24,33,0,0,0,111,MIN,26,24,30,28,0,0,0,108,20090222
2009,MIA,24,22,26,27,0,0,0,99,ORL,39,25,27,31,0,0,0,122,20090222
2009,BOS,38,30,28,32,0,0,0,128,PHO,33,21,29,25,0,0,0,108,20090222
2009,LAC,16,23,29,19,0,0,0,87,POR,38,27,27,24,0,0,0,116,20090222
2009,NYK,27,26,21,26,0,0,0,100,TOR,27,30,25,29,0,0,0,111,20090222
2009,BOS,29,31,26,28,0,0,0,114,DEN,20,17,21,18,0,0,0,76,20090223
2009,GSW,27,28,24,26,0,0,0,105,LAC,27,33,29,29,0,0,0,118,20090223
2009,PHI,31,20,24,21,0,0,0,96,NJN,19,32,23,24,0,0,0,98,20090223
2009,IND,20,31,36,32,0,0,0,119,NYK,23,28,42,30,0,0,0,123,20090223
2009,NOH,29,32,23,28,0,0,0,112,SAC,24,23,27,31,0,0,0,105,20090223
2009,ATL,24,28,17,20,0,0,0,89,UTA,31,35,27,15,0,0,0,108,20090223
2009,ORL,27,27,28,20,0,0,0,102,CHI,30,33,24,33,0,0,0,120,20090224
2009,MEM,16,20,20,23,0,0,0,79,CLE,27,31,18,18,0,0,0,94,20090224
2009,POR,21,22,26,25,0,0,0,94,HOU,31,29,18,20,0,0,0,98,20090224
2009,DET,25,26,17,23,0,0,0,91,MIA,24,28,28,23,0,0,0,103,20090224
2009,LAL,32,24,19,32,0,0,0,107,OKC,22,22,24,25,0,0,0,93,20090224
2009,CHA,27,28,29,18,0,0,0,102,PHO,29,30,35,18,0,0,0,112,20090224
2009,DAL,19,25,14,18,0,0,0,76,SAS,32,18,19,24,0,0,0,93,20090224
2009,MIN,37,19,26,28,0,0,0,110,TOR,25,27,32,34,0,0,0,118,20090224
2009,MIL,23,18,32,23,0,0,0,96,DAL,33,32,25,26,0,0,0,116,20090225
2009,ATL,33,20,25,31,0,0,0,109,DEN,28,32,32,18,0,0,0,110,20090225
2009,MEM,29,22,25,23,0,0,0,99,IND,30,30,22,22,0,0,0,104,20090225
2009,BOS,22,28,22,19,0,0,0,91,LAC,27,19,25,22,0,0,0,93,20090225
2009,UTA,23,28,32,37,0,0,0,120,MIN,26,29,26,22,0,0,0,103,20090225
2009,CHI,26,23,29,21,0,0,0,99,NJN,25,25,24,37,0,0,0,111,20090225
2009,DET,13,29,22,23,0,0,0,87,NOH,22,21,22,25,0,0,0,90,20090225
2009,ORL,25,32,24,33,0,0,0,114,NYK,15,28,28,38,0,0,0,109,20090225
2009,CHA,30,25,23,20,0,0,0,98,SAC,20,21,19,31,0,0,0,91,20090225
2009,POR,20,25,18,21,0,0,0,84,SAS,29,19,26,25,0,0,0,99,20090225
2009,PHI,26,30,26,24,0,0,0,106,WAS,29,24,14,31,0,0,0,98,20090225
2009,CLE,11,29,10,24,0,0,0,74,HOU,19,26,23,25,0,0,0,93,20090226
2009,PHO,26,29,26,25,0,0,0,106,LAL,39,31,32,30,0,0,0,132,20090226
2009,MIA,15,17,21,30,0,0,0,83,ATL,19,17,28,27,0,0,0,91,20090227
2009,IND,18,31,26,24,0,0,0,99,BOS,26,22,29,27,0,0,0,104,20090227
2009,OKC,22,21,26,26,13,0,0,108,DAL,24,24,16,31,15,0,0,110,20090227
2009,LAL,19,21,23,16,0,0,0,79,DEN,16,30,20,24,0,0,0,90,20090227
2009,CHA,25,36,28,23,0,0,0,112,GSW,24,31,31,23,0,0,0,109,20090227
2009,POR,23,25,29,25,0,0,0,102,MIN,21,19,18,24,0,0,0,82,20090227
2009,MIL,18,17,26,33,0,0,0,94,NOH,29,21,25,20,0,0,0,95,20090227
2009,PHI,29,25,23,31,0,0,0,108,NYK,11,26,34,32,0,0,0,103,20090227
2009,DET,20,23,28,22,0,0,0,93,ORL,24,27,14,20,0,0,0,85,20090227
2009,TOR,30,37,25,21,0,0,0,113,PHO,37,31,28,37,0,0,0,133,20090227
2009,LAC,18,21,21,26,0,0,0,86,SAC,27,25,26,20,0,0,0,98,20090227
2009,CLE,27,18,32,20,0,0,0,97,SAS,13,25,18,30,0,0,0,86,20090227
2009,CHI,18,27,29,16,0,0,0,90,WAS,27,22,34,30,0,0,0,113,20090227
2009,HOU,31,27,30,14,0,0,0,102,CHI,26,29,16,34,0,0,0,105,20090228
2009,CHA,17,28,34,21,0,0,0,100,LAC,29,22,20,24,0,0,0,95,20090228
2009,OKC,29,27,21,22,0,0,0,99,MEM,17,28,16,31,0,0,0,92,20090228
2009,NYK,34,33,31,17,0,0,0,115,MIA,22,37,24,37,0,0,0,120,20090228
2009,WAS,17,23,30,23,0,0,0,93,MIL,30,25,28,26,0,0,0,109,20090228
2009,ORL,26,19,25,36,0,0,0,106,PHI,32,25,23,20,0,0,0,100,20090228
2009,SAC,25,25,23,16,0,0,0,89,UTA,32,22,25,23,0,0,0,102,20090228
2009,CLE,30,23,14,21,0,0,0,88,ATL,23,20,25,19,0,0,0,87,20090301
2009,DET,20,35,22,28,0,0,0,105,BOS,22,25,23,25,0,0,0,95,20090301
2009,TOR,24,29,22,23,0,0,0,98,DAL,27,33,30,19,0,0,0,109,20090301
2009,UTA,34,29,24,25,0,0,0,112,GSW,29,27,29,19,0,0,0,104,20090301
2009,DEN,29,12,34,19,0,0,0,94,IND,28,17,23,32,0,0,0,100,20090301
2009,HOU,29,25,29,22,0,0,0,105,MIN,23,30,16,25,0,0,0,94,20090301
2009,NOH,22,26,28,23,0,0,0,99,NJN,18,23,34,21,0,0,0,96,20090301
2009,LAL,26,30,25,30,0,0,0,111,PHO,34,32,25,27,0,0,0,118,20090301
2009,SAS,21,16,21,26,0,0,0,84,POR,33,31,16,22,0,0,0,102,20090301
2009,SAS,26,23,31,26,0,0,0,106,LAC,21,15,23,19,0,0,0,78,20090302
2009,CLE,30,28,18,31,0,0,0,107,MIA,26,29,27,18,0,0,0,100,20090302
2009,DAL,23,21,15,28,0,0,0,87,OKC,23,25,31,17,0,0,0,96,20090302
2009,NOH,21,25,25,27,0,0,0,98,PHI,14,31,22,24,0,0,0,91,20090302
2009,ATL,24,22,25,27,0,0,0,98,WAS,22,23,18,26,0,0,0,89,20090302
2009,CHI,24,19,19,18,0,0,0,80,CHA,32,24,23,17,0,0,0,96,20090303
2009,DEN,26,28,20,21,0,0,0,95,DET,26,18,30,26,0,0,0,100,20090303
2009,TOR,26,23,23,25,0,0,0,97,HOU,20,37,20,30,0,0,0,107,20090303
2009,MEM,19,28,20,22,0,0,0,89,LAL,32,20,26,21,0,0,0,99,20090303
2009,NJN,19,20,22,38,0,0,0,99,MIL,21,24,22,28,0,0,0,95,20090303
2009,GSW,36,30,25,27,0,0,0,118,MIN,18,19,35,22,0,0,0,94,20090303
2009,PHO,29,27,25,18,0,0,0,99,ORL,24,32,22,33,0,0,0,111,20090303
2009,IND,32,33,28,24,0,0,0,117,SAC,27,24,27,31,0,0,0,109,20090303
2009,GSW,26,19,17,26,0,0,0,88,CHI,20,31,24,35,0,0,0,110,20090304
2009,MIL,20,19,19,15,0,0,0,73,CLE,22,26,24,19,0,0,0,91,20090304
2009,SAS,31,26,19,26,0,0,0,102,DAL,29,27,27,24,0,0,0,107,20090304
2009,MEM,30,22,33,33,0,0,0,118,LAC,26,27,21,21,0,0,0,95,20090304
2009,PHO,29,32,34,34,0,0,0,129,MIA,40,27,37,31,0,0,0,135,20090304
2009,BOS,27,31,34,23,0,0,0,115,NJN,20,31,30,30,0,0,0,111,20090304
2009,ATL,26,23,26,30,0,0,0,105,NYK,22,29,33,25,0,0,0,109,20090304
2009,WAS,26,17,19,21,0,0,0,83,OKC,20,24,24,20,0,0,0,88,20090304
2009,IND,26,33,27,19,0,0,0,105,POR,20,32,26,29,0,0,0,107,20090304
2009,HOU,26,20,22,26,0,0,0,94,UTA,22,26,27,26,0,0,0,101,20090304
2009,POR,18,26,26,20,0,0,0,90,DEN,32,21,28,25,0,0,0,106,20090305
2009,DAL,21,24,22,21,0,0,0,88,NOH,24,21,30,29,0,0,0,104,20090305
2009,CLE,19,24,26,25,0,0,0,94,BOS,21,24,33,27,0,0,0,105,20090306
2009,ATL,21,29,20,21,0,0,0,91,CHA,36,23,21,18,0,0,0,98,20090306
2009,MIL,26,26,28,22,0,0,0,102,CHI,25,38,22,32,0,0,0,117,20090306
2009,GSW,16,24,26,25,0,0,0,91,DET,33,30,22,23,0,0,0,108,20090306
2009,PHO,18,28,30,36,0,0,0,112,HOU,23,33,25,35,0,0,0,116,20090306
2009,MIN,17,19,23,31,0,0,0,90,LAL,22,25,30,33,0,0,0,110,20090306
2009,NJN,29,30,27,16,0,0,0,102,ORL,32,28,23,22,0,0,0,105,20090306
2009,WAS,15,19,19,25,0,0,0,78,SAS,24,22,33,21,0,0,0,100,20090306
2009,MIA,22,34,30,22,0,0,0,108,TOR,24,26,26,26,0,0,0,102,20090306
2009,DEN,24,23,22,22,0,0,0,91,UTA,16,21,36,24,0,0,0,97,20090306
2009,DET,26,17,17,23,0,0,0,83,ATL,19,22,22,24,0,0,0,87,20090307
2009,MIA,14,22,25,28,0,0,0,89,CLE,28,22,20,29,0,0,0,99,20090307
2009,WAS,26,25,20,32,0,0,0,103,DAL,20,31,30,38,0,0,0,119,20090307
2009,IND,25,26,33,22,0,0,0,106,LAC,30,34,25,16,0,0,0,105,20090307
2009,PHI,27,24,28,31,0,0,0,110,MEM,26,29,24,26,0,0,0,105,20090307
2009,GSW,28,25,32,35,0,0,0,120,MIL,33,29,32,33,0,0,0,127,20090307
2009,OKC,18,31,23,18,0,0,0,90,NOH,31,22,23,32,0,0,0,108,20090307
2009,CHA,32,27,22,33,0,0,0,114,NYK,31,26,15,33,0,0,0,105,20090307
2009,MIN,22,24,24,23,0,0,0,93,POR,26,21,24,24,0,0,0,95,20090307
2009,ORL,22,29,18,17,0,0,0,86,BOS,15,18,23,23,0,0,0,79,20090308
2009,MEM,19,18,20,26,0,0,0,83,HOU,28,27,20,18,0,0,0,93,20090308
2009,NYK,30,27,20,24,0,0,0,101,NJN,27,26,26,27,0,0,0,106,20090308
2009,PHI,24,12,16,22,0,0,0,74,OKC,18,30,18,23,0,0,0,89,20090308
2009,DEN,25,24,26,31,0,0,0,106,SAC,35,26,24,29,0,0,0,114,20090308
2009,PHO,30,15,29,24,0,0,0,98,SAS,30,28,20,25,0,0,0,103,20090308
2009,UTA,29,20,32,28,0,0,0,109,TOR,24,24,39,14,0,0,0,101,20090308
2009,NOH,28,12,20,19,0,0,0,79,ATL,20,27,20,22,0,0,0,89,20090309
2009,HOU,18,27,29,23,0,0,0,97,DEN,27,13,22,33,0,0,0,95,20090309
2009,ORL,21,24,26,23,0,0,0,94,DET,21,21,31,25,0,0,0,98,20090309
2009,CHI,26,26,22,30,13,10,0,127,MIA,22,32,30,20,13,13,0,130,20090309
2009,WAS,27,22,30,31,0,0,0,110,MIN,24,20,29,26,0,0,0,99,20090309
2009,LAL,16,22,18,38,0,0,0,94,POR,25,36,23,27,0,0,0,111,20090309
2009,UTA,29,25,28,30,0,0,0,112,IND,22,26,32,20,0,0,0,100,20090310
2009,CLE,17,17,18,35,0,0,0,87,LAC,24,24,21,14,0,0,0,83,20090310
2009,NYK,29,27,32,32,0,0,0,120,MIL,31,34,19,28,0,0,0,112,20090310
2009,DAL,33,25,34,30,0,0,0,122,PHO,30,32,25,30,0,0,0,117,20090310
2009,OKC,27,28,29,15,0,0,0,99,SAC,26,29,21,22,0,0,0,98,20090310
2009,CHA,29,17,25,15,0,0,0,86,SAS,23,23,25,29,0,0,0,100,20090310
2009,UTA,18,24,33,18,0,0,0,93,ATL,25,30,18,27,0,0,0,100,20090311
2009,OKC,19,25,26,29,0,0,0,99,DEN,31,22,30,29,0,0,0,112,20090311
2009,NYK,28,20,23,30,15,0,0,116,DET,28,28,25,20,10,0,0,111,20090311
2009,NJN,28,39,20,25,0,0,0,112,GSW,30,23,32,31,0,0,0,116,20090311
2009,LAL,24,16,27,35,0,0,0,102,HOU,24,27,19,26,0,0,0,96,20090311
2009,BOS,32,23,18,26,0,0,0,99,MIA,31,19,32,25,0,0,0,107,20090311
2009,MEM,14,26,21,18,0,0,0,79,MIN,35,15,23,31,0,0,0,104,20090311
2009,CHI,13,23,17,26,0,0,0,79,ORL,26,22,37,22,0,0,0,107,20090311
2009,TOR,19,20,35,32,0,0,0,106,PHI,19,37,36,23,0,0,0,115,20090311
2009,DAL,24,30,20,19,0,0,0,93,POR,25,19,23,22,0,0,0,89,20090311
2009,NOH,22,23,40,24,0,0,0,109,WAS,28,18,22,30,0,0,0,98,20090311
2009,CLE,30,33,26,30,0,0,0,119,PHO,27,35,31,18,0,0,0,111,20090312
2009,LAL,35,18,25,24,0,0,0,102,SAS,17,21,32,25,0,0,0,95,20090312
2009,IND,29,19,16,23,0,0,0,87,ATL,22,23,30,26,0,0,0,101,20090313
2009,MEM,27,17,25,23,0,0,0,92,BOS,21,26,29,26,0,0,0,102,20090313
2009,HOU,21,25,24,21,0,0,0,91,CHA,21,27,17,21,0,0,0,86,20090313
2009,DAL,31,23,24,32,0,0,0,110,GSW,29,31,29,30,0,0,0,119,20090313
2009,NOH,14,25,27,29,0,0,0,95,MIL,14,24,25,23,0,0,0,86,20090313
2009,NYK,25,21,28,28,0,0,0,102,MIN,19,29,21,25,0,0,0,94,20090313
2009,CHI,23,24,22,32,0,0,0,101,PHI,22,28,30,24,0,0,0,104,20090313
2009,NJN,26,25,26,23,0,0,0,100,POR,20,27,24,38,0,0,0,109,20090313
2009,CLE,28,32,24,32,10,0,0,126,SAC,32,27,39,18,7,0,0,123,20090313
2009,DET,24,16,28,20,11,0,0,99,TOR,21,24,12,31,7,0,0,95,20090313
2009,ORL,30,30,21,31,0,0,0,112,WAS,25,27,23,28,0,0,0,103,20090313
2009,NOH,22,17,18,22,0,0,0,79,CHI,27,26,28,16,0,0,0,97,20090314
2009,LAC,17,29,25,23,0,0,0,94,DEN,24,27,34,22,0,0,0,107,20090314
2009,SAS,22,22,20,24,0,0,0,88,HOU,22,15,26,22,0,0,0,85,20090314
2009,UTA,29,26,25,27,8,10,4,129,MIA,19,32,32,24,8,10,15,140,20090314
2009,CHA,25,26,28,21,0,0,0,100,MIN,32,34,21,21,0,0,0,108,20090314
2009,OKC,27,25,20,23,0,0,0,95,PHO,18,28,26,34,0,0,0,106,20090314
2009,POR,18,21,22,19,0,0,0,80,ATL,21,21,30,26,0,0,0,98,20090315
2009,NYK,25,18,29,21,0,0,0,93,CLE,24,26,24,24,0,0,0,98,20090315
2009,MEM,26,31,16,16,0,0,0,89,DET,20,20,26,18,0,0,0,84,20090315
2009,PHO,42,32,46,34,0,0,0,154,GSW,36,36,25,33,0,0,0,130,20090315
2009,NJN,30,24,24,27,0,0,0,105,LAC,33,32,23,19,0,0,0,107,20090315
2009,DAL,28,26,26,20,0,0,0,100,LAL,37,29,21,20,0,0,0,107,20090315
2009,BOS,25,16,22,14,0,0,0,77,MIL,22,19,24,21,0,0,0,86,20090315
2009,UTA,20,23,24,20,0,0,0,87,ORL,30,27,28,20,0,0,0,105,20090315
2009,MIA,22,21,25,9,0,0,0,77,PHI,29,17,15,24,0,0,0,85,20090315
2009,IND,26,24,19,18,0,0,0,87,TOR,24,29,37,20,0,0,0,110,20090315
2009,SAC,29,26,28,21,0,0,0,104,WAS,37,29,21,19,0,0,0,106,20090315
2009,TOR,22,21,29,14,0,0,0,86,CHA,27,30,32,23,0,0,0,112,20090316
2009,NJN,20,23,29,24,0,0,0,96,DEN,30,19,34,38,0,0,0,121,20090316
2009,POR,29,26,18,30,0,0,0,103,MEM,20,28,18,26,0,0,0,92,20090316
2009,HOU,23,21,23,28,0,0,0,95,NOH,23,24,17,20,0,0,0,84,20090316
2009,SAS,29,13,21,13,0,0,0,76,OKC,14,24,23,17,0,0,0,78,20090316
2009,SAC,31,28,27,11,0,0,0,97,ATL,26,42,24,27,0,0,0,119,20090317
2009,BOS,26,29,35,31,0,0,0,121,CHI,34,20,35,38,0,0,0,127,20090317
2009,ORL,23,27,25,18,0,0,0,93,CLE,28,25,19,25,0,0,0,97,20090317
2009,DET,21,24,21,35,0,0,0,101,DAL,29,25,26,23,0,0,0,103,20090317
2009,LAC,27,24,30,39,0,0,0,120,GSW,25,34,33,35,0,0,0,127,20090317
2009,PHI,20,30,12,32,0,0,0,94,LAL,24,26,23,20,0,0,0,93,20090317
2009,MIN,21,14,25,26,0,0,0,86,SAS,22,17,29,25,0,0,0,93,20090317
2009,WAS,15,21,25,27,0,0,0,88,UTA,25,21,30,27,0,0,0,103,20090317
2009,MIA,21,33,22,24,8,0,0,108,BOS,34,15,26,25,12,0,0,112,20090318
2009,SAC,25,21,24,18,0,0,0,88,CHA,33,18,27,26,0,0,0,104,20090318
2009,DET,18,20,27,17,9,10,0,101,HOU,20,22,22,18,9,15,0,106,20090318
2009,POR,27,23,26,19,0,0,0,95,IND,16,23,16,30,0,0,0,85,20090318
2009,WAS,32,32,29,15,0,0,0,108,LAC,27,29,37,30,0,0,0,123,20090318
2009,DEN,26,27,28,30,0,0,0,111,MEM,35,24,32,18,0,0,0,109,20090318
2009,ORL,36,29,17,24,0,0,0,106,MIL,20,15,25,20,0,0,0,80,20090318
2009,MIN,16,28,22,27,0,0,0,93,NOH,24,24,26,20,0,0,0,94,20090318
2009,NJN,20,35,35,25,0,0,0,115,NYK,23,21,26,19,0,0,0,89,20090318
2009,CHI,22,29,29,23,0,0,0,103,OKC,29,27,19,21,0,0,0,96,20090318
2009,PHI,34,32,25,25,0,0,0,116,PHO,31,32,30,33,0,0,0,126,20090318
2009,DAL,29,16,27,15,0,0,0,87,ATL,23,33,20,19,0,0,0,95,20090319
2009,POR,19,17,21,29,6,0,0,92,CLE,12,22,31,21,11,0,0,97,20090319
2009,GSW,28,23,22,33,0,0,0,106,LAL,26,26,30,32,0,0,0,114,20090319
2009,WAS,31,20,25,29,0,0,0,105,DEN,28,30,28,30,0,0,0,116,20090320
2009,LAC,27,23,19,21,0,0,0,90,DET,23,23,28,34,0,0,0,108,20090320
2009,PHI,33,23,23,32,0,0,0,111,GSW,31,31,29,28,0,0,0,119,20090320
2009,MIN,16,21,29,22,0,0,0,88,HOU,22,26,35,24,0,0,0,107,20090320
2009,DAL,25,26,26,17,0,0,0,94,IND,23,23,30,16,0,0,0,92,20090320
2009,MIA,17,22,24,25,0,0,0,88,NJN,21,30,16,29,0,0,0,96,20090320
2009,MEM,21,19,28,16,0,0,0,84,NOH,21,20,26,29,0,0,0,96,20090320
2009,SAC,28,34,35,24,0,0,0,121,NYK,22,21,28,23,0,0,0,94,20090320
2009,UTA,23,26,28,24,0,0,0,101,OKC,24,16,26,28,0,0,0,94,20090320
2009,BOS,16,21,27,16,0,0,0,80,SAS,22,20,21,14,0,0,0,77,20090320
2009,CHA,33,19,30,20,0,0,0,102,TOR,24,26,20,19,0,0,0,89,20090320
2009,IND,23,30,33,22,0,0,0,108,CHA,25,20,9,29,0,0,0,83,20090321
2009,LAL,24,24,33,36,0,0,0,117,CHI,34,28,25,22,0,0,0,109,20090321
2009,ATL,13,22,28,33,0,0,0,96,CLE,27,26,26,23,0,0,0,102,20090321
2009,BOS,21,31,26,27,0,0,0,105,MEM,21,27,17,22,0,0,0,87,20090321
2009,POR,18,21,30,27,0,0,0,96,MIL,24,19,17,24,0,0,0,84,20090321
2009,NYK,28,24,28,23,0,0,0,103,ORL,29,30,27,24,0,0,0,110,20090321
2009,WAS,16,37,22,21,0,0,0,96,PHO,31,26,33,38,0,0,0,128,20090321
2009,MIA,20,23,24,34,0,0,0,101,DET,23,24,26,23,0,0,0,96,20090322
2009,OKC,26,31,27,13,0,0,0,97,MIN,16,23,14,37,0,0,0,90,20090322
2009,CLE,27,21,23,25,0,0,0,96,NJN,21,17,17,33,0,0,0,88,20090322
2009,GSW,20,17,21,31,0,0,0,89,NOH,27,27,24,21,0,0,0,99,20090322
2009,PHI,35,34,26,17,0,0,0,112,SAC,17,26,31,26,0,0,0,100,20090322
2009,HOU,22,29,13,23,0,0,0,87,SAS,27,20,16,22,0,0,0,85,20090322
2009,LAC,20,20,14,22,0,0,0,76,TOR,33,21,23,23,0,0,0,100,20090322
2009,MIN,18,18,28,33,0,0,0,97,ATL,23,35,23,28,0,0,0,109,20090323
2009,LAC,18,24,18,17,0,0,0,77,BOS,31,13,26,20,0,0,0,90,20090323
2009,MEM,16,24,22,20,0,0,0,82,MIA,30,26,24,14,0,0,0,94,20090323
2009,ORL,24,26,20,36,0,0,0,106,NYK,24,30,25,23,0,0,0,102,20090323
2009,DEN,22,38,32,23,0,0,0,115,PHO,29,34,25,30,0,0,0,118,20090323
2009,PHI,31,27,17,23,16,0,0,114,POR,26,18,28,26,10,0,0,108,20090323
2009,CHI,19,22,33,27,0,0,0,101,WAS,27,20,20,32,0,0,0,99,20090323
2009,DET,18,25,25,23,0,0,0,91,CHI,22,21,32,24,0,0,0,99,20090324
2009,LAL,37,25,28,17,0,0,0,107,OKC,20,18,34,17,0,0,0,89,20090324
2009,GSW,25,29,24,28,0,0,0,106,SAS,28,24,27,28,0,0,0,107,20090324
2009,HOU,21,22,24,19,0,0,0,86,UTA,23,23,29,24,0,0,0,99,20090324
2009,SAS,28,25,21,28,0,0,0,102,ATL,22,26,26,18,0,0,0,92,20090325
2009,NJN,17,23,20,27,0,0,0,87,CLE,26,18,24,30,0,0,0,98,20090325
2009,GSW,26,30,27,23,0,0,0,106,DAL,37,26,32,33,0,0,0,128,20090325
2009,MIA,24,25,19,20,0,0,0,88,IND,27,21,19,23,0,0,0,90,20090325
2009,DEN,28,18,31,24,0,0,0,101,NOH,21,24,23,20,0,0,0,88,20090325
2009,LAC,28,37,30,32,13,0,0,140,NYK,44,22,27,34,8,0,0,135,20090325
2009,BOS,21,18,23,20,0,0,0,82,ORL,25,22,23,14,0,0,0,84,20090325
2009,MIN,16,27,19,26,0,0,0,88,PHI,14,23,28,31,0,0,0,96,20090325
2009,UTA,31,27,25,31,0,0,0,114,PHO,32,20,37,29,0,0,0,118,20090325
2009,MIL,20,24,27,35,0,0,0,106,TOR,25,40,29,21,0,0,0,115,20090325
2009,CHA,29,28,14,22,0,0,0,93,WAS,24,26,23,22,0,0,0,95,20090325
2009,MIA,25,24,14,24,0,0,0,87,CHI,26,21,32,27,0,0,0,106,20090326
2009,LAL,25,14,31,22,0,0,0,92,DET,12,30,13,22,0,0,0,77,20090326
2009,PHO,27,30,22,30,0,0,0,109,POR,29,36,35,29,0,0,0,129,20090326
2009,BOS,28,24,25,22,0,0,0,99,ATL,25,17,18,33,0,0,0,93,20090327
2009,MIN,18,21,25,21,0,0,0,85,CLE,27,29,23,28,0,0,0,107,20090327
2009,DEN,25,32,29,17,0,0,0,103,DAL,26,26,24,25,0,0,0,101,20090327
2009,LAL,31,20,30,22,0,0,0,103,NJN,25,24,21,25,0,0,0,95,20090327
2009,NOH,26,23,16,28,0,0,0,93,NYK,23,19,35,26,0,0,0,103,20090327
2009,MIL,20,23,27,24,0,0,0,94,ORL,21,28,31,30,0,0,0,110,20090327
2009,CHA,29,21,23,27,0,0,0,100,PHI,23,10,27,35,0,0,0,95,20090327
2009,MEM,32,27,23,31,0,0,0,113,SAC,22,15,30,28,0,0,0,95,20090327
2009,LAC,19,27,26,26,0,0,0,98,SAS,39,20,37,15,0,0,0,111,20090327
2009,OKC,18,22,25,31,0,0,0,96,TOR,28,23,33,28,0,0,0,112,20090327
2009,NYK,27,17,23,18,0,0,0,85,CHA,20,30,23,23,0,0,0,96,20090328
2009,IND,35,23,24,24,0,0,0,106,CHI,21,33,33,25,0,0,0,112,20090328
2009,GSW,27,30,17,42,0,0,0,116,DEN,28,38,38,25,0,0,0,129,20090328
2009,LAC,17,19,23,34,0,0,0,93,HOU,30,27,28,25,0,0,0,110,20090328
2009,MIL,23,20,20,22,0,0,0,85,MIA,28,30,19,25,0,0,0,102,20090328
2009,MEM,16,20,11,19,0,0,0,66,POR,25,23,20,18,0,0,0,86,20090328
2009,PHO,24,11,23,32,9,0,0,99,UTA,27,25,17,21,14,0,0,104,20090328
2009,DET,29,31,24,14,0,0,0,98,WAS,26,27,19,24,0,0,0,96,20090328
2009,LAL,13,26,19,18,0,0,0,76,ATL,20,20,32,14,0,0,0,86,20090329
2009,OKC,25,20,23,16,0,0,0,84,BOS,20,25,26,32,0,0,0,103,20090329
2009,DAL,30,19,11,14,0,0,0,74,CLE,20,27,30,25,0,0,0,102,20090329
2009,PHI,31,27,25,14,0,0,0,97,DET,27,30,22,22,0,0,0,101,20090329
2009,WAS,28,24,24,39,0,0,0,115,IND,30,29,33,32,0,0,0,124,20090329
2009,NJN,24,24,23,28,0,0,0,99,MIN,29,29,26,24,0,0,0,108,20090329
2009,SAS,25,22,16,23,0,0,0,86,NOH,19,24,25,22,0,0,0,90,20090329
2009,PHO,33,31,32,22,0,0,0,118,SAC,35,35,35,21,0,0,0,126,20090329
2009,CHI,21,23,33,42,10,0,0,129,TOR,30,25,35,29,15,0,0,134,20090329
2009,MEM,27,30,20,37,0,0,0,114,GSW,27,26,31,25,0,0,0,109,20090330
2009,ORL,26,20,24,31,0,0,0,101,MIA,21,22,26,26,0,0,0,95,20090330
2009,MIL,32,28,24,23,0,0,0,107,NJN,13,24,16,25,0,0,0,78,20090330
2009,NYK,24,22,32,26,0,0,0,104,UTA,36,31,19,26,0,0,0,112,20090330
2009,LAL,24,20,20,20,0,0,0,84,CHA,25,18,25,26,0,0,0,94,20090331
2009,DET,19,25,14,15,0,0,0,73,CLE,12,32,18,17,0,0,0,79,20090331
2009,NYK,22,30,25,27,0,0,0,104,DEN,34,31,19,27,0,0,0,111,20090331
2009,CHI,24,28,27,26,0,0,0,105,IND,28,22,26,31,0,0,0,107,20090331
2009,DAL,36,25,24,23,0,0,0,108,MIN,21,26,22,19,0,0,0,88,20090331
2009,ATL,16,21,32,16,0,0,0,85,PHI,28,23,26,21,0,0,0,98,20090331
2009,UTA,25,23,27,29,0,0,0,104,POR,39,22,33,31,0,0,0,125,20090331
2009,NOH,32,32,22,25,0,0,0,111,SAC,38,26,26,20,0,0,0,110,20090331
2009,OKC,29,25,27,15,0,0,0,96,SAS,32,16,27,20,0,0,0,95,20090331
2009,CHA,33,18,26,16,8,8,0,109,BOS,26,28,17,22,8,10,0,111,20090401
2009,MIA,27,20,26,23,0,0,0,96,DAL,26,20,25,27,0,0,0,98,20090401
2009,SAC,40,36,30,26,9,0,0,141,GSW,37,30,43,22,11,0,0,143,20090401
2009,NOH,29,22,27,26,0,0,0,104,LAC,25,23,21,29,0,0,0,98,20090401
2009,WAS,27,23,23,34,0,0,0,107,MEM,27,30,31,24,0,0,0,112,20090401
2009,LAL,22,33,25,24,0,0,0,104,MIL,31,26,24,17,0,0,0,98,20090401
2009,DET,21,27,27,23,0,0,0,98,NJN,32,27,27,25,0,0,0,111,20090401
2009,TOR,32,21,27,19,0,0,0,99,ORL,28,24,21,22,0,0,0,95,20090401
2009,HOU,30,26,32,21,0,0,0,109,PHO,33,34,21,26,0,0,0,114,20090401
2009,UTA,24,19,29,32,0,0,0,104,DEN,21,33,29,31,0,0,0,114,20090402
2009,MIL,24,35,20,16,0,0,0,95,PHI,24,26,30,25,0,0,0,105,20090402
2009,CLE,19,22,29,31,0,0,0,101,WAS,22,27,31,29,0,0,0,109,20090402
2009,ATL,23,25,23,21,0,0,0,92,BOS,21,31,28,24,0,0,0,104,20090403
2009,MIA,16,29,22,30,0,0,0,97,CHA,28,17,26,21,0,0,0,92,20090403
2009,NOH,20,26,25,32,0,0,0,103,GSW,31,24,19,37,0,0,0,111,20090403
2009,SAS,35,28,30,33,0,0,0,126,IND,25,30,26,40,0,0,0,121,20090403
2009,HOU,21,23,18,19,0,0,0,81,LAL,20,24,23,26,0,0,0,93,20090403
2009,DAL,32,29,24,17,0,0,0,102,MEM,27,34,23,23,0,0,0,107,20090403
2009,POR,25,22,29,31,0,0,0,107,OKC,14,21,15,22,0,0,0,72,20090403
2009,CLE,22,16,22,27,0,0,0,87,ORL,27,28,37,24,0,0,0,116,20090403
2009,SAC,25,40,28,18,0,0,0,111,PHO,39,30,37,33,0,0,0,139,20090403
2009,MIN,19,27,26,31,0,0,0,103,UTA,27,29,21,25,0,0,0,102,20090403
2009,ORL,22,18,22,26,0,0,0,88,ATL,18,26,17,21,0,0,0,82,20090404
2009,NJN,16,28,25,25,0,0,0,94,CHI,22,32,19,30,0,0,0,103,20090404
2009,LAC,21,26,29,28,0,0,0,104,DEN,32,34,30,24,0,0,0,120,20090404
2009,MEM,16,38,28,25,0,0,0,107,MIL,20,18,35,29,0,0,0,102,20090404
2009,TOR,23,25,29,25,0,0,0,102,NYK,30,20,23,22,0,0,0,95,20090404
2009,DET,19,31,24,16,0,0,0,90,PHI,21,25,22,27,0,0,0,95,20090404
2009,MIA,30,32,18,38,0,0,0,118,WAS,28,24,25,27,0,0,0,104,20090404
2009,SAS,27,15,21,18,0,0,0,81,CLE,28,27,23,23,0,0,0,101,20090405
2009,PHO,33,26,25,32,0,0,0,116,DAL,39,42,33,26,0,0,0,140,20090405
2009,CHA,17,27,25,28,0,0,0,97,DET,24,27,17,36,0,0,0,104,20090405
2009,POR,25,18,21,24,0,0,0,88,HOU,31,23,18,30,0,0,0,102,20090405
2009,LAC,17,27,12,29,0,0,0,85,LAL,30,24,14,20,0,0,0,88,20090405
2009,DEN,27,33,27,23,0,0,0,110,MIN,20,20,22,25,0,0,0,87,20090405
2009,PHI,20,19,12,16,0,0,0,67,NJN,18,32,18,28,0,0,0,96,20090405
2009,UTA,41,25,21,21,0,0,0,108,NOH,19,20,37,18,0,0,0,94,20090405
2009,IND,31,26,33,27,0,0,0,117,OKC,19,29,19,32,0,0,0,99,20090405
2009,GSW,18,32,36,19,0,0,0,105,SAC,23,19,27,31,0,0,0,100,20090405
2009,NYK,33,32,27,20,0,0,0,112,TOR,34,20,22,27,0,0,0,103,20090405
2009,PHI,19,30,32,17,0,0,0,98,CHA,28,35,16,22,0,0,0,101,20090407
2009,NYK,24,32,28,19,0,0,0,103,CHI,26,27,28,29,0,0,0,110,20090407
2009,ORL,22,16,21,24,0,0,0,83,HOU,25,22,20,26,0,0,0,93,20090407
2009,MIN,18,29,26,14,0,0,0,87,LAC,16,25,21,15,0,0,0,77,20090407
2009,POR,21,14,32,29,0,0,0,96,MEM,21,26,22,24,0,0,0,93,20090407
2009,NOH,27,13,14,25,14,0,0,93,MIA,19,11,18,31,8,0,0,87,20090407
2009,SAS,25,26,24,24,0,0,0,99,OKC,32,18,22,17,0,0,0,89,20090407
2009,LAL,31,40,25,26,0,0,0,122,SAC,37,18,31,18,0,0,0,104,20090407
2009,ATL,26,27,32,33,0,0,0,118,TOR,31,26,27,26,0,0,0,110,20090407
2009,NJN,31,20,27,26,0,0,0,104,BOS,21,37,23,25,0,0,0,106,20090408
2009,WAS,13,24,21,28,0,0,0,86,CLE,26,22,30,20,0,0,0,98,20090408
2009,UTA,17,28,29,27,0,0,0,101,DAL,28,33,32,37,0,0,0,130,20090408
2009,OKC,29,27,28,28,0,0,0,112,DEN,27,26,36,33,0,0,0,122,20090408
2009,MIN,26,32,20,27,0,0,0,105,GSW,27,34,12,24,0,0,0,97,20090408
2009,TOR,28,20,26,27,0,0,0,101,IND,37,37,41,15,0,0,0,130,20090408
2009,ATL,27,26,31,29,0,0,0,113,MIL,28,34,12,31,0,0,0,105,20090408
2009,PHO,26,23,26,30,0,0,0,105,NOH,32,19,14,35,0,0,0,100,20090408
2009,DET,37,26,28,22,0,0,0,113,NYK,20,19,24,23,0,0,0,86,20090408
2009,MEM,24,22,17,15,0,0,0,78,ORL,19,26,10,26,0,0,0,81,20090408
2009,POR,16,31,23,25,0,0,0,95,SAS,33,16,18,16,0,0,0,83,20090408
2009,PHI,29,21,22,27,0,0,0,99,CHI,22,28,32,31,0,0,0,113,20090409
2009,DEN,25,31,25,21,0,0,0,102,LAL,33,23,32,28,0,0,0,116,20090409
2009,HOU,30,19,36,30,0,0,0,115,SAC,33,21,20,24,0,0,0,98,20090409
2009,IND,36,24,24,34,0,0,0,118,ATL,34,28,28,32,0,0,0,122,20090410
2009,MIA,25,22,25,26,0,0,0,98,BOS,22,32,25,26,0,0,0,105,20090410
2009,NOH,17,22,22,31,0,0,0,92,DAL,30,19,28,23,0,0,0,100,20090410
2009,NJN,20,18,30,25,0,0,0,93,DET,27,27,24,22,0,0,0,100,20090410
2009,HOU,25,34,27,27,0,0,0,113,GSW,20,36,23,30,0,0,0,109,20090410
2009,SAC,13,19,20,26,0,0,0,78,LAC,35,23,25,26,0,0,0,109,20090410
2009,PHO,27,20,21,21,0,0,0,89,MEM,23,32,29,22,0,0,0,106,20090410
2009,CHA,17,20,24,20,0,0,0,81,OKC,27,21,16,20,0,0,0,84,20090410
2009,NYK,26,25,27,27,0,0,0,105,ORL,25,28,18,24,0,0,0,95,20090410
2009,CLE,23,29,24,26,0,0,0,102,PHI,19,27,24,22,0,0,0,92,20090410
2009,LAL,23,30,24,21,0,0,0,98,POR,24,25,32,25,0,0,0,106,20090410
2009,UTA,21,20,30,28,0,0,0,99,SAS,24,25,27,29,0,0,0,105,20090410
2009,WAS,16,21,29,34,0,0,0,100,TOR,20,21,22,35,0,0,0,98,20090410
2009,CHA,23,27,33,23,0,0,0,106,CHI,30,22,26,35,0,0,0,113,20090411
2009,DET,27,22,24,29,0,0,0,102,IND,28,24,26,28,0,0,0,106,20090411
2009,POR,17,29,17,24,0,0,0,87,LAC,17,14,25,16,0,0,0,72,20090411
2009,OKC,24,27,21,26,0,0,0,98,MIL,22,34,37,22,0,0,0,115,20090411
2009,PHO,31,26,24,29,0,0,0,110,MIN,8,35,21,33,0,0,0,97,20090411
2009,ORL,24,23,27,19,0,0,0,93,NJN,28,29,26,20,0,0,0,103,20090411
2009,GSW,28,36,29,25,0,0,0,118,UTA,31,20,25,32,0,0,0,108,20090411
2009,BOS,9,24,23,20,0,0,0,76,CLE,31,21,30,25,0,0,0,107,20090412
2009,MEM,15,22,22,16,0,0,0,75,LAL,23,25,22,22,0,0,0,92,20090412
2009,NYK,26,39,26,14,0,0,0,105,MIA,37,26,34,25,0,0,0,122,20090412
2009,DAL,13,31,25,23,0,0,0,92,NOH,22,23,24,33,0,0,0,102,20090412
2009,SAS,24,30,20,21,0,0,0,95,SAC,25,36,16,15,0,0,0,92,20090412
2009,PHI,22,31,27,24,0,0,0,104,TOR,27,26,28,30,0,0,0,111,20090412
2009,MIN,18,25,31,20,0,0,0,94,DAL,26,14,28,28,0,0,0,96,20090413
2009,SAC,33,25,21,19,0,0,0,98,DEN,25,37,24,32,0,0,0,118,20090413
2009,CHI,31,17,21,22,0,0,0,91,DET,31,25,19,13,0,0,0,88,20090413
2009,SAS,29,28,24,20,0,0,0,101,GSW,24,14,13,21,0,0,0,72,20090413
2009,NOH,22,13,11,20,0,0,0,66,HOU,19,28,20,19,0,0,0,86,20090413
2009,CLE,26,36,29,26,0,0,0,117,IND,27,20,37,25,0,0,0,109,20090413
2009,ORL,24,19,17,20,0,0,0,80,MIL,18,32,21,27,0,0,0,98,20090413
2009,CHA,25,21,26,15,0,0,0,87,NJN,20,28,19,24,0,0,0,91,20090413
2009,MEM,25,32,27,26,0,0,0,110,PHO,32,27,27,33,0,0,0,119,20090413
2009,OKC,15,16,24,28,0,0,0,83,POR,29,33,23,28,0,0,0,113,20090413
2009,LAC,17,26,21,21,0,0,0,85,UTA,30,26,27,23,0,0,0,106,20090413
2009,TOR,31,22,19,25,0,0,0,97,WAS,23,30,27,16,0,0,0,96,20090413
2009,MIA,21,13,30,15,0,0,0,79,ATL,18,20,26,17,0,0,0,81,20090414
2009,UTA,27,28,28,29,0,0,0,112,LAL,25,31,35,34,0,0,0,125,20090414
2009,BOS,27,23,28,22,0,0,0,100,PHI,26,32,25,15,0,0,0,98,20090414
2009,WAS,24,28,31,24,0,0,0,107,BOS,25,32,22,36,0,0,0,115,20090415
2009,TOR,32,29,23,25,0,0,0,109,CHI,18,31,20,29,0,0,0,98,20090415
2009,PHI,21,16,28,33,13,0,0,111,CLE,27,22,21,28,12,0,0,110,20090415
2009,HOU,19,31,20,14,0,0,0,84,DAL,26,16,23,30,0,0,0,95,20090415
2009,MIL,25,24,39,20,0,0,0,108,IND,24,32,16,43,0,0,0,115,20090415
2009,OKC,28,32,32,34,0,0,0,126,LAC,21,18,24,22,0,0,0,85,20090415
2009,ATL,21,22,26,21,0,0,0,90,MEM,22,31,19,26,0,0,0,98,20090415
2009,DET,22,19,20,27,8,0,0,96,MIA,24,22,21,21,14,0,0,102,20090415
2009,SAC,21,28,30,18,0,0,0,97,MIN,19,28,18,25,0,0,0,90,20090415
2009,NJN,16,24,18,15,0,0,0,73,NYK,24,28,29,21,0,0,0,102,20090415
2009,CHA,14,24,20,15,0,0,0,73,ORL,28,29,20,21,0,0,0,98,20090415
2009,GSW,36,20,34,23,0,0,0,113,PHO,24,32,30,31,0,0,0,117,20090415
2009,DEN,22,12,26,16,0,0,0,76,POR,23,30,18,33,0,0,0,104,20090415
2009,NOH,25,25,19,21,8,0,0,98,SAS,26,22,22,20,15,0,0,105,20090415
2009,CHI,28,25,18,26,8,0,0,105,BOS,28,16,28,25,6,0,0,103,20090418
2009,DET,25,20,20,19,0,0,0,84,CLE,30,27,21,24,0,0,0,102,20090418
2009,HOU,34,28,23,23,0,0,0,108,POR,23,21,14,23,0,0,0,81,20090418
2009,DAL,18,27,29,31,0,0,0,105,SAS,29,20,25,23,0,0,0,97,20090418
2009,MIA,21,18,18,7,0,0,0,64,ATL,24,35,17,14,0,0,0,90,20090419
2009,NOH,25,22,22,15,0,0,0,84,DEN,27,28,32,26,0,0,0,113,20090419
2009,UTA,19,21,33,27,0,0,0,100,LAL,30,32,24,27,0,0,0,113,20090419
2009,PHI,27,19,19,35,0,0,0,100,ORL,25,25,29,19,0,0,0,98,20090419
2009,CHI,29,32,26,28,0,0,0,115,BOS,35,23,30,30,0,0,0,118,20090420
2009,DAL,19,27,17,21,0,0,0,84,SAS,30,27,28,20,0,0,0,105,20090420
2009,DET,14,18,18,32,0,0,0,82,CLE,23,23,31,17,0,0,0,94,20090421
2009,UTA,29,26,23,31,0,0,0,109,LAL,41,25,23,30,0,0,0,119,20090421
2009,HOU,26,25,21,31,0,0,0,103,POR,28,25,19,35,0,0,0,107,20090421
2009,MIA,24,30,29,25,0,0,0,108,ATL,18,23,31,21,0,0,0,93,20090422
2009,NOH,25,19,27,22,0,0,0,93,DEN,27,25,29,27,0,0,0,108,20090422
2009,PHI,21,18,23,25,0,0,0,87,ORL,21,25,24,26,0,0,0,96,20090422
2009,BOS,32,27,24,24,0,0,0,107,CHI,21,16,21,28,0,0,0,86,20090423
2009,SAS,16,14,12,25,0,0,0,67,DAL,27,19,29,13,0,0,0,88,20090423
2009,LAL,17,22,29,18,0,0,0,86,UTA,26,17,17,28,0,0,0,88,20090423
2009,CLE,18,26,9,26,0,0,0,79,DET,18,19,16,15,0,0,0,68,20090424
2009,POR,15,22,22,24,0,0,0,83,HOU,21,27,18,20,0,0,0,86,20090424
2009,ORL,21,28,28,17,0,0,0,94,PHI,27,33,20,16,0,0,0,96,20090424
2009,SAS,29,26,16,19,0,0,0,90,DAL,32,19,29,19,0,0,0,99,20090425
2009,ATL,12,17,32,17,0,0,0,78,MIA,22,28,25,32,0,0,0,107,20090425
2009,DEN,26,21,25,21,0,0,0,93,NOH,21,29,27,18,0,0,0,95,20090425
2009,LAL,20,40,28,20,0,0,0,108,UTA,25,28,16,25,0,0,0,94,20090425
2009,BOS,19,27,24,26,14,8,0,118,CHI,18,27,20,31,14,11,0,121,20090426
2009,CLE,26,25,22,26,0,0,0,99,DET,27,15,18,18,0,0,0,78,20090426
2009,POR,22,22,26,18,0,0,0,88,HOU,30,20,14,25,0,0,0,89,20090426
2009,ORL,24,12,28,20,0,0,0,84,PHI,22,14,19,26,0,0,0,81,20090426
2009,UTA,26,17,20,33,0,0,0,96,LAL,26,30,26,25,0,0,0,107,20090427
2009,ATL,24,22,17,18,0,0,0,81,MIA,17,25,13,16,0,0,0,71,20090427
2009,DEN,36,25,27,33,0,0,0,121,NOH,15,24,11,13,0,0,0,63,20090427
2009,CHI,21,26,23,23,11,0,0,104,BOS,23,21,22,27,13,0,0,106,20090428
2009,PHI,20,19,21,18,0,0,0,78,ORL,21,24,24,22,0,0,0,91,20090428
2009,HOU,26,17,19,15,0,0,0,77,POR,29,21,14,24,0,0,0,88,20090428
2009,DAL,31,21,30,24,0,0,0,106,SAS,20,28,19,26,0,0,0,93,20090428
2009,MIA,20,20,30,21,0,0,0,91,ATL,24,39,22,21,0,0,0,106,20090429
2009,NOH,27,22,17,20,0,0,0,86,DEN,24,25,31,27,0,0,0,107,20090429
2009,BOS,26,31,19,25,8,9,9,127,CHI,37,22,24,18,8,9,10,128,20090430
2009,POR,19,18,19,20,0,0,0,76,HOU,21,31,22,18,0,0,0,92,20090430
2009,ORL,30,32,25,27,0,0,0,114,PHI,19,29,24,17,0,0,0,89,20090430
2009,ATL,18,24,14,16,0,0,0,72,MIA,32,19,27,20,0,0,0,98,20090501
2009,CHI,28,11,33,27,0,0,0,99,BOS,23,29,26,31,0,0,0,109,20090502
2009,MIA,18,18,16,26,0,0,0,78,ATL,20,29,19,23,0,0,0,91,20090503
2009,DAL,24,23,28,20,0,0,0,95,DEN,16,35,31,27,0,0,0,109,20090503
2009,ORL,24,30,24,17,0,0,0,95,BOS,19,17,26,28,0,0,0,90,20090504
2009,HOU,21,22,27,30,0,0,0,100,LAL,18,22,27,25,0,0,0,92,20090504
2009,ATL,21,23,17,11,0,0,0,72,CLE,25,24,28,22,0,0,0,99,20090505
2009,DAL,22,33,28,22,0,0,0,105,DEN,30,28,28,31,0,0,0,117,20090505
2009,ORL,21,25,18,30,0,0,0,94,BOS,26,35,25,26,0,0,0,112,20090506
2009,HOU,25,32,20,21,0,0,0,98,LAL,39,18,29,25,0,0,0,111,20090506
2009,ATL,17,18,20,30,0,0,0,85,CLE,26,33,26,20,0,0,0,105,20090507
2009,LAL,30,20,24,34,0,0,0,108,HOU,28,20,14,32,0,0,0,94,20090508
2009,BOS,18,23,28,27,0,0,0,96,ORL,22,31,25,39,0,0,0,117,20090508
2009,CLE,22,25,25,25,0,0,0,97,ATL,18,28,19,17,0,0,0,82,20090509
2009,DEN,20,28,31,27,0,0,0,106,DAL,20,25,35,25,0,0,0,105,20090509
2009,LAL,16,20,18,33,0,0,0,87,HOU,29,25,29,16,0,0,0,99,20090510
2009,BOS,25,23,31,16,0,0,0,95,ORL,28,18,25,23,0,0,0,94,20090510
2009,CLE,15,25,22,22,0,0,0,84,ATL,22,16,19,17,0,0,0,74,20090511
2009,DEN,34,29,27,27,0,0,0,117,DAL,23,30,32,34,0,0,0,119,20090511
2009,ORL,22,23,22,21,0,0,0,88,BOS,16,21,22,33,0,0,0,92,20090512
2009,HOU,24,15,15,24,0,0,0,78,LAL,35,29,30,24,0,0,0,118,20090512
2009,DAL,27,28,25,30,0,0,0,110,DEN,34,35,25,30,0,0,0,124,20090513
2009,LAL,15,21,29,15,0,0,0,80,HOU,27,25,22,21,0,0,0,95,20090514
2009,BOS,25,21,16,13,0,0,0,75,ORL,22,23,16,22,0,0,0,83,20090514
2009,ORL,27,18,21,35,0,0,0,101,BOS,17,21,23,21,0,0,0,82,20090517
2009,HOU,12,19,19,20,0,0,0,70,LAL,22,29,18,20,0,0,0,89,20090517
2009,DEN,31,23,22,27,0,0,0,103,LAL,23,32,19,31,0,0,0,105,20090519
2009,ORL,19,29,30,29,0,0,0,107,CLE,33,30,19,24,0,0,0,106,20090520
2009,DEN,23,31,26,26,0,0,0,106,LAL,31,24,26,22,0,0,0,103,20090521
2009,ORL,16,28,25,26,0,0,0,95,CLE,30,26,19,21,0,0,0,96,20090522
2009,LAL,26,22,23,32,0,0,0,103,DEN,28,24,27,18,0,0,0,97,20090523
2009,CLE,17,24,22,26,0,0,0,89,ORL,24,18,26,31,0,0,0,99,20090524
2009,LAL,19,26,21,35,0,0,0,101,DEN,22,30,25,43,0,0,0,120,20090525
2009,CLE,25,33,21,21,14,0,0,114,ORL,21,29,28,22,16,0,0,116,20090526
2009,DEN,25,31,20,18,0,0,0,94,LAL,25,31,20,27,0,0,0,103,20090527
2009,ORL,18,37,24,23,0,0,0,102,CLE,35,21,22,34,0,0,0,112,20090528
2009,LAL,25,28,30,36,0,0,0,119,DEN,20,20,27,25,0,0,0,92,20090529
2009,CLE,25,15,30,20,0,0,0,90,ORL,30,28,28,17,0,0,0,103,20090530
2009,ORL,24,19,15,17,0,0,0,75,LAL,22,31,29,18,0,0,0,100,20090604
2009,ORL,15,20,30,23,8,0,0,96,LAL,15,25,23,25,13,0,0,101,20090607
2009,LAL,31,23,21,29,0,0,0,104,ORL,27,32,22,27,0,0,0,108,20090609
2009,LAL,20,17,30,20,12,0,0,99,ORL,24,25,14,24,4,0,0,91,20090611
2009,LAL,26,30,20,23,0,0,0,99,ORL,28,18,15,25,0,0,0,86,20090614
2010,BOS,21,30,21,23,0,0,0,95,CLE,28,17,20,24,0,0,0,89,20091027
2010,WAS,21,35,21,25,0,0,0,102,DAL,21,29,24,17,0,0,0,91,20091027
2010,LAC,22,27,26,17,0,0,0,92,LAL,32,27,17,23,0,0,0,99,20091027
2010,HOU,23,18,15,31,0,0,0,87,POR,23,31,21,21,0,0,0,96,20091027
2010,IND,32,33,29,15,0,0,0,109,ATL,29,37,29,25,0,0,0,120,20091028
2010,CHA,13,18,10,18,0,0,0,59,BOS,22,20,25,25,0,0,0,92,20091028
2010,UTA,30,25,25,25,0,0,0,105,DEN,23,31,28,32,0,0,0,114,20091028
2010,HOU,26,26,35,21,0,0,0,108,GSW,28,34,19,26,0,0,0,107,20091028
2010,PHO,24,29,24,32,0,0,0,109,LAC,31,22,26,28,0,0,0,107,20091028
2010,DET,24,29,18,25,0,0,0,96,MEM,20,21,16,17,0,0,0,74,20091028
2010,NYK,23,24,15,31,0,0,0,93,MIA,27,29,34,25,0,0,0,115,20091028
2010,NJN,25,30,23,15,0,0,0,93,MIN,21,22,21,31,0,0,0,95,20091028
2010,SAC,22,29,17,21,0,0,0,89,OKC,39,29,21,13,0,0,0,102,20091028
2010,PHI,27,20,22,37,0,0,0,106,ORL,29,41,30,20,0,0,0,120,20091028
2010,NOH,13,26,29,28,0,0,0,96,SAS,19,38,31,25,0,0,0,113,20091028
2010,CLE,22,17,32,20,0,0,0,91,TOR,27,30,21,23,0,0,0,101,20091028
2010,SAS,23,23,18,21,0,0,0,85,CHI,22,25,27,18,0,0,0,92,20091029
2010,DEN,24,18,20,35,0,0,0,97,POR,17,26,24,27,0,0,0,94,20091029
2010,WAS,24,20,22,23,0,0,0,89,ATL,29,29,17,25,0,0,0,100,20091030
2010,CHI,17,18,26,29,0,0,0,90,BOS,21,29,38,30,0,0,0,118,20091030
2010,NYK,13,24,18,27,6,12,0,100,CHA,32,19,18,13,6,14,0,102,20091030
2010,OKC,16,22,24,29,0,0,0,91,DET,24,21,16,22,0,0,0,83,20091030
2010,MIA,28,21,30,17,0,0,0,96,IND,16,31,16,20,0,0,0,83,20091030
2010,DAL,24,28,26,16,0,0,0,94,LAL,21,24,15,20,0,0,0,80,20091030
2010,TOR,22,27,30,28,0,0,0,107,MEM,23,30,23,39,0,0,0,115,20091030
2010,CLE,25,32,26,21,0,0,0,104,MIN,18,29,21,19,0,0,0,87,20091030
2010,ORL,29,21,25,20,0,0,0,95,NJN,24,20,18,23,0,0,0,85,20091030
2010,SAC,27,23,25,17,0,0,0,92,NOH,25,25,22,25,0,0,0,97,20091030
2010,MIL,18,29,20,19,0,0,0,86,PHI,23,18,35,23,0,0,0,99,20091030
2010,GSW,24,27,22,28,0,0,0,101,PHO,28,34,30,31,0,0,0,123,20091030
2010,LAC,32,28,24,14,0,0,0,98,UTA,34,26,23,28,0,0,0,111,20091030
2010,CHA,21,20,13,25,0,0,0,79,CLE,25,20,21,24,0,0,0,90,20091031
2010,POR,28,26,25,28,0,0,0,107,HOU,33,26,24,28,0,0,0,111,20091031
2010,DAL,23,32,25,13,0,0,0,93,LAC,27,28,16,13,0,0,0,84,20091031
2010,DET,29,20,14,22,0,0,0,85,MIL,20,18,36,22,0,0,0,96,20091031
2010,PHI,40,30,26,26,19,0,0,141,NYK,25,26,30,41,5,0,0,127,20091031
2010,SAC,27,18,30,19,0,0,0,94,SAS,34,27,34,18,0,0,0,113,20091031
2010,NJN,24,27,28,25,0,0,0,104,WAS,28,34,37,24,0,0,0,123,20091031
2010,NOH,20,18,31,18,0,0,0,87,BOS,22,25,25,25,0,0,0,97,20091101
2010,MEM,40,26,28,29,0,0,0,123,DEN,35,32,36,30,0,0,0,133,20091101
2010,ATL,25,33,18,34,0,0,0,110,LAL,27,37,34,20,0,0,0,118,20091101
2010,CHI,27,21,22,17,0,0,0,87,MIA,24,25,20,26,0,0,0,95,20091101
2010,POR,25,14,21,23,0,0,0,83,OKC,15,22,19,18,0,0,0,74,20091101
2010,MIN,34,27,24,27,0,0,0,112,PHO,35,32,29,24,0,0,0,120,20091101
2010,ORL,36,28,35,26,0,0,0,125,TOR,28,25,36,27,0,0,0,116,20091101
2010,NJN,14,27,7,20,0,0,0,68,CHA,10,23,20,26,0,0,0,79,20091102
2010,MIN,28,20,22,20,0,0,0,90,LAC,30,27,14,22,0,0,0,93,20091102
2010,NOH,24,28,29,30,0,0,0,111,NYK,31,27,19,40,0,0,0,117,20091102
2010,MEM,33,21,26,30,6,0,0,116,SAC,26,30,23,31,17,0,0,127,20091102
2010,HOU,26,28,25,34,0,0,0,113,UTA,28,29,19,20,0,0,0,96,20091102
2010,MIL,25,18,17,21,0,0,0,81,CHI,13,16,27,27,0,0,0,83,20091103
2010,WAS,31,23,19,17,0,0,0,90,CLE,17,33,28,24,0,0,0,102,20091103
2010,UTA,20,17,30,18,0,0,0,85,DAL,17,18,17,44,0,0,0,96,20091103
2010,ORL,14,27,19,20,0,0,0,80,DET,19,19,22,25,0,0,0,85,20091103
2010,DEN,30,25,28,28,0,0,0,111,IND,13,26,32,22,0,0,0,93,20091103
2010,PHO,23,21,31,29,0,0,0,104,MIA,26,26,29,15,0,0,0,96,20091103
2010,LAL,32,20,19,19,11,0,0,101,OKC,25,26,22,17,8,0,0,98,20091103
2010,BOS,19,25,25,36,0,0,0,105,PHI,17,19,18,20,0,0,0,74,20091103
2010,ATL,15,32,25,25,0,0,0,97,POR,25,23,21,22,0,0,0,91,20091103
2010,MEM,29,27,24,25,0,0,0,105,GSW,19,38,33,23,0,0,0,113,20091104
2010,LAL,22,22,29,19,11,0,0,103,HOU,22,26,26,18,10,0,0,102,20091104
2010,BOS,22,19,31,20,0,0,0,92,MIN,27,22,23,18,0,0,0,90,20091104
2010,DEN,22,28,44,28,0,0,0,122,NJN,23,28,26,17,0,0,0,94,20091104
2010,DAL,17,31,21,28,10,0,0,107,NOH,25,25,24,23,17,0,0,114,20091104
2010,IND,21,29,23,28,0,0,0,101,NYK,25,31,18,15,0,0,0,89,20091104
2010,PHO,25,27,26,22,0,0,0,100,ORL,29,29,34,30,0,0,0,122,20091104
2010,ATL,26,30,27,30,0,0,0,113,SAC,24,31,32,18,0,0,0,105,20091104
2010,DET,28,28,21,22,0,0,0,99,TOR,24,44,17,25,0,0,0,110,20091104
2010,MIA,31,19,16,27,0,0,0,93,WAS,17,24,25,23,0,0,0,89,20091104
2010,CHI,25,21,17,23,0,0,0,86,CLE,27,16,22,20,0,0,0,85,20091105
2010,SAS,22,28,30,19,0,0,0,99,UTA,32,28,33,20,0,0,0,113,20091105
2010,PHO,29,28,28,25,0,0,0,110,BOS,27,24,32,20,0,0,0,103,20091106
2010,ATL,24,24,21,14,0,0,0,83,CHA,28,33,23,19,0,0,0,103,20091106
2010,LAC,30,27,34,27,0,0,0,118,GSW,19,26,16,29,0,0,0,90,20091106
2010,OKC,21,24,24,25,0,0,0,94,HOU,26,24,30,25,0,0,0,105,20091106
2010,WAS,19,22,24,21,0,0,0,86,IND,23,30,29,20,0,0,0,102,20091106
2010,MEM,22,29,24,23,0,0,0,98,LAL,25,24,38,27,0,0,0,114,20091106
2010,DEN,21,17,18,32,0,0,0,88,MIA,23,27,28,18,0,0,0,96,20091106
2010,MIL,16,17,31,23,0,0,0,87,MIN,24,14,14,20,0,0,0,72,20091106
2010,TOR,19,30,34,24,0,0,0,107,NOH,23,28,14,25,0,0,0,90,20091106
2010,CLE,40,23,14,23,0,0,0,100,NYK,21,19,18,33,0,0,0,91,20091106
2010,DET,23,20,25,35,0,0,0,103,ORL,40,18,24,28,0,0,0,110,20091106
2010,NJN,20,27,26,21,0,0,0,94,PHI,18,32,18,29,0,0,0,97,20091106
2010,SAS,14,26,18,26,0,0,0,84,POR,29,22,17,28,0,0,0,96,20091106
2010,DEN,25,25,24,26,0,0,0,100,ATL,33,27,30,35,0,0,0,125,20091107
2010,CHA,28,25,17,20,0,0,0,90,CHI,26,20,27,20,0,0,0,93,20091107
2010,TOR,25,23,22,31,0,0,0,101,DAL,26,29,30,44,0,0,0,129,20091107
2010,MEM,29,31,22,28,0,0,0,110,LAC,23,32,27,31,0,0,0,113,20091107
2010,NYK,22,13,23,29,0,0,0,87,MIL,40,26,17,19,0,0,0,102,20091107
2010,BOS,18,21,20,27,0,0,0,86,NJN,19,21,21,15,0,0,0,76,20091107
2010,SAC,19,36,30,19,0,0,0,104,UTA,30,25,13,31,0,0,0,99,20091107
2010,PHI,19,18,22,22,0,0,0,81,DET,23,20,21,24,0,0,0,88,20091108
2010,NOH,17,25,16,30,0,0,0,88,LAL,27,28,27,22,0,0,0,104,20091108
2010,ORL,25,19,13,17,0,0,0,74,OKC,23,30,26,23,0,0,0,102,20091108
2010,MIN,24,21,22,26,0,0,0,93,POR,33,29,30,24,0,0,0,116,20091108
2010,GSW,29,25,23,30,0,0,0,107,SAC,30,35,31,24,0,0,0,120,20091108
2010,PHO,26,30,24,22,0,0,0,102,WAS,29,22,20,19,0,0,0,90,20091108
2010,MIN,29,26,22,28,0,0,0,105,GSW,33,41,37,35,0,0,0,146,20091109
2010,NOH,35,25,34,18,0,0,0,112,LAC,28,18,17,21,0,0,0,84,20091109
2010,UTA,25,23,30,17,0,0,0,95,NYK,18,13,33,29,0,0,0,93,20091109
2010,PHO,25,29,30,35,0,0,0,119,PHI,27,39,20,29,0,0,0,115,20091109
2010,TOR,32,31,32,29,0,0,0,124,SAS,31,32,30,38,0,0,0,131,20091109
2010,ORL,35,22,20,16,0,0,0,93,CHA,23,18,30,10,0,0,0,81,20091110
2010,DEN,22,24,25,19,0,0,0,90,CHI,20,23,23,23,0,0,0,89,20091110
2010,HOU,37,24,13,29,0,0,0,103,DAL,28,29,26,38,0,0,0,121,20091110
2010,POR,24,21,24,24,0,0,0,93,MEM,21,24,16,18,0,0,0,79,20091110
2010,WAS,27,22,13,14,0,0,0,76,MIA,21,20,24,25,0,0,0,90,20091110
2010,OKC,26,25,26,21,0,0,0,98,SAC,24,30,29,18,0,0,0,101,20091110
2010,UTA,23,21,18,24,0,0,0,86,BOS,28,26,30,21,0,0,0,105,20091111
2010,CHA,22,19,12,22,0,0,0,75,DET,20,32,29,17,0,0,0,98,20091111
2010,MEM,17,21,19,22,0,0,0,79,HOU,20,23,31,30,0,0,0,104,20091111
2010,GSW,28,19,23,24,0,0,0,94,IND,32,32,20,24,0,0,0,108,20091111
2010,OKC,22,21,23,17,0,0,0,83,LAC,22,26,21,10,0,0,0,79,20091111
2010,DEN,27,20,25,30,0,0,0,102,MIL,27,26,28,27,0,0,0,108,20091111
2010,POR,18,32,35,22,0,0,0,107,MIN,23,19,19,23,0,0,0,84,20091111
2010,PHI,22,21,17,22,0,0,0,82,NJN,21,19,18,21,0,0,0,79,20091111
2010,ATL,23,24,37,30,0,0,0,114,NYK,25,29,23,24,0,0,0,101,20091111
2010,CLE,35,31,22,14,0,0,0,102,ORL,28,23,17,25,0,0,0,93,20091111
2010,NOH,29,27,21,27,0,0,0,104,PHO,40,35,26,23,0,0,0,124,20091111
2010,DAL,21,17,26,19,0,0,0,83,SAS,21,30,28,13,0,0,0,92,20091111
2010,CHI,25,35,18,11,0,0,0,89,TOR,27,26,24,22,0,0,0,99,20091111
2010,PHO,24,21,26,31,0,0,0,102,LAL,31,28,33,29,0,0,0,121,20091112
2010,CLE,35,27,30,19,0,0,0,111,MIA,33,24,27,20,0,0,0,104,20091112
2010,ATL,24,17,31,25,0,0,0,97,BOS,22,20,28,16,0,0,0,86,20091113
2010,LAL,28,28,8,15,0,0,0,79,DEN,26,32,29,18,0,0,0,105,20091113
2010,TOR,17,28,29,30,0,0,0,104,LAC,34,20,20,15,0,0,0,89,20091113
2010,DAL,22,22,29,16,0,0,0,89,MIN,22,11,21,23,0,0,0,77,20091113
2010,POR,14,23,28,21,0,0,0,86,NOH,12,21,21,24,0,0,0,78,20091113
2010,GSW,32,34,20,35,0,0,0,121,NYK,26,26,28,27,0,0,0,107,20091113
2010,NJN,27,15,14,16,0,0,0,72,ORL,23,19,20,26,0,0,0,88,20091113
2010,UTA,30,34,28,20,0,0,0,112,PHI,32,18,19,21,0,0,0,90,20091113
2010,HOU,30,22,25,23,0,0,0,100,SAC,30,33,19,27,0,0,0,109,20091113
2010,NOH,28,27,23,20,0,0,0,98,ATL,37,28,26,30,0,0,0,121,20091114
2010,POR,18,20,17,25,0,0,0,80,CHA,18,12,21,23,0,0,0,74,20091114
2010,PHI,23,18,18,29,0,0,0,88,CHI,22,18,23,31,0,0,0,94,20091114
2010,UTA,22,32,18,31,0,0,0,103,CLE,34,25,19,29,0,0,0,107,20091114
2010,BOS,27,34,18,25,0,0,0,104,IND,26,26,32,29,0,0,0,113,20091114
2010,MIN,23,22,18,24,0,0,0,87,MEM,25,20,23,29,0,0,0,97,20091114
2010,NJN,19,19,19,23,0,0,0,80,MIA,17,23,18,23,0,0,0,81,20091114
2010,GSW,30,27,26,42,0,0,0,125,MIL,21,28,43,37,0,0,0,129,20091114
2010,OKC,25,21,32,23,0,0,0,101,SAS,25,28,21,24,0,0,0,98,20091114
2010,DET,27,28,23,28,0,0,0,106,WAS,18,29,33,23,0,0,0,103,20091114
2010,DAL,22,18,31,24,0,0,0,95,DET,18,28,20,24,0,0,0,90,20091115
2010,HOU,23,29,28,21,0,0,0,101,LAL,29,25,19,18,0,0,0,91,20091115
2010,LAC,26,23,26,26,0,0,0,101,OKC,23,18,35,17,0,0,0,93,20091115
2010,TOR,33,20,26,21,0,0,0,100,PHO,31,19,27,24,0,0,0,101,20091115
2010,POR,28,20,19,18,10,0,0,95,ATL,20,23,15,27,14,0,0,99,20091116
2010,DAL,33,33,19,19,11,0,0,115,MIL,28,26,28,22,9,0,0,113,20091116
2010,CHA,21,31,16,23,0,0,0,91,ORL,25,25,26,21,0,0,0,97,20091116
2010,GSW,30,25,24,29,0,0,0,108,CLE,35,31,24,24,0,0,0,114,20091117
2010,TOR,29,35,25,23,0,0,0,112,DEN,28,36,33,33,0,0,0,130,20091117
2010,PHO,22,30,26,33,0,0,0,111,HOU,34,21,27,23,0,0,0,105,20091117
2010,DET,22,20,21,30,0,0,0,93,LAL,23,34,31,18,0,0,0,106,20091117
2010,OKC,25,20,29,26,0,0,0,100,MIA,17,25,17,28,0,0,0,87,20091117
2010,IND,31,23,13,24,0,0,0,91,NJN,21,25,14,23,0,0,0,83,20091117
2010,LAC,22,31,22,27,0,0,0,102,NOH,29,29,26,26,0,0,0,110,20091117
2010,CHI,27,34,25,15,0,0,0,101,SAC,23,24,25,15,0,0,0,87,20091117
2010,MIA,23,20,29,18,0,0,0,90,ATL,26,34,19,26,0,0,0,105,20091118
2010,GSW,23,25,19,28,0,0,0,95,BOS,27,22,31,29,0,0,0,109,20091118
2010,SAS,21,14,24,25,10,0,0,94,DAL,19,18,26,21,15,0,0,99,20091118
2010,NYK,25,29,22,34,0,0,0,110,IND,26,43,17,17,0,0,0,103,20091118
2010,LAC,23,22,19,27,0,0,0,91,MEM,27,28,27,24,0,0,0,106,20091118
2010,NJN,19,29,12,25,0,0,0,85,MIL,20,21,28,30,0,0,0,99,20091118
2010,HOU,23,25,20,29,0,0,0,97,MIN,21,21,25,17,0,0,0,84,20091118
2010,OKC,17,26,15,36,0,0,0,94,ORL,28,33,27,20,0,0,0,108,20091118
2010,CHA,22,21,22,19,0,0,0,84,PHI,29,23,17,17,0,0,0,86,20091118
2010,DET,17,21,12,31,0,0,0,81,POR,21,27,22,17,0,0,0,87,20091118
2010,TOR,17,35,23,16,0,0,0,91,UTA,33,28,17,26,0,0,0,104,20091118
2010,CLE,32,19,21,19,0,0,0,91,WAS,22,22,31,33,0,0,0,108,20091118
2010,CHI,19,23,25,26,0,0,0,93,LAL,25,28,31,24,0,0,0,108,20091119
2010,PHO,22,27,27,27,0,0,0,103,NOH,26,26,26,32,0,0,0,110,20091119
2010,UTA,20,24,16,30,0,0,0,90,SAS,19,21,20,23,0,0,0,83,20091119
2010,HOU,26,25,21,31,0,0,0,103,ATL,28,27,22,28,0,0,0,105,20091120
2010,ORL,29,14,23,17,0,0,0,83,BOS,13,27,19,19,0,0,0,78,20091120
2010,SAC,24,18,23,37,0,0,0,102,DAL,22,25,21,36,0,0,0,104,20091120
2010,POR,37,15,23,19,0,0,0,94,GSW,29,27,27,25,0,0,0,108,20091120
2010,CLE,38,28,11,28,0,0,0,105,IND,38,23,21,13,0,0,0,95,20091120
2010,DEN,26,20,27,26,0,0,0,99,LAC,21,35,32,18,0,0,0,106,20091120
2010,CHA,25,16,19,28,0,0,0,88,MIL,30,23,23,19,0,0,0,95,20091120
2010,WAS,29,26,31,22,0,0,0,108,OKC,32,30,33,32,0,0,0,127,20091120
2010,MEM,28,21,29,24,0,0,0,102,PHI,22,28,21,26,0,0,0,97,20091120
2010,MIA,24,25,34,30,0,0,0,113,TOR,26,43,20,31,0,0,0,120,20091120
2010,PHI,23,28,30,10,0,0,0,91,CLE,36,18,21,22,0,0,0,97,20091121
2010,CHI,27,25,19,22,0,0,0,93,DEN,14,35,26,37,0,0,0,112,20091121
2010,SAC,27,25,32,22,0,0,0,106,HOU,33,26,21,33,0,0,0,113,20091121
2010,MIL,19,26,31,27,0,0,0,103,MEM,29,21,22,26,0,0,0,98,20091121
2010,NYK,29,23,22,24,0,0,0,98,NJN,24,19,24,24,0,0,0,91,20091121
2010,ATL,19,23,18,28,0,0,0,88,NOH,22,27,22,25,0,0,0,96,20091121
2010,MIN,14,23,26,15,0,0,0,78,POR,23,17,36,30,0,0,0,106,20091121
2010,WAS,21,19,18,26,0,0,0,84,SAS,27,25,28,26,0,0,0,106,20091121
2010,DET,24,22,22,22,7,0,0,97,UTA,27,15,22,26,10,0,0,100,20091121
2010,IND,20,21,19,28,0,0,0,88,CHA,28,24,29,23,0,0,0,104,20091122
2010,OKC,16,18,24,27,0,0,0,85,LAL,35,22,22,22,0,0,0,101,20091122
2010,NOH,25,27,31,18,0,0,0,101,MIA,30,29,27,16,0,0,0,102,20091122
2010,BOS,30,26,21,21,9,0,0,107,NYK,22,31,29,16,7,0,0,105,20091122
2010,DET,26,16,21,28,0,0,0,91,PHO,29,29,26,33,0,0,0,117,20091122
2010,ORL,22,28,26,28,0,0,0,104,TOR,28,21,27,20,0,0,0,96,20091122
2010,MIN,29,22,22,14,0,0,0,87,LAC,28,20,24,19,0,0,0,91,20091123
2010,SAC,18,32,19,36,0,0,0,105,MEM,25,35,26,30,0,0,0,116,20091123
2010,CHI,28,23,29,18,0,0,0,98,POR,31,35,24,32,0,0,0,122,20091123
2010,MIL,18,32,24,24,0,0,0,98,SAS,23,26,37,26,0,0,0,112,20091123
2010,GSW,25,25,28,33,0,0,0,111,DAL,27,27,28,21,0,0,0,103,20091124
2010,NJN,19,24,18,26,0,0,0,87,DEN,27,28,25,21,0,0,0,101,20091124
2010,NYK,24,21,17,28,0,0,0,90,LAL,30,25,28,17,0,0,0,100,20091124
2010,IND,31,22,39,20,0,0,0,112,TOR,39,35,26,23,0,0,0,123,20091124
2010,OKC,25,28,31,20,0,0,0,104,UTA,28,24,16,26,0,0,0,94,20091124
2010,PHI,22,24,29,32,0,0,0,107,WAS,23,22,40,23,0,0,0,108,20091124
2010,PHI,23,29,33,25,0,0,0,110,BOS,27,24,28,34,0,0,0,113,20091125
2010,TOR,23,23,21,14,0,0,0,81,CHA,20,32,33,31,0,0,0,116,20091125
2010,CLE,28,32,20,18,0,0,0,98,DET,19,23,24,22,0,0,0,88,20091125
2010,DAL,36,32,23,39,0,0,0,130,HOU,25,26,26,22,0,0,0,99,20091125
2010,LAC,19,24,16,14,0,0,0,73,IND,12,22,21,31,0,0,0,86,20091125
2010,DEN,29,33,40,22,0,0,0,124,MIN,18,24,37,32,0,0,0,111,20091125
2010,MIL,30,17,23,21,8,0,0,99,NOH,20,19,29,23,11,0,0,102,20091125
2010,MIA,26,17,23,33,0,0,0,99,ORL,24,20,27,27,0,0,0,98,20091125
2010,MEM,27,22,28,34,0,0,0,111,PHO,27,33,38,28,0,0,0,126,20091125
2010,NJN,23,21,12,27,0,0,0,83,POR,28,21,13,31,0,0,0,93,20091125
2010,NYK,24,27,22,24,0,0,0,97,SAC,30,31,32,18,0,0,0,111,20091125
2010,GSW,31,27,23,23,0,0,0,104,SAS,33,27,31,27,0,0,0,118,20091125
2010,ORL,23,16,28,26,0,0,0,93,ATL,25,26,14,11,0,0,0,76,20091126
2010,CHI,22,18,25,21,0,0,0,86,UTA,28,29,24,24,0,0,0,105,20091126
2010,TOR,27,28,17,31,0,0,0,103,BOS,33,21,33,29,0,0,0,116,20091127
2010,CLE,19,24,28,16,0,0,0,87,CHA,26,32,24,12,0,0,0,94,20091127
2010,NYK,30,30,27,38,0,0,0,125,DEN,26,35,31,36,0,0,0,128,20091127
2010,LAC,27,20,27,30,0,0,0,104,DET,27,27,21,21,0,0,0,96,20091127
2010,SAS,18,26,24,24,0,0,0,92,HOU,23,23,12,26,0,0,0,84,20091127
2010,DAL,35,31,29,18,0,0,0,113,IND,26,28,15,23,0,0,0,92,20091127
2010,WAS,26,25,16,27,0,0,0,94,MIA,24,18,22,20,0,0,0,84,20091127
2010,PHO,32,28,32,28,0,0,0,120,MIN,22,17,26,30,0,0,0,95,20091127
2010,MIL,26,24,13,27,0,0,0,90,OKC,31,20,27,30,0,0,0,108,20091127
2010,ATL,26,20,29,25,0,0,0,100,PHI,23,18,25,20,0,0,0,86,20091127
2010,MEM,29,32,16,29,0,0,0,106,POR,15,24,24,33,0,0,0,96,20091127
2010,NJN,20,22,27,27,0,0,0,96,SAC,33,26,25,25,0,0,0,109,20091127
2010,DAL,26,29,24,16,0,0,0,95,CLE,35,33,19,24,0,0,0,111,20091128
2010,LAL,36,24,38,32,0,0,0,130,GSW,22,28,25,22,0,0,0,97,20091128
2010,ORL,21,26,26,27,0,0,0,100,MIL,26,30,16,26,0,0,0,98,20091128
2010,POR,17,27,23,25,0,0,0,92,UTA,32,27,30,19,0,0,0,108,20091128
2010,CHA,22,20,27,23,0,0,0,92,WAS,19,13,18,26,0,0,0,76,20091128
2010,MIN,25,25,31,25,0,0,0,106,DEN,40,24,12,24,0,0,0,100,20091129
2010,ATL,25,22,18,23,0,0,0,88,DET,27,28,12,27,0,0,0,94,20091129
2010,MEM,28,30,23,7,0,0,0,88,LAC,21,22,22,33,0,0,0,98,20091129
2010,NJN,12,22,26,27,0,0,0,87,LAL,27,32,28,19,0,0,0,106,20091129
2010,BOS,29,26,12,25,0,0,0,92,MIA,31,17,17,20,0,0,0,85,20091129
2010,ORL,31,23,28,32,0,0,0,114,NYK,29,23,21,29,0,0,0,102,20091129
2010,HOU,25,20,24,31,0,0,0,100,OKC,29,25,17,20,0,0,0,91,20091129
2010,NOH,26,19,29,22,0,0,0,96,SAC,26,31,25,30,0,0,0,112,20091129
2010,PHI,23,22,25,19,0,0,0,89,SAS,25,29,26,17,0,0,0,97,20091129
2010,PHO,33,17,34,29,0,0,0,113,TOR,25,24,27,18,0,0,0,94,20091129
2010,PHI,23,20,29,30,0,0,0,102,DAL,28,29,21,26,0,0,0,104,20091130
2010,IND,33,24,26,24,0,0,0,107,GSW,25,26,34,41,0,0,0,126,20091130
2010,CHI,17,27,28,25,0,0,0,97,MIL,22,26,29,22,0,0,0,99,20091130
2010,MEM,22,26,22,23,0,0,0,93,UTA,31,30,34,25,0,0,0,120,20091130
2010,BOS,29,33,26,20,0,0,0,108,CHA,18,21,27,24,0,0,0,90,20091201
2010,GSW,28,27,29,23,0,0,0,107,DEN,25,44,38,28,0,0,0,135,20091201
2010,NOH,27,15,27,30,0,0,0,99,LAL,31,31,28,20,0,0,0,110,20091201
2010,PHO,28,30,18,23,0,0,0,99,NYK,39,32,29,26,0,0,0,126,20091201
2010,MIA,32,28,28,19,0,0,0,107,POR,28,22,22,28,0,0,0,100,20091201
2010,WAS,25,30,17,34,0,0,0,106,TOR,24,30,23,25,0,0,0,102,20091201
2010,TOR,26,28,30,31,0,0,0,115,ATL,33,42,39,32,0,0,0,146,20091202
2010,DET,10,28,19,28,0,0,0,85,CHI,24,24,26,18,0,0,0,92,20091202
2010,PHO,14,15,29,32,0,0,0,90,CLE,33,24,22,28,0,0,0,107,20091202
2010,HOU,27,25,24,26,0,0,0,102,LAC,26,26,20,13,0,0,0,85,20091202
2010,MEM,22,25,30,20,0,0,0,97,MIN,28,27,18,22,0,0,0,95,20091202
2010,DAL,28,49,28,12,0,0,0,117,NJN,28,22,28,23,0,0,0,101,20091202
2010,PHI,33,22,27,24,0,0,0,106,OKC,29,25,34,29,0,0,0,117,20091202
2010,NYK,23,16,31,34,0,0,0,104,ORL,31,20,41,26,0,0,0,118,20091202
2010,IND,33,24,24,24,0,0,0,105,SAC,30,30,28,22,0,0,0,110,20091202
2010,MIL,22,32,26,22,0,0,0,102,WAS,26,24,29,25,0,0,0,104,20091202
2010,MIA,22,20,26,28,0,0,0,96,DEN,25,33,34,22,0,0,0,114,20091203
2010,HOU,28,30,25,28,0,0,0,111,GSW,28,23,38,20,0,0,0,109,20091203
2010,BOS,25,22,27,16,0,0,0,90,SAS,15,24,24,20,0,0,0,83,20091203
2010,NYK,35,29,19,31,0,0,0,114,ATL,34,17,33,23,0,0,0,107,20091204
2010,CHI,25,21,15,26,0,0,0,87,CLE,30,17,29,25,0,0,0,101,20091204
2010,MIL,23,32,17,24,0,0,0,96,DET,34,29,20,22,0,0,0,105,20091204
2010,MIA,23,25,28,31,0,0,0,107,LAL,21,30,25,32,0,0,0,108,20091204
2010,DAL,30,21,16,15,0,0,0,82,MEM,28,30,20,20,0,0,0,98,20091204
2010,CHA,29,22,18,22,0,0,0,91,NJN,28,19,21,29,0,0,0,97,20091204
2010,MIN,22,27,16,24,0,0,0,89,NOH,20,27,28,23,0,0,0,98,20091204
2010,BOS,31,29,28,17,0,0,0,105,OKC,20,29,16,22,0,0,0,87,20091204
2010,IND,14,30,26,17,0,0,0,87,UTA,32,25,22,17,0,0,0,96,20091204
2010,TOR,27,26,18,25,13,0,0,109,WAS,17,29,25,25,11,0,0,107,20091204
2010,PHI,22,26,38,19,0,0,0,105,CHA,28,21,29,28,0,0,0,106,20091205
2010,TOR,37,27,23,23,0,0,0,110,CHI,16,28,14,20,0,0,0,78,20091205
2010,ATL,27,14,23,16,0,0,0,80,DAL,19,21,20,15,0,0,0,75,20091205
2010,ORL,42,30,25,29,0,0,0,126,GSW,33,31,36,18,0,0,0,118,20091205
2010,IND,18,21,17,16,0,0,0,72,LAC,22,19,22,25,0,0,0,88,20091205
2010,UTA,24,26,23,28,0,0,0,101,MIN,22,25,26,35,0,0,0,108,20091205
2010,SAC,26,29,28,24,0,0,0,107,PHO,35,25,22,33,0,0,0,115,20091205
2010,HOU,23,25,21,20,0,0,0,89,POR,23,22,23,22,0,0,0,90,20091205
2010,DEN,23,30,22,31,0,0,0,106,SAS,30,29,17,23,0,0,0,99,20091205
2010,WAS,19,30,20,25,0,0,0,94,DET,24,28,19,27,0,0,0,98,20091206
2010,PHO,26,18,22,22,0,0,0,88,LAL,29,25,33,21,0,0,0,108,20091206
2010,CLE,21,31,23,26,0,0,0,101,MIL,17,16,24,29,0,0,0,86,20091206
2010,NJN,30,31,18,18,0,0,0,97,NYK,26,27,33,20,0,0,0,106,20091206
2010,MIA,30,29,29,27,0,0,0,115,SAC,25,19,33,25,0,0,0,102,20091206
2010,POR,18,20,17,29,0,0,0,84,NYK,18,31,29,15,0,0,0,93,20091207
2010,GSW,23,26,18,21,0,0,0,88,OKC,22,28,29,25,0,0,0,104,20091207
2010,DEN,20,21,22,30,0,0,0,93,PHI,26,18,21,18,0,0,0,83,20091207
2010,SAS,31,26,19,25,0,0,0,101,UTA,24,25,37,18,0,0,0,104,20091207
2010,MIL,27,21,23,18,0,0,0,89,BOS,26,23,22,27,0,0,0,98,20091208
2010,DEN,26,23,26,20,0,0,0,95,CHA,29,25,24,29,0,0,0,107,20091208
2010,NJN,26,28,26,23,0,0,0,103,CHI,24,30,16,31,0,0,0,101,20091208
2010,PHO,29,21,20,31,0,0,0,101,DAL,23,26,28,25,0,0,0,102,20091208
2010,ORL,34,19,20,24,0,0,0,97,LAC,24,23,22,17,0,0,0,86,20091208
2010,CLE,31,28,19,22,9,0,0,109,MEM,25,23,28,24,11,0,0,111,20091208
2010,SAC,19,29,20,26,0,0,0,94,NOH,29,19,19,29,0,0,0,96,20091208
2010,MIN,20,15,28,25,0,0,0,88,TOR,23,20,21,30,0,0,0,94,20091208
2010,CHI,21,21,15,26,0,0,0,83,ATL,22,34,31,31,0,0,0,118,20091209
2010,CLE,19,20,19,27,0,0,0,85,HOU,33,19,16,27,0,0,0,95,20091209
2010,POR,26,26,25,25,0,0,0,102,IND,19,26,30,16,0,0,0,91,20091209
2010,UTA,24,28,19,6,0,0,0,77,LAL,24,24,25,28,0,0,0,101,20091209
2010,TOR,22,23,29,21,0,0,0,95,MIL,29,28,26,34,0,0,0,117,20091209
2010,NOH,29,24,25,19,0,0,0,97,MIN,29,35,19,13,0,0,0,96,20091209
2010,GSW,20,38,23,24,0,0,0,105,NJN,27,21,22,19,0,0,0,89,20091209
2010,DET,18,24,25,23,0,0,0,90,PHI,16,26,21,23,0,0,0,86,20091209
2010,SAC,24,30,28,24,0,0,0,106,SAS,30,33,26,29,0,0,0,118,20091209
2010,DEN,24,26,23,26,0,0,0,99,DET,23,29,28,21,0,0,0,101,20091210
2010,ORL,35,25,21,30,0,0,0,111,UTA,22,30,38,30,0,0,0,120,20091210
2010,BOS,27,37,19,21,0,0,0,104,WAS,28,22,24,28,0,0,0,102,20091210
2010,GSW,28,23,19,17,4,0,0,91,CHI,26,18,25,18,9,0,0,96,20091211
2010,POR,23,31,22,23,0,0,0,99,CLE,26,19,31,28,0,0,0,104,20091211
2010,NJN,21,30,23,17,0,0,0,91,IND,27,33,27,20,0,0,0,107,20091211
2010,MIN,24,30,14,24,0,0,0,92,LAL,33,23,30,18,0,0,0,104,20091211
2010,OKC,29,27,10,36,0,0,0,102,MEM,18,24,28,24,0,0,0,94,20091211
2010,DAL,30,23,31,22,0,0,0,106,MIA,18,28,27,20,0,0,0,93,20091211
2010,NYK,21,32,28,32,0,0,0,113,NOH,30,32,17,17,0,0,0,96,20091211
2010,HOU,19,29,28,20,0,0,0,96,PHI,29,22,13,27,0,0,0,91,20091211
2010,ORL,22,30,29,22,0,0,0,103,PHO,33,28,24,21,0,0,0,106,20091211
2010,CHA,19,23,29,14,0,0,0,85,SAS,29,30,13,32,0,0,0,104,20091211
2010,ATL,29,32,28,22,0,0,0,111,TOR,27,21,23,18,0,0,0,89,20091211
2010,BOS,29,25,29,23,0,0,0,106,CHI,26,20,17,17,0,0,0,80,20091212
2010,CHA,20,26,24,15,12,0,0,97,DAL,26,17,19,23,13,0,0,98,20091212
2010,PHO,26,34,17,22,0,0,0,99,DEN,29,18,30,28,0,0,0,105,20091212
2010,GSW,30,25,12,28,0,0,0,95,DET,24,25,22,33,0,0,0,104,20091212
2010,POR,16,28,15,28,8,6,0,101,MIL,21,18,30,18,8,13,0,108,20091212
2010,MIN,32,25,20,23,0,0,0,100,SAC,35,29,33,23,0,0,0,120,20091212
2010,LAL,25,28,18,23,0,0,0,94,UTA,25,34,21,22,0,0,0,102,20091212
2010,IND,36,30,21,27,0,0,0,114,WAS,38,14,38,23,0,0,0,113,20091212
2010,NJN,29,21,32,25,0,0,0,107,ATL,31,31,39,29,0,0,0,130,20091213
2010,SAS,39,27,22,27,0,0,0,115,LAC,23,33,19,15,0,0,0,90,20091213
2010,MEM,37,25,31,25,0,0,0,118,MIA,25,24,18,23,0,0,0,90,20091213
2010,CLE,27,22,29,24,0,0,0,102,OKC,29,25,22,13,0,0,0,89,20091213
2010,HOU,17,25,21,25,0,0,0,88,TOR,32,23,20,26,0,0,0,101,20091213
2010,NOH,18,25,23,24,0,0,0,90,DAL,35,14,22,23,0,0,0,94,20091214
2010,OKC,23,17,21,32,0,0,0,93,DEN,25,30,19,28,0,0,0,102,20091214
2010,WAS,25,19,25,26,0,0,0,95,LAC,21,18,28,30,0,0,0,97,20091214
2010,BOS,28,26,31,25,0,0,0,110,MEM,31,24,26,24,0,0,0,105,20091214
2010,IND,30,24,27,17,0,0,0,98,ORL,17,36,26,27,0,0,0,106,20091214
2010,GSW,24,33,11,33,0,0,0,101,PHI,36,35,26,20,0,0,0,117,20091214
2010,MIN,30,31,27,22,0,0,0,110,UTA,33,32,17,26,0,0,0,108,20091214
2010,NYK,20,27,27,13,0,0,0,87,CHA,24,22,20,28,0,0,0,94,20091215
2010,LAL,31,23,18,24,0,0,0,96,CHI,31,17,25,14,0,0,0,87,20091215
2010,NJN,22,23,18,26,0,0,0,89,CLE,30,22,20,27,0,0,0,99,20091215
2010,DET,19,28,21,28,0,0,0,96,HOU,29,27,25,26,0,0,0,107,20091215
2010,TOR,26,24,24,21,0,0,0,95,MIA,24,36,31,24,0,0,0,115,20091215
2010,SAS,17,35,32,20,0,0,0,104,PHO,28,39,22,27,0,0,0,116,20091215
2010,SAC,23,31,19,15,0,0,0,88,POR,23,20,23,29,0,0,0,95,20091215
2010,MEM,24,18,24,31,0,0,0,97,ATL,22,29,32,27,0,0,0,110,20091216
2010,HOU,21,30,27,23,0,0,0,101,DEN,25,33,27,26,0,0,0,111,20091216
2010,SAS,27,20,31,25,0,0,0,103,GSW,25,24,20,22,0,0,0,91,20091216
2010,CHA,25,21,23,29,0,0,0,98,IND,30,26,23,22,0,0,0,101,20091216
2010,LAL,19,26,29,21,12,0,0,107,MIL,20,27,24,24,11,0,0,106,20091216
2010,LAC,27,37,27,29,0,0,0,120,MIN,29,24,26,16,0,0,0,95,20091216
2010,UTA,26,26,25,31,0,0,0,108,NJN,24,17,21,30,0,0,0,92,20091216
2010,DET,28,27,18,14,0,0,0,87,NOH,25,17,28,25,0,0,0,95,20091216
2010,DAL,24,19,28,29,0,0,0,100,OKC,24,24,20,18,0,0,0,86,20091216
2010,TOR,24,30,25,20,0,0,0,99,ORL,35,31,26,26,0,0,0,118,20091216
2010,CLE,32,28,23,25,0,0,0,108,PHI,26,29,25,21,0,0,0,101,20091216
2010,WAS,33,21,26,29,0,0,0,109,SAC,34,25,30,23,0,0,0,112,20091216
2010,NYK,34,16,22,17,0,0,0,89,CHI,23,25,21,29,0,0,0,98,20091217
2010,ORL,18,26,16,26,0,0,0,86,MIA,33,26,30,15,0,0,0,104,20091217
2010,PHO,28,27,26,21,0,0,0,102,POR,25,23,22,35,0,0,0,105,20091217
2010,UTA,18,16,17,32,0,0,0,83,ATL,22,22,37,15,0,0,0,96,20091218
2010,PHI,17,25,30,26,0,0,0,98,BOS,24,29,23,21,0,0,0,97,20091218
2010,MIL,26,23,12,21,0,0,0,82,CLE,24,23,24,14,0,0,0,85,20091218
2010,HOU,19,30,24,27,16,0,0,116,DAL,24,17,24,35,8,0,0,108,20091218
2010,WAS,39,21,29,29,0,0,0,118,GSW,31,28,23,27,0,0,0,109,20091218
2010,IND,24,32,17,21,0,0,0,94,MEM,28,23,32,24,0,0,0,107,20091218
2010,SAC,22,23,31,20,0,0,0,96,MIN,27,25,35,25,0,0,0,112,20091218
2010,DEN,23,29,19,21,0,0,0,92,NOH,25,21,33,19,0,0,0,98,20091218
2010,LAC,31,27,14,19,0,0,0,91,NYK,16,26,30,23,0,0,0,95,20091218
2010,DET,27,24,22,25,0,0,0,98,OKC,24,28,25,32,0,0,0,109,20091218
2010,NJN,15,18,27,35,0,0,0,95,TOR,39,31,24,24,0,0,0,118,20091218
2010,UTA,24,28,31,27,0,0,0,110,CHA,25,22,28,27,0,0,0,102,20091219
2010,ATL,29,17,23,23,6,0,0,98,CHI,16,24,23,29,9,0,0,101,20091219
2010,OKC,22,18,25,25,0,0,0,90,HOU,23,27,24,21,0,0,0,95,20091219
2010,SAC,21,28,24,23,0,0,0,96,MIL,21,32,19,23,0,0,0,95,20091219
2010,LAL,29,17,28,29,0,0,0,103,NJN,21,27,16,20,0,0,0,84,20091219
2010,POR,21,23,21,18,0,0,0,83,ORL,19,20,26,27,0,0,0,92,20091219
2010,LAC,30,30,18,21,13,0,0,112,PHI,18,29,26,26,8,0,0,107,20091219
2010,WAS,21,26,25,23,0,0,0,95,PHO,30,33,39,19,0,0,0,121,20091219
2010,IND,21,24,38,16,0,0,0,99,SAS,30,20,20,30,0,0,0,100,20091219
2010,MIN,19,22,31,32,0,0,0,104,BOS,34,32,26,30,0,0,0,122,20091220
2010,CLE,26,24,17,28,0,0,0,95,DAL,25,27,21,29,0,0,0,102,20091220
2010,LAL,31,25,27,10,0,0,0,93,DET,19,19,24,19,0,0,0,81,20091220
2010,DEN,19,24,24,29,0,0,0,96,MEM,33,28,19,22,0,0,0,102,20091220
2010,POR,21,24,26,31,0,0,0,102,MIA,25,23,21,26,0,0,0,95,20091220
2010,CHA,14,31,25,24,0,0,0,94,NYK,16,35,25,22,0,0,0,98,20091220
2010,NOH,22,25,22,23,0,0,0,92,TOR,26,25,25,22,0,0,0,98,20091220
2010,SAC,19,24,26,33,0,0,0,102,CHI,38,29,21,10,0,0,0,98,20091221
2010,MIL,19,17,29,19,0,0,0,84,IND,16,27,20,18,0,0,0,81,20091221
2010,UTA,18,22,28,31,0,0,0,99,ORL,19,21,30,34,0,0,0,104,20091221
2010,CLE,29,30,23,27,0,0,0,109,PHO,30,23,22,16,0,0,0,91,20091221
2010,LAC,19,27,18,23,0,0,0,87,SAS,33,24,28,18,0,0,0,103,20091221
2010,IND,28,29,20,17,0,0,0,94,BOS,21,21,35,26,0,0,0,103,20091222
2010,DET,19,17,19,21,0,0,0,76,CHA,23,29,17,19,0,0,0,88,20091222
2010,POR,18,26,14,27,0,0,0,85,DAL,14,19,32,16,0,0,0,81,20091222
2010,LAC,33,21,28,17,0,0,0,99,HOU,34,31,23,20,0,0,0,108,20091222
2010,OKC,30,31,21,26,0,0,0,108,LAL,25,29,34,23,0,0,0,111,20091222
2010,GSW,38,20,21,29,0,0,0,108,MEM,32,36,29,24,0,0,0,121,20091222
2010,ATL,26,28,27,31,0,0,0,112,MIN,17,24,28,18,0,0,0,87,20091222
2010,CHI,12,19,25,25,0,0,0,81,NYK,22,31,15,20,0,0,0,88,20091222
2010,PHI,21,23,35,19,0,0,0,98,WAS,27,20,25,33,0,0,0,105,20091222
2010,ATL,24,27,31,22,0,0,0,104,DEN,34,29,29,32,0,0,0,124,20091223
2010,TOR,25,29,20,20,0,0,0,94,DET,21,16,14,13,0,0,0,64,20091223
2010,UTA,16,14,19,21,0,0,0,70,MIA,19,13,31,17,0,0,0,80,20091223
2010,WAS,37,20,24,28,0,0,0,109,MIL,27,25,23,22,0,0,0,97,20091223
2010,MIN,27,25,24,27,0,0,0,103,NJN,23,25,26,25,0,0,0,99,20091223
2010,GSW,26,30,24,22,0,0,0,102,NOH,27,31,27,23,0,0,0,108,20091223
2010,HOU,22,30,13,22,0,0,0,87,ORL,34,21,23,24,0,0,0,102,20091223
2010,OKC,36,30,23,28,0,0,0,117,PHO,31,33,25,24,0,0,0,113,20091223
2010,CLE,32,25,32,15,13,0,0,117,SAC,29,24,32,19,0,0,0,104,20091223
2010,POR,28,20,27,23,0,0,0,98,SAS,24,23,22,25,0,0,0,94,20091223
2010,CLE,23,28,25,26,0,0,0,102,LAL,19,23,17,28,0,0,0,87,20091225
2010,MIA,21,20,23,29,0,0,0,93,NYK,23,14,17,33,0,0,0,87,20091225
2010,BOS,18,20,23,25,0,0,0,86,ORL,19,8,26,24,0,0,0,77,20091225
2010,LAC,26,29,22,16,0,0,0,93,PHO,30,37,34,23,0,0,0,124,20091225
2010,DEN,31,20,25,20,0,0,0,96,POR,24,25,25,33,0,0,0,107,20091225
2010,NOH,27,24,9,25,0,0,0,85,CHI,24,26,23,23,0,0,0,96,20091226
2010,MEM,30,25,22,24,0,0,0,101,DAL,24,29,26,27,0,0,0,106,20091226
2010,PHO,35,36,37,19,0,0,0,127,GSW,36,34,34,28,0,0,0,132,20091226
2010,ATL,33,18,33,26,0,0,0,110,IND,20,20,26,32,0,0,0,98,20091226
2010,SAS,26,30,33,23,0,0,0,112,MIL,14,27,23,33,0,0,0,97,20091226
2010,WAS,22,20,25,22,0,0,0,89,MIN,23,20,25,33,0,0,0,101,20091226
2010,HOU,27,30,13,28,0,0,0,98,NJN,20,31,18,24,0,0,0,93,20091226
2010,CHA,25,25,23,18,0,0,0,91,OKC,24,29,28,17,0,0,0,98,20091226
2010,LAL,28,27,23,16,7,11,0,112,SAC,31,26,21,16,7,2,0,103,20091226
2010,PHI,19,20,25,12,0,0,0,76,UTA,25,23,24,25,0,0,0,97,20091226
2010,HOU,24,24,15,20,0,0,0,83,CLE,24,27,32,25,0,0,0,108,20091227
2010,DAL,30,25,28,21,0,0,0,104,DEN,23,29,20,24,0,0,0,96,20091227
2010,BOS,23,25,25,17,0,0,0,90,LAC,22,24,23,23,0,0,0,92,20091227
2010,IND,21,23,16,20,0,0,0,80,MIA,34,32,32,16,0,0,0,114,20091227
2010,SAS,21,29,20,25,0,0,0,95,NYK,20,27,21,20,0,0,0,88,20091227
2010,DET,22,19,28,26,0,0,0,95,TOR,29,31,14,28,0,0,0,102,20091227
2010,MIL,20,14,28,22,0,0,0,84,CHA,23,33,18,20,0,0,0,94,20091228
2010,BOS,35,23,18,23,0,0,0,99,GSW,22,35,23,23,0,0,0,103,20091228
2010,WAS,23,28,29,22,9,0,0,111,MEM,23,27,31,21,14,0,0,116,20091228
2010,OKC,32,29,23,21,0,0,0,105,NJN,27,28,21,13,0,0,0,89,20091228
2010,LAL,23,27,27,26,0,0,0,103,PHO,25,31,33,29,0,0,0,118,20091228
2010,PHI,22,21,34,27,0,0,0,104,POR,25,24,24,20,0,0,0,93,20091228
2010,DEN,32,16,22,31,0,0,0,101,SAC,26,21,28,31,0,0,0,106,20091228
2010,CLE,23,33,19,20,0,0,0,95,ATL,26,25,23,10,0,0,0,84,20091229
2010,IND,15,38,21,21,0,0,0,95,CHI,34,23,30,17,0,0,0,104,20091229
2010,NYK,27,22,30,25,0,0,0,104,DET,21,19,26,21,0,0,0,87,20091229
2010,NOH,23,28,31,18,0,0,0,100,HOU,31,30,13,34,0,0,0,108,20091229
2010,GSW,35,25,26,32,0,0,0,118,LAL,29,24,35,36,0,0,0,124,20091229
2010,MIN,24,28,21,26,0,0,0,99,SAS,29,37,23,28,0,0,0,117,20091229
2010,OKC,30,23,23,34,0,0,0,110,WAS,25,30,21,22,0,0,0,98,20091229
2010,ATL,30,34,21,16,0,0,0,101,CLE,23,29,25,29,0,0,0,106,20091230
2010,MEM,35,33,25,28,0,0,0,121,IND,29,22,28,31,0,0,0,110,20091230
2010,UTA,27,19,33,28,0,0,0,107,MIN,24,23,22,34,0,0,0,103,20091230
2010,NYK,28,25,19,23,0,0,0,95,NJN,27,33,25,19,0,0,0,104,20091230
2010,MIA,19,21,19,32,0,0,0,91,NOH,25,23,25,22,0,0,0,95,20091230
2010,MIL,25,24,25,18,0,0,0,92,ORL,21,20,38,38,0,0,0,117,20091230
2010,BOS,20,29,24,25,0,0,0,98,PHO,30,31,29,26,0,0,0,116,20091230
2010,LAC,20,28,28,23,0,0,0,99,POR,25,32,24,22,0,0,0,103,20091230
2010,PHI,17,33,29,37,0,0,0,116,SAC,28,22,26,30,0,0,0,106,20091230
2010,CHA,26,30,24,23,0,0,0,103,TOR,31,24,29,23,0,0,0,107,20091230
2010,CHI,25,19,25,29,0,0,0,98,DET,19,20,17,31,0,0,0,87,20091231
2010,DAL,17,30,23,24,0,0,0,94,HOU,24,32,22,19,0,0,0,97,20091231
2010,PHI,31,20,14,23,0,0,0,88,LAC,26,23,29,26,0,0,0,104,20091231
2010,UTA,24,22,16,24,0,0,0,86,OKC,22,26,17,22,0,0,0,87,20091231
2010,MIA,26,23,13,16,0,0,0,78,SAS,26,32,28,22,0,0,0,108,20091231
2010,NYK,22,33,12,32,13,0,0,112,ATL,26,28,26,19,9,0,0,108,20100101
2010,SAC,28,36,22,22,0,0,0,108,LAL,23,26,30,30,0,0,0,109,20100101
2010,ORL,24,27,22,33,0,0,0,106,MIN,26,19,26,23,0,0,0,94,20100101
2010,TOR,27,21,19,29,0,0,0,96,BOS,29,29,20,25,0,0,0,103,20100102
2010,ORL,29,19,24,21,0,0,0,93,CHI,26,26,32,17,0,0,0,101,20100102
2010,MIN,26,19,40,26,0,0,0,111,IND,32,41,25,24,0,0,0,122,20100102
2010,CHA,17,32,24,34,0,0,0,107,MIA,30,16,26,25,0,0,0,97,20100102
2010,OKC,20,29,24,15,9,0,0,97,MIL,23,25,23,17,15,0,0,103,20100102
2010,CLE,19,25,25,25,0,0,0,94,NJN,26,17,18,25,0,0,0,86,20100102
2010,HOU,26,24,27,18,0,0,0,95,NOH,24,22,25,28,0,0,0,99,20100102
2010,MEM,33,36,31,28,0,0,0,128,PHO,29,21,26,27,0,0,0,103,20100102
2010,GSW,41,15,17,16,0,0,0,89,POR,31,24,23,27,0,0,0,105,20100102
2010,DAL,25,30,22,22,0,0,0,99,SAC,27,21,19,24,0,0,0,91,20100102
2010,DEN,28,23,27,27,0,0,0,105,UTA,25,22,21,27,0,0,0,95,20100102
2010,SAS,30,20,20,27,0,0,0,97,WAS,24,26,21,15,0,0,0,86,20100102
2010,CHA,18,27,25,21,0,0,0,91,CLE,24,22,23,19,0,0,0,88,20100103
2010,PHI,27,32,25,24,0,0,0,108,DEN,36,24,16,29,0,0,0,105,20100103
2010,DAL,13,26,24,33,0,0,0,96,LAL,30,34,39,28,0,0,0,131,20100103
2010,IND,16,26,20,27,0,0,0,89,NYK,38,36,33,25,0,0,0,132,20100103
2010,SAS,19,15,21,31,0,0,0,86,TOR,27,21,19,24,0,0,0,91,20100103
2010,OKC,23,24,32,19,0,0,0,98,CHI,28,24,14,19,0,0,0,85,20100104
2010,POR,21,24,29,21,0,0,0,95,LAC,20,25,33,27,0,0,0,105,20100104
2010,ATL,14,20,24,17,0,0,0,75,MIA,30,21,22,19,0,0,0,92,20100104
2010,NOH,24,20,25,22,0,0,0,91,UTA,32,19,11,25,0,0,0,87,20100104
2010,CHI,28,24,28,28,0,0,0,108,CHA,31,28,28,26,0,0,0,113,20100105
2010,DET,22,22,24,25,0,0,0,93,DAL,14,22,32,30,0,0,0,98,20100105
2010,GSW,30,32,34,26,0,0,0,122,DEN,28,37,33,25,0,0,0,123,20100105
2010,ORL,19,20,23,28,0,0,0,90,IND,24,21,23,29,0,0,0,97,20100105
2010,HOU,15,18,22,24,0,0,0,79,LAL,22,19,18,29,0,0,0,88,20100105
2010,MIL,22,30,26,20,0,0,0,98,NJN,16,25,18,17,0,0,0,76,20100105
2010,WAS,23,21,34,26,0,0,0,104,PHI,26,32,22,17,0,0,0,97,20100105
2010,MEM,24,33,30,22,0,0,0,109,POR,25,33,21,26,0,0,0,105,20100105
2010,PHO,34,29,25,25,0,0,0,113,SAC,25,24,32,28,0,0,0,109,20100105
2010,NJN,15,30,25,19,0,0,0,89,ATL,32,29,28,30,0,0,0,119,20100106
2010,WAS,23,20,37,18,0,0,0,98,CLE,29,36,36,20,0,0,0,121,20100106
2010,LAL,26,17,30,18,0,0,0,91,LAC,25,27,27,23,0,0,0,102,20100106
2010,BOS,30,27,18,26,11,0,0,112,MIA,35,19,24,23,5,0,0,106,20100106
2010,GSW,34,27,17,29,0,0,0,107,MIN,22,22,23,34,0,0,0,101,20100106
2010,NOH,23,25,31,18,0,0,0,97,OKC,23,23,35,11,0,0,0,92,20100106
2010,TOR,23,35,28,22,0,0,0,108,ORL,27,22,19,35,0,0,0,103,20100106
2010,HOU,33,27,26,24,0,0,0,110,PHO,36,17,32,33,0,0,0,118,20100106
2010,DET,28,24,23,17,0,0,0,92,SAS,27,32,18,35,0,0,0,112,20100106
2010,MEM,28,20,23,23,0,0,0,94,UTA,28,32,31,26,0,0,0,117,20100106
2010,CHA,22,22,27,22,0,0,0,93,NYK,28,21,19,29,0,0,0,97,20100107
2010,BOS,17,28,15,25,0,0,0,85,ATL,19,20,29,25,0,0,0,93,20100108
2010,CLE,24,25,24,24,0,0,0,97,DEN,30,18,21,30,0,0,0,99,20100108
2010,SAC,32,29,25,15,0,0,0,101,GSW,28,18,30,32,0,0,0,108,20100108
2010,UTA,14,26,27,22,0,0,0,89,MEM,33,16,22,20,0,0,0,91,20100108
2010,CHI,19,22,23,29,0,0,0,93,MIL,29,18,17,32,0,0,0,96,20100108
2010,IND,26,36,19,28,0,0,0,109,MIN,26,35,31,24,0,0,0,116,20100108
2010,NJN,18,27,27,27,0,0,0,99,NOH,25,29,27,22,0,0,0,103,20100108
2010,TOR,23,26,34,25,0,0,0,108,PHI,32,28,25,21,0,0,0,106,20100108
2010,MIA,27,32,22,28,0,0,0,109,PHO,33,20,23,29,0,0,0,105,20100108
2010,LAL,24,19,28,27,0,0,0,98,POR,30,25,26,26,0,0,0,107,20100108
2010,DAL,26,25,19,42,0,0,0,112,SAS,26,28,26,23,0,0,0,103,20100108
2010,ORL,29,27,21,20,0,0,0,97,WAS,29,22,20,33,0,0,0,104,20100108
2010,MEM,21,31,16,19,0,0,0,87,CHA,25,17,22,25,0,0,0,89,20100109
2010,MIN,32,14,18,32,0,0,0,96,CHI,28,24,27,31,0,0,0,110,20100109
2010,UTA,26,24,33,28,0,0,0,111,DAL,18,22,22,31,0,0,0,93,20100109
2010,PHI,26,30,20,28,0,0,0,104,DET,10,20,29,35,0,0,0,94,20100109
2010,NYK,32,25,22,17,0,0,0,96,HOU,21,30,27,27,0,0,0,105,20100109
2010,IND,21,26,27,28,0,0,0,102,OKC,24,29,34,21,0,0,0,108,20100109
2010,ATL,21,16,22,22,0,0,0,81,ORL,29,37,25,22,0,0,0,113,20100109
2010,DEN,26,28,22,24,0,0,0,100,SAC,19,24,30,29,0,0,0,102,20100109
2010,MIA,20,21,17,26,0,0,0,84,LAC,30,26,23,15,0,0,0,94,20100110
2010,MIL,8,20,18,31,0,0,0,77,LAL,24,15,26,30,0,0,0,95,20100110
2010,CLE,34,30,18,24,0,0,0,106,POR,29,20,29,16,0,0,0,94,20100110
2010,NJN,22,25,18,20,0,0,0,85,SAS,20,29,28,20,0,0,0,97,20100110
2010,BOS,29,30,34,21,0,0,0,114,TOR,26,24,30,27,0,0,0,107,20100110
2010,NOH,28,32,20,35,0,0,0,115,WAS,31,18,33,28,0,0,0,110,20100110
2010,ATL,21,25,31,25,0,0,0,102,BOS,31,24,25,16,0,0,0,96,20100111
2010,DET,25,22,22,18,0,0,0,87,CHI,28,33,36,23,0,0,0,120,20100111
2010,MIN,15,35,20,24,0,0,0,94,DEN,20,38,27,20,0,0,0,105,20100111
2010,CLE,33,29,31,24,0,0,0,117,GSW,31,23,29,31,0,0,0,114,20100111
2010,TOR,30,35,19,17,0,0,0,101,IND,22,30,26,27,0,0,0,105,20100111
2010,NYK,24,23,15,26,0,0,0,88,OKC,34,29,21,22,0,0,0,106,20100111
2010,NOH,12,31,31,18,0,0,0,92,PHI,27,21,27,21,0,0,0,96,20100111
2010,MIL,15,27,34,25,0,0,0,101,PHO,36,18,25,26,0,0,0,105,20100111
2010,MIA,22,25,24,18,0,0,0,89,UTA,24,34,32,28,0,0,0,118,20100111
2010,HOU,34,26,17,17,0,0,0,94,CHA,29,21,24,28,0,0,0,102,20100112
2010,LAC,37,28,25,12,0,0,0,102,MEM,26,26,27,25,0,0,0,104,20100112
2010,ORL,24,27,25,33,0,0,0,109,SAC,24,31,23,10,0,0,0,88,20100112
2010,LAL,23,18,22,22,0,0,0,85,SAS,27,26,22,30,0,0,0,105,20100112
2010,DET,21,27,19,32,0,0,0,99,WAS,27,11,26,26,0,0,0,90,20100112
2010,WAS,13,20,29,20,0,0,0,82,ATL,17,28,21,28,0,0,0,94,20100113
2010,LAL,27,22,27,24,0,0,0,100,DAL,24,21,26,24,0,0,0,95,20100113
2010,ORL,25,28,19,25,0,0,0,97,DEN,25,25,35,30,0,0,0,115,20100113
2010,MIA,22,30,38,25,0,0,0,115,GSW,23,21,32,26,0,0,0,102,20100113
2010,MIN,13,31,17,28,9,7,9,114,HOU,30,23,16,20,9,7,15,120,20100113
2010,PHO,35,33,23,23,0,0,0,114,IND,24,28,39,31,0,0,0,122,20100113
2010,BOS,38,33,19,21,0,0,0,111,NJN,22,13,29,23,0,0,0,87,20100113
2010,LAC,25,23,22,24,0,0,0,94,NOH,28,22,28,30,0,0,0,108,20100113
2010,SAS,35,28,13,23,10,0,0,109,OKC,18,33,26,22,9,0,0,108,20100113
2010,NYK,30,17,21,25,0,0,0,93,PHI,26,22,20,24,0,0,0,92,20100113
2010,MIL,16,30,25,37,0,0,0,108,POR,31,35,31,23,0,0,0,120,20100113
2010,CHI,29,18,23,26,0,0,0,96,BOS,18,21,24,20,0,0,0,83,20100114
2010,CLE,26,21,13,36,0,0,0,96,UTA,19,21,15,42,0,0,0,97,20100114
2010,PHO,25,30,20,26,0,0,0,101,ATL,17,33,28,24,0,0,0,102,20100115
2010,SAS,24,18,15,19,0,0,0,76,CHA,22,16,26,28,0,0,0,92,20100115
2010,WAS,24,24,29,27,8,7,0,119,CHI,26,21,27,30,8,9,0,121,20100115
2010,OKC,28,27,16,27,0,0,0,98,DAL,19,29,26,25,0,0,0,99,20100115
2010,NOH,16,28,25,27,8,0,0,104,DET,31,24,21,20,14,0,0,110,20100115
2010,MIL,21,27,36,29,0,0,0,113,GSW,23,33,23,25,0,0,0,104,20100115
2010,MIA,27,35,29,24,0,0,0,115,HOU,29,24,24,29,0,0,0,106,20100115
2010,LAC,25,25,17,19,0,0,0,86,LAL,28,25,36,37,0,0,0,126,20100115
2010,MIN,30,29,22,29,0,0,0,110,MEM,35,31,40,29,0,0,0,135,20100115
2010,IND,31,41,24,25,0,0,0,121,NJN,28,24,24,29,0,0,0,105,20100115
2010,TOR,39,28,26,19,0,0,0,112,NYK,20,23,37,24,0,0,0,104,20100115
2010,SAC,25,22,24,15,0,0,0,86,PHI,32,17,25,24,0,0,0,98,20100115
2010,ORL,14,18,27,28,0,0,0,87,POR,24,28,25,25,0,0,0,102,20100115
2010,PHO,22,25,30,22,0,0,0,99,CHA,43,31,31,20,0,0,0,125,20100116
2010,NYK,24,13,23,30,0,0,0,90,DET,23,28,26,17,0,0,0,94,20100116
2010,NOH,26,26,23,26,0,0,0,101,IND,25,23,20,28,0,0,0,96,20100116
2010,CLE,23,24,26,29,0,0,0,102,LAC,26,30,22,23,0,0,0,101,20100116
2010,SAS,27,15,23,21,0,0,0,86,MEM,24,28,23,17,0,0,0,92,20100116
2010,MIA,19,26,22,13,0,0,0,80,OKC,29,26,29,14,0,0,0,98,20100116
2010,MIL,20,27,24,24,0,0,0,95,UTA,31,29,29,23,0,0,0,112,20100116
2010,SAC,23,21,22,20,0,0,0,86,WAS,22,26,22,26,0,0,0,96,20100116
2010,UTA,28,25,28,31,0,0,0,112,DEN,28,32,25,34,0,0,0,119,20100117
2010,DAL,23,18,27,20,0,0,0,88,TOR,20,34,30,26,0,0,0,110,20100117
2010,OKC,29,23,27,15,0,0,0,94,ATL,22,27,26,16,0,0,0,91,20100118
2010,DAL,20,21,34,24,0,0,0,99,BOS,25,25,18,22,0,0,0,90,20100118
2010,SAC,23,24,25,31,0,0,0,103,CHA,32,34,18,21,0,0,0,105,20100118
2010,CHI,25,28,26,18,0,0,0,97,GSW,33,21,29,31,0,0,0,114,20100118
2010,MIL,34,17,22,18,7,0,0,98,HOU,27,31,21,12,10,0,0,101,20100118
2010,NJN,24,25,17,29,0,0,0,95,LAC,39,22,27,18,0,0,0,106,20100118
2010,ORL,25,22,21,24,0,0,0,92,LAL,33,19,12,34,0,0,0,98,20100118
2010,PHO,20,36,30,32,0,0,0,118,MEM,34,24,30,37,0,0,0,125,20100118
2010,PHI,29,28,18,24,4,0,0,103,MIN,17,23,33,26,9,0,0,108,20100118
2010,SAS,29,27,22,19,0,0,0,97,NOH,16,25,20,29,0,0,0,90,20100118
2010,DET,23,20,27,21,0,0,0,91,NYK,23,34,11,31,0,0,0,99,20100118
2010,POR,21,17,35,19,0,0,0,92,WAS,24,19,27,27,0,0,0,97,20100118
2010,TOR,28,32,23,17,0,0,0,100,CLE,28,34,29,17,0,0,0,108,20100119
2010,IND,19,24,15,25,0,0,0,83,MIA,36,26,23,28,0,0,0,113,20100119
2010,SAC,23,29,16,29,0,0,0,97,ATL,23,31,27,27,0,0,0,108,20100120
2010,MIA,17,17,19,12,0,0,0,65,CHA,38,23,26,17,0,0,0,104,20100120
2010,BOS,30,26,13,17,0,0,0,86,DET,21,27,21,23,0,0,0,92,20100120
2010,DEN,30,23,28,24,18,0,0,123,GSW,25,28,29,23,13,0,0,118,20100120
2010,CHI,26,21,23,27,0,0,0,97,LAC,19,31,25,29,0,0,0,104,20100120
2010,TOR,24,32,22,29,0,0,0,107,MIL,22,27,32,32,0,0,0,113,20100120
2010,OKC,24,31,22,17,0,0,0,94,MIN,24,27,18,23,0,0,0,92,20100120
2010,MEM,24,30,31,26,0,0,0,111,NOH,31,33,18,31,0,0,0,113,20100120
2010,IND,20,26,28,24,0,0,0,98,ORL,40,28,26,15,0,0,0,109,20100120
2010,POR,22,25,24,27,0,0,0,98,PHI,21,21,26,22,0,0,0,90,20100120
2010,NJN,26,23,28,17,0,0,0,94,PHO,32,24,34,28,0,0,0,118,20100120
2010,UTA,21,24,29,31,0,0,0,105,SAS,22,28,20,28,0,0,0,98,20100120
2010,DAL,25,25,20,24,0,0,0,94,WAS,20,27,20,26,0,0,0,93,20100120
2010,LAL,27,19,19,22,0,0,0,87,CLE,18,26,23,26,0,0,0,93,20100121
2010,LAC,24,24,17,20,0,0,0,85,DEN,24,23,34,24,0,0,0,105,20100121
2010,CHA,17,26,22,24,0,0,0,89,ATL,31,16,36,20,0,0,0,103,20100122
2010,POR,25,25,19,22,4,0,0,95,BOS,30,25,19,17,7,0,0,98,20100122
2010,IND,31,22,32,20,0,0,0,105,DET,19,26,22,26,0,0,0,93,20100122
2010,NJN,21,23,21,14,0,0,0,79,GSW,26,24,38,23,0,0,0,111,20100122
2010,OKC,20,29,20,15,0,0,0,84,MEM,28,20,24,14,0,0,0,86,20100122
2010,NOH,26,27,21,22,0,0,0,96,MIN,24,29,18,23,0,0,0,94,20100122
2010,LAL,36,27,21,31,0,0,0,115,NYK,30,33,22,20,0,0,0,105,20100122
2010,SAC,22,10,17,35,0,0,0,84,ORL,23,25,29,23,0,0,0,100,20100122
2010,DAL,25,23,12,21,0,0,0,81,PHI,24,30,18,20,0,0,0,92,20100122
2010,CHI,35,29,24,27,0,0,0,115,PHO,26,28,29,21,0,0,0,104,20100122
2010,HOU,28,27,28,33,0,0,0,116,SAS,31,25,21,32,0,0,0,109,20100122
2010,MIL,25,32,16,23,0,0,0,96,TOR,28,20,20,33,0,0,0,101,20100122
2010,MIA,32,25,28,27,0,0,0,112,WAS,15,27,22,24,0,0,0,88,20100122
2010,ORL,24,25,20,23,14,0,0,106,CHA,21,24,14,33,3,0,0,95,20100123
2010,OKC,23,20,35,21,0,0,0,99,CLE,26,30,21,23,0,0,0,100,20100123
2010,NOH,33,21,24,23,9,0,0,110,DEN,32,21,26,22,15,0,0,116,20100123
2010,POR,32,24,18,23,0,0,0,97,DET,21,21,27,24,0,0,0,93,20100123
2010,CHI,32,32,16,24,0,0,0,104,HOU,21,31,23,22,0,0,0,97,20100123
2010,PHI,27,30,29,21,0,0,0,107,IND,29,21,23,24,0,0,0,97,20100123
2010,SAC,25,20,16,23,0,0,0,84,MIA,33,32,24,26,0,0,0,115,20100123
2010,MIN,23,22,22,27,0,0,0,94,MIL,32,23,30,42,0,0,0,127,20100123
2010,GSW,28,32,20,23,0,0,0,103,PHO,25,30,24,33,0,0,0,112,20100123
2010,NJN,21,21,21,20,0,0,0,83,UTA,34,26,34,22,0,0,0,116,20100123
2010,DAL,27,32,38,31,0,0,0,128,NYK,25,18,13,22,0,0,0,78,20100124
2010,LAL,24,32,28,21,0,0,0,105,TOR,21,33,28,24,0,0,0,106,20100124
2010,LAC,30,18,23,21,0,0,0,92,WAS,26,20,22,10,0,0,0,78,20100124
2010,LAC,19,25,15,30,0,0,0,89,BOS,17,26,21,31,0,0,0,95,20100125
2010,CHA,26,26,21,20,0,0,0,93,DEN,29,27,28,20,0,0,0,104,20100125
2010,ATL,23,32,22,25,0,0,0,102,HOU,25,19,23,28,0,0,0,95,20100125
2010,ORL,23,27,29,15,0,0,0,94,MEM,22,30,25,22,0,0,0,99,20100125
2010,CLE,24,26,17,25,0,0,0,92,MIA,34,20,15,22,0,0,0,91,20100125
2010,IND,25,31,24,29,0,0,0,109,PHI,29,30,17,22,0,0,0,98,20100125
2010,NOH,31,16,25,26,0,0,0,98,POR,23,26,24,24,0,0,0,97,20100125
2010,CHI,29,23,18,28,0,0,0,98,SAS,31,19,21,22,0,0,0,93,20100125
2010,PHO,24,45,27,19,0,0,0,115,UTA,24,34,33,33,0,0,0,124,20100125
2010,MIL,27,26,24,30,0,0,0,107,DAL,28,31,24,25,0,0,0,108,20100126
2010,MIN,16,29,19,41,0,0,0,105,NYK,40,28,28,36,0,0,0,132,20100126
2010,CHA,26,22,29,21,16,0,0,114,PHO,33,21,29,15,11,0,0,109,20100126
2010,GSW,18,20,22,36,0,0,0,96,SAC,23,26,24,26,0,0,0,99,20100126
2010,LAL,30,30,27,28,0,0,0,115,WAS,29,15,28,31,0,0,0,103,20100126
2010,MIN,26,22,18,29,0,0,0,95,CLE,27,33,25,24,0,0,0,109,20100127
2010,MEM,27,29,23,20,0,0,0,99,DET,21,29,24,19,0,0,0,93,20100127
2010,NOH,33,29,34,27,0,0,0,123,GSW,30,25,20,35,0,0,0,110,20100127
2010,DEN,16,34,22,25,0,0,0,97,HOU,31,20,23,18,0,0,0,92,20100127
2010,LAL,31,28,33,26,0,0,0,118,IND,29,27,22,18,0,0,0,96,20100127
2010,PHI,19,27,23,19,0,0,0,88,MIL,20,28,24,19,0,0,0,91,20100127
2010,LAC,20,21,23,23,0,0,0,87,NJN,23,28,20,32,0,0,0,103,20100127
2010,CHI,28,28,12,28,0,0,0,96,OKC,30,17,19,20,0,0,0,86,20100127
2010,UTA,37,26,22,21,0,0,0,106,POR,16,30,29,20,0,0,0,95,20100127
2010,ATL,21,23,30,16,0,0,0,90,SAS,36,30,21,18,0,0,0,105,20100127
2010,MIA,34,26,21,22,0,0,0,103,TOR,23,34,28,26,0,0,0,111,20100127
2010,TOR,20,29,30,27,0,0,0,106,NYK,34,19,28,23,0,0,0,104,20100128
2010,BOS,34,17,21,22,0,0,0,94,ORL,23,17,21,35,0,0,0,96,20100128
2010,DAL,34,25,31,16,0,0,0,106,PHO,25,30,29,28,0,0,0,112,20100128
2010,BOS,22,19,32,18,0,0,0,91,ATL,23,30,21,26,0,0,0,100,20100129
2010,MIA,26,21,24,21,0,0,0,92,DET,23,13,12,17,0,0,0,65,20100129
2010,CHA,24,41,27,29,0,0,0,121,GSW,28,31,21,30,0,0,0,110,20100129
2010,POR,28,19,24,29,0,0,0,100,HOU,18,31,29,26,0,0,0,104,20100129
2010,CLE,36,22,19,17,0,0,0,94,IND,18,26,20,9,0,0,0,73,20100129
2010,LAC,20,17,36,24,0,0,0,97,MIN,34,22,26,29,0,0,0,111,20100129
2010,WAS,18,28,17,18,0,0,0,81,NJN,26,21,19,13,0,0,0,79,20100129
2010,CHI,30,27,31,14,6,0,0,108,NOH,29,21,27,25,4,0,0,106,20100129
2010,DEN,26,19,15,24,0,0,0,84,OKC,27,24,28,22,0,0,0,101,20100129
2010,LAL,19,32,25,23,0,0,0,99,PHI,18,24,25,24,0,0,0,91,20100129
2010,MEM,21,29,20,27,0,0,0,97,SAS,28,25,24,27,0,0,0,104,20100129
2010,SAC,20,26,17,31,0,0,0,94,UTA,22,27,24,28,0,0,0,101,20100129
2010,POR,26,18,29,30,11,0,0,114,DAL,21,26,22,34,9,0,0,112,20100130
2010,NOH,18,24,34,21,12,0,0,109,MEM,33,28,20,16,5,0,0,102,20100130
2010,MIA,21,17,20,26,0,0,0,84,MIL,23,33,15,24,0,0,0,95,20100130
2010,ATL,18,26,19,23,0,0,0,86,ORL,21,28,28,27,0,0,0,104,20100130
2010,CHA,29,27,34,13,0,0,0,103,SAC,33,21,13,29,0,0,0,96,20100130
2010,NYK,19,25,25,27,0,0,0,96,WAS,36,14,32,24,0,0,0,106,20100130
2010,LAL,30,17,19,24,0,0,0,90,BOS,19,33,21,16,0,0,0,89,20100131
2010,LAC,20,19,28,22,0,0,0,89,CLE,46,21,16,31,0,0,0,114,20100131
2010,ORL,29,19,16,27,0,0,0,91,DET,21,24,20,21,0,0,0,86,20100131
2010,PHO,28,32,19,21,15,0,0,115,HOU,21,27,25,27,11,0,0,111,20100131
2010,NYK,26,20,26,19,0,0,0,91,MIN,23,26,33,30,0,0,0,112,20100131
2010,PHI,22,24,23,14,0,0,0,83,NJN,25,23,12,19,0,0,0,79,20100131
2010,GSW,26,29,20,29,0,0,0,104,OKC,29,25,33,25,0,0,0,112,20100131
2010,DEN,21,24,30,28,0,0,0,103,SAS,23,18,27,21,0,0,0,89,20100131
2010,IND,29,30,27,16,0,0,0,102,TOR,32,31,32,22,0,0,0,117,20100131
2010,SAC,26,38,14,21,10,0,0,109,DEN,26,24,23,26,13,0,0,112,20100201
2010,LAL,24,26,21,22,0,0,0,93,MEM,24,28,18,25,0,0,0,95,20100201
2010,MIL,21,33,22,21,0,0,0,97,MIA,17,21,21,22,0,0,0,81,20100201
2010,PHO,30,29,26,24,0,0,0,109,NOH,31,15,24,30,0,0,0,100,20100201
2010,CHA,19,24,22,14,0,0,0,79,POR,29,22,21,26,0,0,0,98,20100201
2010,DAL,26,20,30,16,0,0,0,92,UTA,24,29,24,27,0,0,0,104,20100201
2010,BOS,24,24,26,25,0,0,0,99,WAS,23,31,24,10,0,0,0,88,20100201
2010,LAC,31,19,28,12,0,0,0,90,CHI,26,16,21,19,0,0,0,82,20100202
2010,MEM,16,21,25,27,0,0,0,89,CLE,28,27,31,19,0,0,0,105,20100202
2010,GSW,25,24,19,29,0,0,0,97,HOU,39,20,24,36,0,0,0,119,20100202
2010,TOR,34,19,33,29,0,0,0,115,IND,32,26,42,30,0,0,0,130,20100202
2010,DET,24,19,28,26,0,0,0,97,NJN,29,19,19,26,0,0,0,93,20100202
2010,ATL,22,27,23,27,0,0,0,99,OKC,22,27,30,27,0,0,0,106,20100202
2010,MIL,26,10,21,25,0,0,0,82,ORL,23,27,25,24,0,0,0,99,20100202
2010,LAC,23,23,26,25,0,0,0,97,ATL,17,24,28,34,0,0,0,103,20100203
2010,MIA,26,25,23,28,0,0,0,102,BOS,27,26,21,33,0,0,0,107,20100203
2010,GSW,21,27,27,26,0,0,0,101,DAL,32,30,19,29,0,0,0,110,20100203
2010,PHO,28,32,26,23,0,0,0,109,DEN,22,27,23,25,0,0,0,97,20100203
2010,CHA,21,26,20,30,0,0,0,97,LAL,19,30,23,27,0,0,0,99,20100203
2010,OKC,22,36,24,21,0,0,0,103,NOH,22,30,24,23,0,0,0,99,20100203
2010,WAS,22,23,20,20,0,0,0,85,NYK,22,19,31,35,0,0,0,107,20100203
2010,CHI,25,26,19,24,9,0,0,103,PHI,26,19,26,23,12,0,0,106,20100203
2010,SAS,31,30,27,27,0,0,0,115,SAC,29,31,23,30,0,0,0,113,20100203
2010,NJN,22,34,22,21,0,0,0,99,TOR,28,29,26,25,0,0,0,108,20100203
2010,POR,27,25,25,28,0,0,0,105,UTA,29,31,28,30,0,0,0,118,20100203
2010,MIA,28,24,21,13,0,0,0,86,CLE,29,27,25,21,0,0,0,102,20100204
2010,SAS,24,29,21,19,0,0,0,93,POR,26,25,15,30,0,0,0,96,20100204
2010,CHI,20,26,24,11,0,0,0,81,ATL,27,23,14,27,0,0,0,91,20100205
2010,NJN,25,30,18,14,0,0,0,87,BOS,29,22,21,24,0,0,0,96,20100205
2010,MIN,32,25,32,28,0,0,0,117,DAL,29,32,19,28,0,0,0,108,20100205
2010,DET,20,17,19,27,0,0,0,83,IND,24,28,24,31,0,0,0,107,20100205
2010,DEN,30,29,35,32,0,0,0,126,LAL,30,34,25,24,0,0,0,113,20100205
2010,HOU,25,25,25,26,0,0,0,101,MEM,25,19,22,17,0,0,0,83,20100205
2010,PHI,25,31,20,25,0,0,0,101,NOH,23,24,23,24,0,0,0,94,20100205
2010,MIL,29,25,36,24,0,0,0,114,NYK,26,33,22,26,0,0,0,107,20100205
2010,WAS,13,22,39,18,0,0,0,92,ORL,32,18,17,24,0,0,0,91,20100205
2010,PHO,39,27,30,18,0,0,0,114,SAC,24,27,20,31,0,0,0,102,20100205
2010,NOH,21,22,36,25,0,0,0,104,CHA,26,27,21,25,0,0,0,99,20100206
2010,MIA,27,15,27,22,0,0,0,91,CHI,23,26,20,26,0,0,0,95,20100206
2010,NYK,24,30,26,26,0,0,0,106,CLE,44,30,20,19,0,0,0,113,20100206
2010,NJN,18,29,24,21,0,0,0,92,DET,26,30,22,21,0,0,0,99,20100206
2010,OKC,26,26,36,16,0,0,0,104,GSW,27,23,23,22,0,0,0,95,20100206
2010,PHI,26,21,23,32,0,0,0,102,HOU,22,35,19,19,0,0,0,95,20100206
2010,SAS,28,21,33,16,0,0,0,98,LAC,10,17,35,19,0,0,0,81,20100206
2010,IND,21,25,17,18,0,0,0,81,MIL,31,22,17,23,0,0,0,93,20100206
2010,MEM,27,26,25,24,0,0,0,102,MIN,17,30,29,33,0,0,0,109,20100206
2010,LAL,26,28,19,26,0,0,0,99,POR,29,19,16,18,0,0,0,82,20100206
2010,DEN,28,27,31,20,0,0,0,106,UTA,38,28,27,23,0,0,0,116,20100206
2010,ORL,23,17,36,20,0,0,0,96,BOS,24,27,11,27,0,0,0,89,20100207
2010,SAC,24,35,28,17,0,0,0,104,TOR,31,31,22,31,0,0,0,115,20100207
2010,DAL,29,32,29,37,0,0,0,127,GSW,34,36,28,19,0,0,0,117,20100208
2010,SAS,34,13,21,21,0,0,0,89,LAL,28,22,23,28,0,0,0,101,20100208
2010,NOH,32,38,24,23,0,0,0,117,ORL,28,27,32,36,0,0,0,123,20100208
2010,WAS,27,22,21,22,0,0,0,92,CHA,24,26,23,21,0,0,0,94,20100209
2010,NJN,27,22,23,25,0,0,0,97,CLE,26,29,23,26,0,0,0,104,20100209
2010,DAL,21,18,31,21,0,0,0,91,DEN,32,33,38,24,0,0,0,127,20100209
2010,CHI,29,28,24,28,0,0,0,109,IND,28,32,26,15,0,0,0,101,20100209
2010,UTA,29,23,28,29,0,0,0,109,LAC,26,30,28,15,0,0,0,99,20100209
2010,ATL,27,26,29,26,0,0,0,108,MEM,30,25,20,19,0,0,0,94,20100209
2010,HOU,16,15,24,11,0,0,0,66,MIA,24,32,24,19,0,0,0,99,20100209
2010,DET,20,25,19,29,0,0,0,93,MIL,9,29,24,19,0,0,0,81,20100209
2010,SAC,26,26,24,29,13,0,0,118,NYK,33,23,28,21,9,0,0,114,20100209
2010,MIN,23,28,25,21,0,0,0,97,PHI,30,43,24,22,0,0,0,119,20100209
2010,OKC,23,18,18,30,0,0,0,89,POR,17,24,20,16,0,0,0,77,20100209
2010,MIA,20,23,24,27,0,0,0,94,ATL,27,15,22,12,0,0,0,76,20100210
2010,ORL,41,26,22,18,0,0,0,107,CHI,17,28,19,23,0,0,0,87,20100210
2010,SAC,20,35,23,25,0,0,0,103,DET,22,34,23,18,0,0,0,97,20100210
2010,LAC,20,26,28,28,0,0,0,102,GSW,38,26,46,22,0,0,0,132,20100210
2010,CHA,37,19,24,13,0,0,0,93,MIN,24,19,27,22,0,0,0,92,20100210
2010,MIL,20,24,24,29,0,0,0,97,NJN,26,18,16,17,0,0,0,77,20100210
2010,BOS,27,28,12,18,0,0,0,85,NOH,29,14,29,21,0,0,0,93,20100210
2010,POR,30,30,23,25,0,0,0,108,PHO,20,24,23,34,0,0,0,101,20100210
2010,PHI,24,17,22,30,0,0,0,93,TOR,30,20,28,26,0,0,0,104,20100210
2010,LAL,31,25,20,20,0,0,0,96,UTA,18,23,16,24,0,0,0,81,20100210
2010,ORL,23,40,20,23,0,0,0,106,CLE,37,29,21,28,0,0,0,115,20100211
2010,SAS,32,22,29,28,0,0,0,111,DEN,29,16,25,22,0,0,0,92,20100211
2010,NJN,31,21,30,21,0,0,0,103,CHA,27,25,21,21,0,0,0,94,20100216
2010,NYK,28,22,18,17,0,0,0,85,CHI,29,35,31,23,0,0,0,118,20100216
2010,MIN,31,21,13,20,0,0,0,85,DET,25,27,33,23,0,0,0,108,20100216
2010,UTA,28,21,27,28,0,0,0,104,HOU,23,32,19,21,0,0,0,95,20100216
2010,GSW,24,27,22,21,0,0,0,94,LAL,36,18,25,25,0,0,0,104,20100216
2010,PHO,27,36,24,22,0,0,0,109,MEM,30,25,19,21,0,0,0,95,20100216
2010,DAL,26,28,11,21,0,0,0,86,OKC,16,40,22,21,0,0,0,99,20100216
2010,MIA,23,23,33,26,0,0,0,105,PHI,21,14,17,26,0,0,0,78,20100216
2010,LAC,20,18,27,22,0,0,0,87,POR,26,23,29,31,0,0,0,109,20100216
2010,BOS,30,27,19,19,0,0,0,95,SAC,30,22,17,23,0,0,0,92,20100216
2010,PHO,23,26,19,29,0,0,0,97,DAL,28,28,26,25,0,0,0,107,20100217
2010,SAC,29,16,31,22,0,0,0,98,GSW,30,42,35,23,0,0,0,130,20100217
2010,SAS,24,27,18,21,0,0,0,90,IND,28,17,22,20,0,0,0,87,20100217
2010,ATL,29,27,25,29,0,0,0,110,LAC,26,18,31,17,0,0,0,92,20100217
2010,HOU,20,37,43,27,0,0,0,127,MIL,20,32,14,33,0,0,0,99,20100217
2010,MIA,23,28,19,17,0,0,0,87,NJN,22,23,21,18,0,0,0,84,20100217
2010,UTA,17,24,31,26,0,0,0,98,NOH,23,20,28,19,0,0,0,90,20100217
2010,CHI,25,28,29,33,0,0,0,115,NYK,27,37,20,25,0,0,0,109,20100217
2010,DET,25,30,22,14,0,0,0,91,ORL,30,26,27,33,0,0,0,116,20100217
2010,MEM,28,21,22,26,12,0,0,109,TOR,16,31,22,28,5,0,0,102,20100217
2010,MIN,31,23,21,24,0,0,0,99,WAS,25,27,34,22,0,0,0,108,20100217
2010,DEN,31,21,23,31,12,0,0,118,CLE,21,23,35,27,10,0,0,116,20100218
2010,BOS,30,23,23,11,0,0,0,87,LAL,27,21,21,17,0,0,0,86,20100218
2010,CLE,32,18,18,25,0,0,0,93,CHA,27,23,32,28,0,0,0,110,20100219
2010,MIL,23,27,22,19,0,0,0,91,DET,29,17,19,20,0,0,0,85,20100219
2010,UTA,28,31,26,15,0,0,0,100,GSW,31,10,24,24,0,0,0,89,20100219
2010,MIA,21,25,17,13,9,15,0,100,MEM,14,17,26,19,9,2,0,87,20100219
2010,CHI,30,25,22,23,0,0,0,100,MIN,29,29,18,18,0,0,0,94,20100219
2010,TOR,32,24,26,24,0,0,0,106,NJN,21,20,30,18,0,0,0,89,20100219
2010,IND,19,24,28,30,0,0,0,101,NOH,31,31,21,24,0,0,0,107,20100219
2010,DAL,23,19,23,30,0,0,0,95,ORL,33,14,22,16,0,0,0,85,20100219
2010,SAS,26,26,24,18,0,0,0,94,PHI,25,20,28,33,0,0,0,106,20100219
2010,ATL,23,27,16,14,0,0,0,80,PHO,26,23,21,18,0,0,0,88,20100219
2010,BOS,32,24,17,23,0,0,0,96,POR,25,13,23,15,0,0,0,76,20100219
2010,DEN,25,35,22,15,0,0,0,97,WAS,28,24,21,34,0,0,0,107,20100219
2010,PHI,23,16,30,21,0,0,0,90,CHI,25,33,30,34,0,0,0,122,20100220
2010,MIA,27,25,12,27,0,0,0,91,DAL,21,23,27,26,0,0,0,97,20100220
2010,IND,27,27,36,35,0,0,0,125,HOU,30,35,25,25,0,0,0,115,20100220
2010,SAC,22,23,23,21,0,0,0,89,LAC,21,39,17,22,0,0,0,99,20100220
2010,CHA,16,23,23,26,0,0,0,88,MIL,24,30,19,20,0,0,0,93,20100220
2010,OKC,25,27,30,23,16,0,0,121,NYK,31,26,23,25,13,0,0,118,20100220
2010,WAS,32,25,31,16,0,0,0,104,TOR,34,30,21,24,0,0,0,109,20100220
2010,BOS,19,28,26,32,0,0,0,105,DEN,37,17,28,32,0,0,0,114,20100221
2010,SAS,24,21,22,26,8,0,0,101,DET,24,21,24,24,16,0,0,109,20100221
2010,ATL,24,28,38,14,0,0,0,104,GSW,21,30,22,35,0,0,0,108,20100221
2010,OKC,30,32,24,23,0,0,0,109,MIN,23,28,29,27,0,0,0,107,20100221
2010,MEM,20,27,31,26,0,0,0,104,NJN,36,22,16,20,0,0,0,94,20100221
2010,HOU,16,23,23,32,0,0,0,94,NOH,24,26,24,28,0,0,0,102,20100221
2010,CLE,18,25,32,20,0,0,0,95,ORL,25,24,25,27,0,0,0,101,20100221
2010,SAC,27,27,15,19,0,0,0,88,PHO,25,26,24,29,0,0,0,104,20100221
2010,UTA,14,24,22,23,10,0,0,93,POR,27,23,23,10,6,0,0,89,20100221
2010,IND,20,21,20,21,0,0,0,82,DAL,29,20,23,19,0,0,0,91,20100222
2010,CHA,23,27,24,20,0,0,0,94,LAC,30,23,18,27,0,0,0,98,20100222
2010,MIL,27,20,16,20,0,0,0,83,NYK,20,21,14,12,0,0,0,67,20100222
2010,ATL,28,26,20,31,0,0,0,105,UTA,24,27,24,25,0,0,0,100,20100222
2010,CHI,26,30,16,23,0,0,0,95,WAS,25,21,31,24,0,0,0,101,20100222
2010,NYK,27,33,31,15,0,0,0,106,BOS,38,26,30,16,0,0,0,110,20100223
2010,NOH,16,40,20,19,0,0,0,95,CLE,28,25,29,23,0,0,0,105,20100223
2010,PHI,37,29,24,20,0,0,0,110,GSW,26,22,25,29,0,0,0,102,20100223
2010,LAL,27,26,23,23,0,0,0,99,MEM,16,32,33,17,0,0,0,98,20100223
2010,MIN,24,21,23,23,0,0,0,91,MIA,15,26,17,30,0,0,0,88,20100223
2010,POR,32,24,21,25,0,0,0,102,NJN,22,15,33,23,0,0,0,93,20100223
2010,PHO,27,24,31,22,0,0,0,104,OKC,25,27,26,24,0,0,0,102,20100223
2010,DET,29,25,29,18,0,0,0,101,SAC,26,16,16,31,0,0,0,89,20100223
2010,MIN,21,21,24,26,0,0,0,92,ATL,23,27,28,20,0,0,0,98,20100224
2010,IND,18,36,28,28,0,0,0,110,CHI,37,21,37,25,0,0,0,120,20100224
2010,LAL,23,27,22,24,0,0,0,96,DAL,20,29,25,27,0,0,0,101,20100224
2010,ORL,23,37,25,25,0,0,0,110,HOU,18,22,34,18,0,0,0,92,20100224
2010,DET,25,24,22,20,0,0,0,91,LAC,22,19,26,30,0,0,0,97,20100224
2010,NOH,28,27,17,23,0,0,0,95,MIL,31,30,28,26,0,0,0,115,20100224
2010,PHI,25,22,27,21,0,0,0,95,PHO,33,25,31,17,0,0,0,106,20100224
2010,OKC,27,15,25,20,0,0,0,87,SAS,23,25,20,27,0,0,0,95,20100224
2010,POR,32,21,25,23,0,0,0,101,TOR,24,23,21,19,0,0,0,87,20100224
2010,CHA,31,22,16,24,0,0,0,93,UTA,28,14,31,29,0,0,0,102,20100224
2010,MEM,27,19,23,30,0,0,0,99,WAS,23,25,20,26,0,0,0,94,20100224
2010,CLE,21,27,25,35,0,0,0,108,BOS,31,25,18,14,0,0,0,88,20100225
2010,DEN,29,36,33,29,0,0,0,127,GSW,21,35,31,25,0,0,0,112,20100225
2010,MIL,30,31,28,23,0,0,0,112,IND,31,25,21,33,0,0,0,110,20100225
2010,DAL,29,21,15,34,12,0,0,111,ATL,19,31,26,23,4,0,0,103,20100226
2010,POR,22,29,28,24,8,0,0,111,CHI,31,21,28,23,12,0,0,115,20100226
2010,DET,29,20,26,27,0,0,0,102,DEN,22,31,24,30,0,0,0,107,20100226
2010,SAS,14,27,28,35,0,0,0,104,HOU,31,28,26,24,0,0,0,109,20100226
2010,PHI,25,26,18,21,0,0,0,90,LAL,24,26,24,25,0,0,0,99,20100226
2010,CHA,26,22,21,24,0,0,0,93,MEM,27,20,19,23,0,0,0,89,20100226
2010,ORL,21,35,24,13,0,0,0,93,NOH,26,20,26,28,0,0,0,100,20100226
2010,MIN,19,22,24,27,0,0,0,92,OKC,30,25,29,25,0,0,0,109,20100226
2010,LAC,28,31,27,26,0,0,0,112,PHO,36,27,33,29,0,0,0,125,20100226
2010,UTA,20,30,25,24,0,0,0,99,SAC,25,24,26,28,0,0,0,103,20100226
2010,CLE,33,27,26,25,15,0,0,126,TOR,30,30,22,29,7,0,0,118,20100226
2010,NYK,24,28,29,31,6,0,0,118,WAS,30,29,26,27,4,0,0,116,20100226
2010,NJN,29,20,25,30,0,0,0,104,BOS,27,15,22,32,0,0,0,96,20100227
2010,DET,22,28,19,19,0,0,0,88,GSW,14,23,29,29,0,0,0,95,20100227
2010,CHI,24,23,21,22,0,0,0,90,IND,25,29,26,20,0,0,0,100,20100227
2010,MIL,26,24,25,19,0,0,0,94,MIA,18,27,12,14,0,0,0,71,20100227
2010,POR,25,22,36,27,0,0,0,110,MIN,23,10,24,34,0,0,0,91,20100227
2010,MEM,31,25,29,35,0,0,0,120,NYK,23,29,36,21,0,0,0,109,20100227
2010,HOU,35,24,35,16,0,0,0,110,UTA,39,31,37,26,0,0,0,133,20100227
2010,MIL,24,22,27,19,10,0,0,102,ATL,24,20,30,18,14,0,0,106,20100228
2010,NOH,24,26,25,25,0,0,0,100,DAL,35,34,17,22,0,0,0,108,20100228
2010,DEN,29,23,18,19,0,0,0,89,LAL,21,22,24,28,0,0,0,95,20100228
2010,WAS,24,20,25,20,0,0,0,89,NJN,31,19,18,17,0,0,0,85,20100228
2010,TOR,24,23,20,32,0,0,0,99,OKC,34,27,30,28,0,0,0,119,20100228
2010,MIA,24,24,16,16,0,0,0,80,ORL,26,26,24,20,0,0,0,96,20100228
2010,LAC,18,24,26,24,0,0,0,92,SAC,32,24,20,21,0,0,0,97,20100228
2010,PHO,25,27,24,34,0,0,0,110,SAS,21,28,28,36,0,0,0,113,20100228
2010,DAL,24,19,23,23,0,0,0,89,CHA,28,25,15,16,0,0,0,84,20100301
2010,ATL,34,25,16,41,0,0,0,116,CHI,23,20,25,24,0,0,0,92,20100301
2010,NYK,26,22,11,34,0,0,0,93,CLE,38,36,27,23,0,0,0,124,20100301
2010,TOR,28,19,18,27,0,0,0,92,HOU,37,31,29,19,0,0,0,116,20100301
2010,UTA,19,24,27,34,0,0,0,104,LAC,29,24,29,26,0,0,0,108,20100301
2010,POR,21,20,41,21,0,0,0,103,MEM,27,26,21,19,0,0,0,93,20100301
2010,SAS,31,27,22,26,0,0,0,106,NOH,24,23,26,19,0,0,0,92,20100301
2010,ORL,35,33,34,24,0,0,0,126,PHI,36,25,20,24,0,0,0,105,20100301
2010,DEN,33,11,23,18,0,0,0,85,PHO,24,33,27,17,0,0,0,101,20100301
2010,BOS,25,30,17,33,0,0,0,105,DET,25,27,23,25,0,0,0,100,20100302
2010,IND,28,26,17,28,0,0,0,99,LAL,27,33,38,24,0,0,0,122,20100302
2010,GSW,34,20,24,28,0,0,0,106,MIA,33,23,30,24,0,0,0,110,20100302
2010,SAC,25,33,24,25,0,0,0,107,OKC,28,37,25,23,0,0,0,113,20100302
2010,PHI,22,29,17,25,0,0,0,93,ATL,32,29,26,25,0,0,0,112,20100303
2010,CHA,21,24,16,19,0,0,0,80,BOS,31,23,28,22,0,0,0,104,20100303
2010,MIN,28,25,34,22,0,0,0,109,DAL,30,30,29,23,0,0,0,112,20100303
2010,OKC,25,27,12,26,0,0,0,90,DEN,32,29,31,27,0,0,0,119,20100303
2010,SAC,22,21,26,15,0,0,0,84,HOU,17,20,28,16,0,0,0,81,20100303
2010,PHO,30,27,39,31,0,0,0,127,LAC,26,32,18,25,0,0,0,101,20100303
2010,WAS,26,22,12,27,0,0,0,87,MIL,28,28,21,23,0,0,0,100,20100303
2010,CLE,35,24,27,25,0,0,0,111,NJN,15,27,26,24,0,0,0,92,20100303
2010,MEM,29,25,20,30,0,0,0,104,NOH,24,27,25,24,0,0,0,100,20100303
2010,DET,23,32,30,19,0,0,0,104,NYK,33,34,27,34,0,0,0,128,20100303
2010,GSW,22,23,27,18,0,0,0,90,ORL,32,32,30,23,0,0,0,117,20100303
2010,IND,26,15,21,17,0,0,0,79,POR,32,21,26,23,0,0,0,102,20100303
2010,MEM,19,26,31,29,0,0,0,105,CHI,32,19,29,16,0,0,0,96,20100304
2010,LAL,27,20,21,31,12,0,0,111,MIA,26,18,30,25,15,0,0,114,20100304
2010,UTA,24,25,26,41,0,0,0,116,PHO,34,23,29,22,0,0,0,108,20100304
2010,GSW,35,28,25,34,0,0,0,122,ATL,35,28,29,35,0,0,0,127,20100305
2010,LAL,26,17,20,20,0,0,0,83,CHA,23,26,26,23,0,0,0,98,20100305
2010,DET,31,24,15,22,0,0,0,92,CLE,22,24,22,31,0,0,0,99,20100305
2010,SAC,26,27,19,28,0,0,0,100,DAL,24,28,33,23,0,0,0,108,20100305
2010,IND,28,28,26,32,0,0,0,114,DEN,38,26,33,25,0,0,0,122,20100305
2010,OKC,31,22,25,26,0,0,0,104,LAC,21,25,23,18,0,0,0,87,20100305
2010,ORL,32,18,22,25,0,0,0,97,NJN,18,25,14,30,0,0,0,87,20100305
2010,BOS,23,23,28,22,0,0,0,96,PHI,25,18,24,19,0,0,0,86,20100305
2010,NOH,19,26,24,22,0,0,0,91,SAS,29,25,20,28,0,0,0,102,20100305
2010,NYK,24,28,25,19,0,0,0,96,TOR,31,22,25,24,0,0,0,102,20100305
2010,MIL,28,23,30,21,0,0,0,102,WAS,19,17,19,19,0,0,0,74,20100305
2010,GSW,19,35,22,14,0,0,0,90,CHA,24,29,28,20,0,0,0,101,20100306
2010,DAL,30,36,28,28,0,0,0,122,CHI,26,29,25,36,0,0,0,116,20100306
2010,SAS,22,36,20,24,0,0,0,102,MEM,28,20,24,20,0,0,0,92,20100306
2010,ATL,27,29,21,17,0,0,0,94,MIA,22,30,24,24,0,0,0,100,20100306
2010,CLE,14,27,20,24,0,0,0,85,MIL,25,17,27,23,0,0,0,92,20100306
2010,HOU,33,27,29,23,0,0,0,112,MIN,22,28,23,25,0,0,0,98,20100306
2010,NJN,22,34,27,30,0,0,0,113,NYK,32,18,24,19,0,0,0,93,20100306
2010,IND,28,29,29,19,0,0,0,105,PHO,29,34,30,20,0,0,0,113,20100306
2010,LAC,32,18,22,13,0,0,0,85,UTA,26,25,32,24,0,0,0,107,20100306
2010,WAS,25,19,22,17,0,0,0,83,BOS,19,19,24,24,0,0,0,86,20100307
2010,POR,21,28,26,31,0,0,0,106,DEN,34,32,23,29,0,0,0,118,20100307
2010,HOU,20,35,31,16,5,0,0,107,DET,29,28,25,20,8,0,0,110,20100307
2010,LAL,24,24,16,30,0,0,0,94,ORL,31,21,22,22,0,0,0,96,20100307
2010,OKC,26,31,24,27,0,0,0,108,SAC,25,27,27,23,0,0,0,102,20100307
2010,PHI,24,31,34,25,0,0,0,114,TOR,24,23,28,26,0,0,0,101,20100307
2010,SAS,26,26,24,19,0,0,0,95,CLE,28,21,23,25,0,0,0,97,20100308
2010,NJN,27,24,26,24,0,0,0,101,MEM,32,35,14,26,0,0,0,107,20100308
2010,DAL,34,37,26,28,0,0,0,125,MIN,27,34,23,28,0,0,0,112,20100308
2010,GSW,25,37,33,36,0,0,0,131,NOH,36,31,33,35,0,0,0,135,20100308
2010,ATL,27,19,24,28,0,0,0,98,NYK,27,17,32,23,0,0,0,99,20100308
2010,MIA,30,18,18,12,0,0,0,78,CHA,20,19,23,21,0,0,0,83,20100309
2010,UTA,35,28,29,40,0,0,0,132,CHI,30,31,20,27,0,0,0,108,20100309
2010,PHI,29,23,15,29,0,0,0,96,IND,24,30,22,31,0,0,0,107,20100309
2010,TOR,24,34,26,23,0,0,0,107,LAL,29,21,31,28,0,0,0,109,20100309
2010,BOS,22,24,22,16,0,0,0,84,MIL,24,18,22,22,0,0,0,86,20100309
2010,LAC,21,20,27,19,0,0,0,87,ORL,31,36,24,22,0,0,0,113,20100309
2010,SAC,29,13,20,19,0,0,0,81,POR,25,27,21,15,0,0,0,88,20100309
2010,HOU,21,27,23,25,0,0,0,96,WAS,22,18,20,28,0,0,0,88,20100309
2010,MEM,27,28,27,29,0,0,0,111,BOS,12,21,30,28,0,0,0,91,20100310
2010,NJN,33,14,15,25,0,0,0,87,DAL,19,20,31,26,0,0,0,96,20100310
2010,UTA,28,35,24,28,0,0,0,115,DET,29,14,31,30,0,0,0,104,20100310
2010,LAC,24,24,24,25,0,0,0,97,MIA,34,23,33,18,0,0,0,108,20100310
2010,DEN,20,28,31,31,0,0,0,110,MIN,23,30,19,30,0,0,0,102,20100310
2010,NOH,26,19,17,21,0,0,0,83,OKC,29,25,26,18,0,0,0,98,20100310
2010,CHA,37,25,23,17,0,0,0,102,PHI,23,21,14,29,0,0,0,87,20100310
2010,TOR,25,20,23,22,0,0,0,90,SAC,24,16,43,30,0,0,0,113,20100310
2010,NYK,22,17,21,27,0,0,0,87,SAS,31,20,16,30,0,0,0,97,20100310
2010,POR,28,30,25,27,0,0,0,110,GSW,28,32,36,9,0,0,0,105,20100311
2010,CHI,17,16,18,31,0,0,0,82,ORL,28,37,14,32,0,0,0,111,20100311
2010,ATL,27,27,25,26,0,0,0,105,WAS,22,29,22,26,0,0,0,99,20100311
2010,IND,23,24,31,25,0,0,0,103,BOS,29,38,31,24,0,0,0,122,20100312
2010,LAC,23,22,23,30,0,0,0,98,CHA,31,30,19,26,0,0,0,106,20100312
2010,WAS,23,17,23,24,0,0,0,87,DET,27,29,21,24,0,0,0,101,20100312
2010,NYK,24,18,31,39,0,0,0,112,MEM,32,31,31,25,0,0,0,119,20100312
2010,CHI,22,27,18,28,0,0,0,95,MIA,28,22,29,29,0,0,0,108,20100312
2010,UTA,22,18,23,24,0,0,0,87,MIL,25,23,23,24,0,0,0,95,20100312
2010,SAS,22,29,22,30,0,0,0,103,MIN,21,22,15,27,0,0,0,85,20100312
2010,DEN,29,22,22,29,0,0,0,102,NOH,29,23,23,20,0,0,0,95,20100312
2010,NJN,20,29,22,31,0,0,0,102,OKC,31,28,23,22,0,0,0,104,20100312
2010,CLE,36,25,17,22,0,0,0,100,PHI,34,23,22,16,0,0,0,95,20100312
2010,LAL,24,29,24,25,0,0,0,102,PHO,31,15,27,23,0,0,0,96,20100312
2010,POR,31,30,26,23,0,0,0,110,SAC,24,22,20,28,0,0,0,94,20100312
2010,DET,12,29,36,22,0,0,0,99,ATL,30,39,23,20,0,0,0,112,20100313
2010,NYK,30,28,33,37,0,0,0,128,DAL,25,23,18,28,0,0,0,94,20100313
2010,TOR,35,25,25,27,0,0,0,112,GSW,25,31,41,27,0,0,0,124,20100313
2010,NJN,31,24,23,30,0,0,0,108,HOU,31,23,28,34,0,0,0,116,20100313
2010,DEN,24,33,28,40,0,0,0,125,MEM,33,30,22,23,0,0,0,108,20100313
2010,LAC,18,30,20,20,0,0,0,88,SAS,32,33,25,28,0,0,0,118,20100313
2010,ORL,20,41,27,21,0,0,0,109,WAS,33,22,21,19,0,0,0,95,20100313
2010,BOS,18,30,24,21,0,0,0,93,CLE,24,30,26,24,0,0,0,104,20100314
2010,PHI,21,28,24,18,0,0,0,91,MIA,31,26,21,26,0,0,0,104,20100314
2010,IND,19,22,21,32,0,0,0,94,MIL,23,26,27,22,0,0,0,98,20100314
2010,UTA,26,23,30,32,0,0,0,111,OKC,29,30,31,29,0,0,0,119,20100314
2010,CHA,26,25,21,24,0,0,0,96,ORL,25,28,15,21,0,0,0,89,20100314
2010,NOH,22,27,22,35,0,0,0,106,PHO,34,21,28,37,0,0,0,120,20100314
2010,TOR,30,19,29,20,0,0,0,98,POR,32,28,25,24,0,0,0,109,20100314
2010,MIN,28,21,12,39,0,0,0,100,SAC,32,32,30,20,0,0,0,114,20100314
2010,DET,15,20,35,23,0,0,0,93,BOS,31,33,25,30,0,0,0,119,20100315
2010,LAL,39,20,35,30,0,0,0,124,GSW,32,33,22,34,0,0,0,121,20100315
2010,DEN,29,28,38,28,0,0,0,123,HOU,38,30,25,32,0,0,0,125,20100315
2010,NOH,26,20,31,31,0,0,0,108,LAC,23,27,28,22,0,0,0,100,20100315
2010,NYK,26,18,29,21,0,0,0,94,PHI,25,30,14,15,0,0,0,84,20100315
2010,WAS,25,20,15,29,0,0,0,89,UTA,25,34,31,22,0,0,0,112,20100315
2010,WAS,24,21,18,24,0,0,0,87,DEN,18,21,26,32,0,0,0,97,20100316
2010,CLE,28,26,21,38,0,0,0,113,DET,28,28,20,25,0,0,0,101,20100316
2010,CHA,24,19,24,27,0,0,0,94,IND,20,32,26,21,0,0,0,99,20100316
2010,CHI,26,18,23,30,0,0,0,97,MEM,25,30,30,19,0,0,0,104,20100316
2010,SAS,29,26,16,17,0,0,0,88,MIA,14,23,17,22,0,0,0,76,20100316
2010,ATL,22,33,23,30,0,0,0,108,NJN,22,17,19,26,0,0,0,84,20100316
2010,MIN,33,28,27,26,0,0,0,114,PHO,38,41,35,38,0,0,0,152,20100316
2010,LAL,28,21,28,29,0,0,0,106,SAC,17,31,20,31,0,0,0,99,20100316
2010,NYK,19,30,22,26,0,0,0,97,BOS,32,36,24,17,0,0,0,109,20100317
2010,OKC,26,25,19,22,0,0,0,92,CHA,15,28,30,27,0,0,0,100,20100317
2010,IND,25,23,17,29,0,0,0,94,CLE,30,20,31,18,0,0,0,99,20100317
2010,CHI,20,24,28,34,0,0,0,106,DAL,32,32,24,25,0,0,0,113,20100317
2010,NOH,34,35,27,25,0,0,0,121,GSW,30,26,32,43,0,0,0,131,20100317
2010,MEM,29,26,18,21,0,0,0,94,HOU,22,31,29,25,0,0,0,107,20100317
2010,MIL,27,16,31,19,0,0,0,93,LAC,27,25,20,29,0,0,0,101,20100317
2010,SAS,24,18,16,26,0,0,0,84,ORL,29,23,28,30,0,0,0,110,20100317
2010,NJN,22,27,19,29,0,0,0,97,PHI,32,28,21,27,0,0,0,108,20100317
2010,ATL,25,31,30,19,0,0,0,105,TOR,30,29,16,31,0,0,0,106,20100317
2010,MIN,26,17,30,27,0,0,0,100,UTA,26,26,35,35,0,0,0,122,20100317
2010,NOH,17,20,24,19,0,0,0,80,DEN,27,35,15,16,0,0,0,93,20100318
2010,ORL,29,25,22,19,13,0,0,108,MIA,25,29,17,24,7,0,0,102,20100318
2010,CHA,26,18,25,15,8,0,0,92,ATL,20,26,18,20,9,0,0,93,20100319
2010,CLE,29,25,15,23,0,0,0,92,CHI,28,18,19,20,0,0,0,85,20100319
2010,BOS,28,22,22,22,0,0,0,94,HOU,24,17,21,25,0,0,0,87,20100319
2010,DET,18,23,29,32,0,0,0,102,IND,33,29,25,19,0,0,0,106,20100319
2010,MIN,20,29,19,28,0,0,0,96,LAL,31,28,19,26,0,0,0,104,20100319
2010,PHI,26,24,14,24,0,0,0,88,NYK,15,33,15,29,0,0,0,92,20100319
2010,UTA,22,15,30,33,0,0,0,100,PHO,32,20,29,29,0,0,0,110,20100319
2010,WAS,18,12,21,23,0,0,0,74,POR,23,19,13,21,0,0,0,76,20100319
2010,MIL,29,20,17,29,6,13,0,114,SAC,21,27,25,22,6,7,0,108,20100319
2010,GSW,28,33,29,26,0,0,0,116,SAS,41,36,44,26,0,0,0,147,20100319
2010,OKC,39,32,26,18,0,0,0,115,TOR,25,19,21,24,0,0,0,89,20100319
2010,BOS,30,18,25,29,0,0,0,102,DAL,24,23,25,21,0,0,0,93,20100320
2010,MIL,27,26,23,26,0,0,0,102,DEN,31,23,22,21,0,0,0,97,20100320
2010,GSW,31,33,26,17,0,0,0,107,MEM,30,39,38,16,0,0,0,123,20100320
2010,CHA,21,24,11,15,0,0,0,71,MIA,20,27,14,16,0,0,0,77,20100320
2010,TOR,29,19,32,20,0,0,0,100,NJN,29,22,19,20,0,0,0,90,20100320
2010,CHI,21,31,25,21,0,0,0,98,PHI,17,23,22,22,0,0,0,84,20100320
2010,NOH,22,16,19,29,0,0,0,86,UTA,30,33,28,15,0,0,0,106,20100320
2010,SAS,33,18,27,27,9,0,0,114,ATL,22,31,28,24,14,0,0,119,20100321
2010,DET,20,21,18,20,0,0,0,79,CLE,28,25,28,23,0,0,0,104,20100321
2010,OKC,25,23,26,27,0,0,0,101,IND,32,27,34,28,0,0,0,121,20100321
2010,SAC,32,24,25,21,0,0,0,102,LAC,19,28,22,20,0,0,0,89,20100321
2010,WAS,18,15,27,32,0,0,0,92,LAL,24,35,23,17,0,0,0,99,20100321
2010,HOU,17,45,30,24,0,0,0,116,NYK,32,32,30,18,0,0,0,112,20100321
2010,POR,26,21,21,19,0,0,0,87,PHO,21,26,17,29,0,0,0,93,20100321
2010,HOU,29,24,13,22,0,0,0,88,CHI,30,18,24,26,0,0,0,98,20100322
2010,PHO,33,32,34,34,0,0,0,133,GSW,31,31,36,33,0,0,0,131,20100322
2010,ATL,20,34,20,21,0,0,0,95,MIL,23,22,22,31,0,0,0,98,20100322
2010,TOR,21,25,32,28,0,0,0,106,MIN,22,23,23,32,0,0,0,100,20100322
2010,MIA,25,27,27,20,0,0,0,99,NJN,32,21,14,22,0,0,0,89,20100322
2010,DAL,32,13,25,29,0,0,0,99,NOH,19,33,30,33,0,0,0,115,20100322
2010,SAS,25,31,25,18,0,0,0,99,OKC,34,25,17,20,0,0,0,96,20100322
2010,ORL,27,29,26,27,0,0,0,109,PHI,23,24,25,21,0,0,0,93,20100322
2010,MEM,30,21,24,27,0,0,0,102,SAC,28,24,18,15,0,0,0,85,20100322
2010,BOS,26,28,19,24,0,0,0,97,UTA,21,28,33,28,0,0,0,110,20100322
2010,LAC,24,24,29,19,0,0,0,96,DAL,32,30,14,30,0,0,0,106,20100323
2010,IND,29,23,25,21,0,0,0,98,DET,18,31,17,17,0,0,0,83,20100323
2010,DEN,27,26,21,30,0,0,0,104,NYK,26,23,34,26,0,0,0,109,20100323
2010,CHA,27,11,26,18,13,0,0,95,WAS,23,21,21,17,4,0,0,86,20100323
2010,ORL,22,20,20,22,0,0,0,84,ATL,16,30,22,18,0,0,0,86,20100324
2010,DEN,27,24,29,19,0,0,0,99,BOS,30,31,26,26,0,0,0,113,20100324
2010,MIN,33,12,31,19,0,0,0,95,CHA,30,25,30,23,0,0,0,108,20100324
2010,MEM,23,33,30,24,0,0,0,110,GSW,34,44,25,25,0,0,0,128,20100324
2010,WAS,25,17,16,24,0,0,0,82,IND,29,20,25,25,0,0,0,99,20100324
2010,PHI,28,30,23,20,0,0,0,101,MIL,23,22,18,23,0,0,0,86,20100324
2010,SAC,23,18,18,20,0,0,0,79,NJN,24,21,23,25,0,0,0,93,20100324
2010,CLE,26,26,35,18,0,0,0,105,NOH,21,27,23,21,0,0,0,92,20100324
2010,HOU,25,32,25,22,0,0,0,104,OKC,39,35,27,21,0,0,0,122,20100324
2010,LAL,22,19,30,21,0,0,0,92,SAS,25,23,18,17,0,0,0,83,20100324
2010,UTA,33,28,26,26,0,0,0,113,TOR,17,26,24,20,0,0,0,87,20100324
2010,MIA,31,32,23,17,0,0,0,103,CHI,19,14,16,25,0,0,0,74,20100325
2010,LAC,19,25,25,30,0,0,0,99,HOU,28,15,27,23,0,0,0,93,20100325
2010,DAL,27,27,21,14,0,0,0,89,POR,32,28,20,21,0,0,0,101,20100325
2010,SAC,17,20,24,25,0,0,0,86,BOS,32,25,17,20,0,0,0,94,20100326
2010,WAS,25,20,26,25,0,0,0,96,CHA,29,25,31,22,0,0,0,107,20100326
2010,UTA,29,32,22,23,0,0,0,106,IND,28,26,33,35,0,0,0,122,20100326
2010,MIA,28,20,21,18,0,0,0,87,MIL,20,15,20,19,0,0,0,74,20100326
2010,DET,30,23,24,33,0,0,0,110,NJN,24,23,33,38,0,0,0,118,20100326
2010,LAL,15,19,13,28,0,0,0,75,OKC,27,26,27,11,0,0,0,91,20100326
2010,MIN,29,25,19,24,0,0,0,97,ORL,27,32,23,24,0,0,0,106,20100326
2010,ATL,27,24,24,23,0,0,0,98,PHI,26,23,31,25,0,0,0,105,20100326
2010,NYK,29,19,22,26,0,0,0,96,PHO,34,30,32,36,0,0,0,132,20100326
2010,CLE,20,30,20,27,0,0,0,97,SAS,22,23,24,33,0,0,0,102,20100326
2010,DEN,26,30,16,25,0,0,0,97,TOR,19,33,29,15,0,0,0,96,20100326
2010,NJN,23,14,19,27,0,0,0,83,CHI,28,25,29,24,0,0,0,106,20100327
2010,DAL,31,36,24,20,0,0,0,111,GSW,27,14,21,28,0,0,0,90,20100327
2010,LAL,27,35,27,20,0,0,0,109,HOU,34,11,24,32,0,0,0,101,20100327
2010,POR,28,29,33,22,0,0,0,112,NOH,23,18,27,33,0,0,0,101,20100327
2010,UTA,23,27,30,23,0,0,0,103,WAS,21,22,22,22,0,0,0,87,20100327
2010,IND,31,19,13,21,0,0,0,84,ATL,26,22,24,22,0,0,0,94,20100328
2010,SAS,19,25,33,17,0,0,0,94,BOS,23,20,17,13,0,0,0,73,20100328
2010,SAC,21,31,24,14,0,0,0,90,CLE,30,28,20,19,0,0,0,97,20100328
2010,CHI,28,34,22,26,0,0,0,110,DET,22,22,32,27,0,0,0,103,20100328
2010,GSW,29,40,26,26,0,0,0,121,LAC,36,14,33,20,0,0,0,103,20100328
2010,TOR,23,26,28,17,0,0,0,94,MIA,26,17,24,30,0,0,0,97,20100328
2010,MEM,23,21,29,21,9,0,0,103,MIL,24,22,24,24,14,0,0,108,20100328
2010,PHO,26,40,17,28,0,0,0,111,MIN,25,19,31,30,0,0,0,105,20100328
2010,POR,30,20,24,18,0,0,0,92,OKC,21,28,22,16,0,0,0,87,20100328
2010,DEN,24,27,26,20,0,0,0,97,ORL,22,30,25,26,0,0,0,103,20100328
2010,TOR,18,25,29,31,0,0,0,103,CHA,18,29,31,23,0,0,0,101,20100329
2010,DEN,23,23,23,24,0,0,0,93,DAL,31,24,24,30,0,0,0,109,20100329
2010,SAS,33,13,20,18,0,0,0,84,NJN,27,16,19,28,0,0,0,90,20100329
2010,LAL,22,20,21,37,0,0,0,100,NOH,27,23,27,31,0,0,0,108,20100329
2010,NYK,30,30,27,11,0,0,0,98,UTA,43,21,23,16,0,0,0,103,20100329
2010,PHO,36,21,24,30,0,0,0,111,CHI,25,35,24,21,0,0,0,105,20100330
2010,WAS,30,23,14,27,0,0,0,94,HOU,27,21,17,33,0,0,0,98,20100330
2010,SAC,30,26,14,25,0,0,0,95,IND,24,23,26,29,0,0,0,102,20100330
2010,LAC,19,25,24,21,0,0,0,89,MIL,26,33,23,25,0,0,0,107,20100330
2010,OKC,33,23,28,27,0,0,0,111,PHI,23,22,29,19,0,0,0,93,20100330
2010,LAL,25,20,19,28,0,0,0,92,ATL,29,26,25,29,0,0,0,109,20100331
2010,OKC,30,27,26,26,0,0,0,109,BOS,23,38,22,21,0,0,0,104,20100331
2010,PHI,18,24,17,25,0,0,0,84,CHA,24,28,25,26,0,0,0,103,20100331
2010,MIL,30,20,21,27,0,0,0,98,CLE,29,23,25,24,0,0,0,101,20100331
2010,MIA,23,31,21,23,0,0,0,98,DET,25,20,17,19,0,0,0,81,20100331
2010,DAL,22,28,17,23,16,0,0,106,MEM,27,23,23,17,12,0,0,102,20100331
2010,SAC,31,13,26,29,0,0,0,99,MIN,31,22,34,21,0,0,0,108,20100331
2010,PHO,23,27,38,28,0,0,0,116,NJN,23,30,23,29,0,0,0,105,20100331
2010,WAS,23,20,27,26,0,0,0,96,NOH,19,20,20,32,0,0,0,91,20100331
2010,NYK,20,18,27,25,0,0,0,90,POR,31,34,30,23,0,0,0,118,20100331
2010,HOU,27,32,19,24,0,0,0,102,SAS,34,30,28,27,0,0,0,119,20100331
2010,LAC,28,25,22,17,0,0,0,92,TOR,31,17,33,33,0,0,0,114,20100331
2010,GSW,26,23,29,26,0,0,0,104,UTA,40,36,30,22,0,0,0,128,20100331
2010,ORL,18,25,29,25,0,0,0,97,DAL,16,20,20,26,0,0,0,82,20100401
2010,POR,24,31,21,16,0,0,0,92,DEN,27,29,31,22,0,0,0,109,20100401
2010,HOU,32,25,30,22,10,0,0,119,BOS,30,23,30,26,5,0,0,114,20100402
2010,MIL,19,26,20,15,6,0,0,86,CHA,17,27,21,15,7,0,0,87,20100402
2010,ATL,23,23,20,22,0,0,0,88,CLE,23,26,20,24,0,0,0,93,20100402
2010,PHO,26,30,29,24,0,0,0,109,DET,23,27,23,21,0,0,0,94,20100402
2010,NYK,32,19,38,28,0,0,0,117,GSW,34,31,32,31,0,0,0,128,20100402
2010,MIA,23,16,31,19,16,0,0,105,IND,22,27,18,22,7,0,0,96,20100402
2010,UTA,16,29,22,25,0,0,0,92,LAL,33,21,21,31,0,0,0,106,20100402
2010,NOH,20,26,25,25,0,0,0,96,MEM,25,36,25,21,0,0,0,107,20100402
2010,ORL,27,29,22,22,0,0,0,100,SAS,29,25,33,25,0,0,0,112,20100402
2010,CHI,30,23,23,19,0,0,0,95,WAS,25,25,25,12,0,0,0,87,20100402
2010,DET,21,24,29,11,0,0,0,85,ATL,23,31,20,17,0,0,0,91,20100403
2010,CHA,24,17,22,25,0,0,0,88,CHI,29,21,20,26,0,0,0,96,20100403
2010,OKC,35,32,27,27,0,0,0,121,DAL,37,22,26,31,0,0,0,116,20100403
2010,LAC,34,21,16,19,0,0,0,90,DEN,25,22,29,22,0,0,0,98,20100403
2010,PHO,18,16,28,36,0,0,0,98,MIL,22,36,23,26,0,0,0,107,20100403
2010,MIA,25,28,20,24,0,0,0,97,MIN,27,17,14,26,0,0,0,84,20100403
2010,NOH,24,23,24,16,0,0,0,87,NJN,30,29,25,31,0,0,0,115,20100403
2010,TOR,26,37,36,15,14,0,0,128,PHI,24,36,27,27,9,0,0,123,20100403
2010,POR,32,16,24,26,0,0,0,98,SAC,25,24,20,18,0,0,0,87,20100403
2010,CLE,24,25,32,32,0,0,0,113,BOS,33,31,34,19,0,0,0,117,20100404
2010,HOU,28,28,19,27,0,0,0,102,IND,33,39,29,32,0,0,0,133,20100404
2010,NYK,29,30,27,27,0,0,0,113,LAC,27,28,24,28,0,0,0,107,20100404
2010,SAS,22,26,19,33,0,0,0,100,LAL,24,16,19,22,0,0,0,81,20100404
2010,MIN,25,25,31,27,0,0,0,108,OKC,43,29,18,26,0,0,0,116,20100404
2010,MEM,24,22,23,23,0,0,0,92,ORL,32,22,21,32,0,0,0,107,20100404
2010,GSW,37,20,31,25,0,0,0,113,TOR,24,30,25,33,0,0,0,112,20100404
2010,NJN,22,26,23,28,0,0,0,99,WAS,29,26,25,29,0,0,0,109,20100404
2010,ATL,14,22,36,28,0,0,0,100,CHA,34,25,25,25,0,0,0,109,20100406
2010,MIL,14,28,18,19,0,0,0,79,CHI,27,9,15,23,0,0,0,74,20100406
2010,TOR,26,27,26,22,0,0,0,101,CLE,35,20,35,23,0,0,0,113,20100406
2010,HOU,32,27,29,25,0,0,0,113,MEM,32,23,19,29,0,0,0,103,20100406
2010,BOS,21,31,26,23,0,0,0,101,NYK,27,26,33,18,0,0,0,104,20100406
2010,DET,34,27,30,33,0,0,0,124,PHI,30,31,19,23,0,0,0,103,20100406
2010,SAS,18,29,24,24,0,0,0,95,SAC,18,29,20,19,0,0,0,86,20100406
2010,OKC,29,36,29,35,10,0,0,139,UTA,32,31,34,32,11,0,0,140,20100406
2010,GSW,23,20,34,17,0,0,0,94,WAS,40,28,26,18,0,0,0,112,20100406
2010,MEM,20,25,21,18,0,0,0,84,DAL,33,24,21,32,0,0,0,110,20100407
2010,ATL,20,28,24,16,0,0,0,88,DET,25,23,17,25,0,0,0,90,20100407
2010,UTA,22,24,31,19,0,0,0,96,HOU,33,27,36,17,0,0,0,113,20100407
2010,NYK,25,34,31,15,0,0,0,105,IND,38,34,20,21,0,0,0,113,20100407
2010,POR,27,23,27,16,0,0,0,93,LAC,18,28,14,25,0,0,0,85,20100407
2010,PHI,25,22,30,18,0,0,0,95,MIA,27,26,24,22,0,0,0,99,20100407
2010,NJN,38,20,17,14,0,0,0,89,MIL,33,25,24,26,0,0,0,108,20100407
2010,GSW,31,37,31,17,0,0,0,116,MIN,28,29,21,29,0,0,0,107,20100407
2010,CHA,32,28,19,25,0,0,0,104,NOH,21,17,40,25,0,0,0,103,20100407
2010,DEN,30,21,22,25,0,0,0,98,OKC,33,19,28,14,0,0,0,94,20100407
2010,WAS,25,19,21,29,0,0,0,94,ORL,24,26,34,37,0,0,0,121,20100407
2010,SAS,29,23,28,21,0,0,0,101,PHO,29,32,27,24,0,0,0,112,20100407
2010,BOS,30,22,30,33,0,0,0,115,TOR,25,29,22,28,0,0,0,104,20100407
2010,CLE,28,28,24,28,0,0,0,108,CHI,28,32,22,27,0,0,0,109,20100408
2010,LAL,20,27,27,22,0,0,0,96,DEN,22,35,16,25,0,0,0,98,20100408
2010,LAC,27,20,29,18,0,0,0,94,SAC,33,30,21,32,0,0,0,116,20100408
2010,TOR,25,22,26,28,0,0,0,101,ATL,14,45,22,26,0,0,0,107,20100409
2010,WAS,30,22,23,31,0,0,0,106,BOS,17,14,23,42,0,0,0,96,20100409
2010,IND,26,29,28,33,0,0,0,116,CLE,25,32,27,29,0,0,0,113,20100409
2010,CHA,23,24,16,27,0,0,0,90,HOU,24,26,21,26,0,0,0,97,20100409
2010,DET,27,26,28,25,0,0,0,106,MIA,23,25,28,23,0,0,0,99,20100409
2010,LAL,21,31,22,23,0,0,0,97,MIN,17,17,31,23,0,0,0,88,20100409
2010,CHI,29,24,16,34,9,4,0,116,NJN,24,28,23,28,9,15,0,127,20100409
2010,UTA,32,28,29,25,0,0,0,114,NOH,30,25,20,28,0,0,0,103,20100409
2010,PHO,31,26,12,22,0,0,0,91,OKC,32,26,21,17,0,0,0,96,20100409
2010,NYK,21,27,31,24,0,0,0,103,ORL,35,27,28,28,0,0,0,118,20100409
2010,MIL,24,24,17,30,0,0,0,95,PHI,15,21,24,30,0,0,0,90,20100409
2010,DAL,23,19,16,25,0,0,0,83,POR,18,21,20,18,0,0,0,77,20100409
2010,MEM,21,37,28,21,0,0,0,107,SAS,30,27,25,17,0,0,0,99,20100409
2010,DET,20,23,26,26,0,0,0,95,CHA,19,31,24,25,0,0,0,99,20100410
2010,SAS,20,25,23,36,0,0,0,104,DEN,19,21,21,24,0,0,0,85,20100410
2010,NJN,34,26,19,23,0,0,0,102,IND,25,31,32,27,0,0,0,115,20100410
2010,GSW,27,28,24,25,0,0,0,104,LAC,35,28,20,24,0,0,0,107,20100410
2010,PHI,21,30,35,34,0,0,0,120,MEM,26,32,20,23,0,0,0,101,20100410
2010,BOS,15,26,27,37,0,0,0,105,MIL,18,22,25,25,0,0,0,90,20100410
2010,DAL,35,30,35,26,0,0,0,126,SAC,24,29,26,29,0,0,0,108,20100410
2010,ATL,30,22,26,27,0,0,0,105,WAS,30,20,28,17,0,0,0,95,20100410
2010,ORL,19,27,31,21,0,0,0,98,CLE,28,22,23,19,0,0,0,92,20100411
2010,OKC,42,21,27,27,0,0,0,117,GSW,25,31,30,34,0,0,0,120,20100411
2010,POR,20,25,24,22,0,0,0,91,LAL,23,23,25,17,0,0,0,88,20100411
2010,MIN,21,18,25,22,0,0,0,86,NOH,25,33,25,31,0,0,0,114,20100411
2010,MIA,24,31,32,24,0,0,0,111,NYK,29,18,27,24,0,0,0,98,20100411
2010,HOU,36,21,28,21,0,0,0,106,PHO,33,29,25,29,0,0,0,116,20100411
2010,CHI,28,30,26,20,0,0,0,104,TOR,23,25,17,23,0,0,0,88,20100411
2010,MEM,31,26,17,27,0,0,0,101,DEN,32,31,30,30,0,0,0,123,20100412
2010,TOR,24,34,31,22,0,0,0,111,DET,26,20,26,25,0,0,0,97,20100412
2010,ORL,42,23,25,28,0,0,0,118,IND,18,33,19,28,0,0,0,98,20100412
2010,DAL,37,27,35,18,0,0,0,117,LAC,26,17,26,25,0,0,0,94,20100412
2010,ATL,30,25,23,26,0,0,0,104,MIL,21,27,22,26,0,0,0,96,20100412
2010,CHA,28,31,22,24,0,0,0,105,NJN,20,24,33,18,0,0,0,95,20100412
2010,WAS,30,16,36,21,0,0,0,103,NYK,25,20,29,40,0,0,0,114,20100412
2010,MIA,27,26,29,25,0,0,0,107,PHI,27,27,32,19,0,0,0,105,20100412
2010,OKC,28,23,20,24,0,0,0,95,POR,22,21,30,30,0,0,0,103,20100412
2010,HOU,28,34,26,29,0,0,0,117,SAC,40,27,18,22,0,0,0,107,20100412
2010,MIN,26,21,27,37,0,0,0,111,SAS,33,36,29,35,0,0,0,133,20100412
2010,BOS,20,21,27,25,0,0,0,93,CHI,17,27,23,34,0,0,0,101,20100413
2010,UTA,22,25,30,26,0,0,0,103,GSW,22,25,22,25,0,0,0,94,20100413
2010,SAC,28,26,19,27,0,0,0,100,LAL,28,32,26,20,0,0,0,106,20100413
2010,DEN,26,23,21,31,0,0,0,101,PHO,38,32,27,26,0,0,0,123,20100413
2010,CLE,23,23,14,23,0,0,0,83,ATL,27,21,29,22,0,0,0,99,20100414
2010,MIL,23,32,33,18,0,0,0,106,BOS,20,30,28,17,0,0,0,95,20100414
2010,CHI,33,24,18,23,0,0,0,98,CHA,26,17,22,24,0,0,0,89,20100414
2010,SAS,22,24,18,25,0,0,0,89,DAL,30,26,19,21,0,0,0,96,20100414
2010,NOH,34,23,38,28,0,0,0,123,HOU,34,26,30,25,0,0,0,115,20100414
2010,LAL,28,21,16,26,0,0,0,91,LAC,23,29,26,29,0,0,0,107,20100414
2010,NJN,20,18,13,27,6,2,0,86,MIA,20,22,22,14,6,10,0,94,20100414
2010,DET,27,21,20,35,0,0,0,103,MIN,29,29,21,19,0,0,0,98,20100414
2010,MEM,26,23,29,27,0,0,0,105,OKC,38,33,19,24,0,0,0,114,20100414
2010,PHI,20,30,20,41,0,0,0,111,ORL,37,26,30,32,0,0,0,125,20100414
2010,GSW,33,27,25,37,0,0,0,122,POR,33,25,33,25,0,0,0,116,20100414
2010,NYK,30,34,30,19,0,0,0,113,TOR,33,40,32,26,0,0,0,131,20100414
2010,PHO,30,29,22,19,0,0,0,100,UTA,25,17,18,26,0,0,0,86,20100414
2010,IND,21,30,29,17,0,0,0,97,WAS,30,17,27,24,0,0,0,98,20100414
2010,MIL,17,23,30,22,0,0,0,92,ATL,34,28,19,21,0,0,0,102,20100417
2010,MIA,29,15,22,10,0,0,0,76,BOS,28,13,23,21,0,0,0,85,20100417
2010,CHI,18,23,19,23,0,0,0,83,CLE,32,24,17,23,0,0,0,96,20100417
2010,UTA,28,28,30,27,0,0,0,113,DEN,30,27,31,38,0,0,0,126,20100417
2010,SAS,18,27,24,25,0,0,0,94,DAL,23,27,26,24,0,0,0,100,20100418
2010,OKC,13,26,17,23,0,0,0,79,LAL,27,20,17,23,0,0,0,87,20100418
2010,CHA,20,23,23,23,0,0,0,89,ORL,31,28,17,22,0,0,0,98,20100418
2010,POR,25,19,26,35,0,0,0,105,PHO,24,19,29,28,0,0,0,100,20100418
2010,CHI,22,28,27,25,0,0,0,102,CLE,28,24,25,35,0,0,0,112,20100419
2010,UTA,33,30,25,26,0,0,0,114,DEN,30,21,31,29,0,0,0,111,20100419
2010,MIL,20,26,16,24,0,0,0,86,ATL,28,24,24,20,0,0,0,96,20100420
2010,MIA,23,10,26,18,0,0,0,77,BOS,23,26,36,21,0,0,0,106,20100420
2010,OKC,18,29,22,23,0,0,0,92,LAL,26,19,28,22,0,0,0,95,20100420
2010,POR,26,23,19,22,0,0,0,90,PHO,32,31,31,25,0,0,0,119,20100420
2010,SAS,24,34,24,20,0,0,0,102,DAL,20,26,26,16,0,0,0,88,20100421
2010,CHA,14,16,25,22,0,0,0,77,ORL,18,23,34,17,0,0,0,92,20100421
2010,CLE,21,24,23,38,0,0,0,106,CHI,32,24,23,29,0,0,0,108,20100422
2010,LAL,27,23,25,21,0,0,0,96,OKC,22,21,31,27,0,0,0,101,20100422
2010,PHO,34,32,15,27,0,0,0,108,POR,16,21,23,29,0,0,0,89,20100422
2010,BOS,27,21,32,20,0,0,0,100,MIA,29,20,23,26,0,0,0,98,20100423
2010,DAL,16,28,26,20,0,0,0,90,SAS,23,24,19,28,0,0,0,94,20100423
2010,DEN,27,21,20,25,0,0,0,93,UTA,21,31,32,21,0,0,0,105,20100423
2010,ORL,29,12,25,24,0,0,0,90,CHA,27,19,20,20,0,0,0,86,20100424
2010,ATL,19,21,17,32,0,0,0,89,MIL,36,16,26,29,0,0,0,107,20100424
2010,LAL,17,25,22,25,0,0,0,89,OKC,29,26,31,24,0,0,0,110,20100424
2010,PHO,27,23,22,15,0,0,0,87,POR,26,28,20,22,0,0,0,96,20100424
2010,CLE,24,38,37,22,0,0,0,121,CHI,21,31,24,22,0,0,0,98,20100425
2010,BOS,18,25,34,15,0,0,0,92,MIA,31,18,22,30,0,0,0,101,20100425
2010,DAL,17,31,11,30,0,0,0,89,SAS,20,17,29,26,0,0,0,92,20100425
2010,DEN,25,20,23,38,0,0,0,106,UTA,31,23,32,31,0,0,0,117,20100425
2010,ORL,23,20,28,28,0,0,0,99,CHA,25,20,23,22,0,0,0,90,20100426
2010,ATL,25,25,24,30,0,0,0,104,MIL,28,26,31,26,0,0,0,111,20100426
2010,POR,28,19,19,22,0,0,0,88,PHO,27,30,27,23,0,0,0,107,20100426
2010,MIA,21,17,27,21,0,0,0,86,BOS,29,19,23,25,0,0,0,96,20100427
2010,CHI,26,22,23,23,0,0,0,94,CLE,27,28,18,23,0,0,0,96,20100427
2010,SAS,21,25,18,17,0,0,0,81,DAL,27,26,29,21,0,0,0,103,20100427
2010,OKC,16,18,26,27,0,0,0,87,LAL,31,24,33,23,0,0,0,111,20100427
2010,MIL,24,19,18,30,0,0,0,91,ATL,23,23,23,18,0,0,0,87,20100428
2010,UTA,27,25,29,21,0,0,0,102,DEN,25,25,36,30,0,0,0,116,20100428
2010,PHO,24,29,21,25,0,0,0,99,POR,17,24,24,25,0,0,0,90,20100429
2010,DAL,8,26,29,24,0,0,0,87,SAS,22,25,23,27,0,0,0,97,20100429
2010,ATL,16,15,29,23,0,0,0,83,MIL,19,15,11,24,0,0,0,69,20100430
2010,LAL,26,27,23,19,0,0,0,95,OKC,27,20,26,21,0,0,0,94,20100430
2010,DEN,23,31,26,24,0,0,0,104,UTA,32,24,27,29,0,0,0,112,20100430
2010,BOS,26,28,24,15,0,0,0,93,CLE,20,23,36,22,0,0,0,101,20100501
2010,MIL,13,27,20,14,0,0,0,74,ATL,20,33,20,22,0,0,0,95,20100502
2010,UTA,23,22,28,26,0,0,0,99,LAL,30,23,28,23,0,0,0,104,20100502
2010,BOS,26,26,31,21,0,0,0,104,CLE,22,26,12,26,0,0,0,86,20100503
2010,SAS,22,25,28,27,0,0,0,102,PHO,31,26,28,26,0,0,0,111,20100503
2010,UTA,23,23,31,26,0,0,0,103,LAL,27,31,29,24,0,0,0,111,20100504
2010,ATL,23,10,11,27,0,0,0,71,ORL,25,28,32,29,0,0,0,114,20100504
2010,SAS,30,21,25,26,0,0,0,102,PHO,21,30,27,32,0,0,0,110,20100505
2010,ATL,27,30,26,15,0,0,0,98,ORL,32,17,35,28,0,0,0,112,20100506
2010,CLE,36,29,31,28,0,0,0,124,BOS,17,26,27,25,0,0,0,95,20100507
2010,PHO,19,25,27,39,0,0,0,110,SAS,28,22,22,24,0,0,0,96,20100507
2010,ORL,28,24,27,26,0,0,0,105,ATL,18,15,22,20,0,0,0,75,20100508
2010,LAL,17,33,32,29,0,0,0,111,UTA,22,32,26,30,0,0,0,110,20100508
2010,CLE,22,23,27,15,0,0,0,87,BOS,31,23,20,23,0,0,0,97,20100509
2010,PHO,19,31,22,35,0,0,0,107,SAS,25,22,24,30,0,0,0,101,20100509
2010,ORL,34,19,22,23,0,0,0,98,ATL,23,22,21,18,0,0,0,84,20100510
2010,LAL,29,29,22,31,0,0,0,111,UTA,24,17,26,29,0,0,0,96,20100510
2010,BOS,20,30,30,40,0,0,0,120,CLE,23,21,19,25,0,0,0,88,20100511
2010,CLE,22,27,18,18,0,0,0,85,BOS,25,26,25,18,0,0,0,94,20100513
2010,BOS,22,19,33,18,0,0,0,92,ORL,14,18,26,30,0,0,0,88,20100516
2010,PHO,26,29,24,28,0,0,0,107,LAL,35,27,31,35,0,0,0,128,20100517
2010,BOS,27,26,25,17,0,0,0,95,ORL,28,23,19,22,0,0,0,92,20100518
2010,PHO,24,32,34,22,0,0,0,112,LAL,36,29,25,34,0,0,0,124,20100519
2010,ORL,12,22,13,24,0,0,0,71,BOS,27,24,24,19,0,0,0,94,20100522
2010,LAL,32,15,37,25,0,0,0,109,PHO,29,25,32,32,0,0,0,118,20100523
2010,ORL,31,20,16,19,10,0,0,96,BOS,26,21,21,18,6,0,0,92,20100524
2010,LAL,23,32,29,22,0,0,0,106,PHO,23,41,21,30,0,0,0,115,20100525
2010,BOS,27,22,26,17,0,0,0,92,ORL,31,26,27,29,0,0,0,113,20100526
2010,PHO,21,24,27,29,0,0,0,101,LAL,24,29,25,25,0,0,0,103,20100527
2010,ORL,19,23,19,23,0,0,0,84,BOS,30,25,27,14,0,0,0,96,20100528
2010,LAL,37,28,26,20,0,0,0,111,PHO,34,19,21,29,0,0,0,103,20100529
2010,BOS,21,20,23,25,0,0,0,89,LAL,26,24,34,18,0,0,0,102,20100603
2010,BOS,29,25,18,31,0,0,0,103,LAL,22,26,24,22,0,0,0,94,20100606
2010,LAL,26,26,15,24,0,0,0,91,BOS,17,23,21,23,0,0,0,84,20100608
2010,LAL,16,29,17,27,0,0,0,89,BOS,19,23,18,36,0,0,0,96,20100610
2010,LAL,20,19,26,21,0,0,0,86,BOS,22,23,28,19,0,0,0,92,20100613
2010,BOS,18,13,20,16,0,0,0,67,LAL,28,23,25,13,0,0,0,89,20100615
2010,BOS,23,17,17,22,0,0,0,79,LAL,14,20,19,30,0,0,0,83,20100617
2011,MIA,9,21,27,23,0,0,0,80,BOS,16,29,18,25,0,0,0,88,20101026
2011,HOU,33,29,20,28,0,0,0,110,LAL,26,25,26,35,0,0,0,112,20101026
2011,PHO,26,20,35,11,0,0,0,92,POR,28,22,25,31,0,0,0,106,20101026
2011,BOS,23,24,26,14,0,0,0,87,CLE,21,25,22,27,0,0,0,95,20101027
2011,CHA,21,24,22,19,0,0,0,86,DAL,25,24,31,21,0,0,0,101,20101027
2011,UTA,20,20,25,23,0,0,0,88,DEN,29,31,26,24,0,0,0,110,20101027
2011,HOU,31,37,28,32,0,0,0,128,GSW,34,33,37,28,0,0,0,132,20101027
2011,POR,31,23,16,28,0,0,0,98,LAC,23,26,22,17,0,0,0,88,20101027
2011,ATL,30,32,29,28,0,0,0,119,MEM,22,28,25,29,0,0,0,104,20101027
2011,SAC,27,26,34,30,0,0,0,117,MIN,23,35,25,33,0,0,0,116,20101027
2011,DET,20,27,20,31,0,0,0,98,NJN,20,19,31,31,0,0,0,101,20101027
2011,MIL,30,17,25,19,0,0,0,91,NOH,29,18,31,17,0,0,0,95,20101027
2011,CHI,25,29,28,13,0,0,0,95,OKC,30,29,23,24,0,0,0,106,20101027
2011,MIA,18,31,31,17,0,0,0,97,PHI,15,26,13,33,0,0,0,87,20101027
2011,IND,31,34,24,20,0,0,0,109,SAS,37,29,26,30,0,0,0,122,20101027
2011,NYK,29,22,23,24,0,0,0,98,TOR,22,25,25,21,0,0,0,93,20101027
2011,WAS,15,19,25,24,0,0,0,83,ORL,29,29,32,22,0,0,0,112,20101028
2011,PHO,27,31,26,26,0,0,0,110,UTA,22,20,30,22,0,0,0,94,20101028
2011,NYK,20,26,26,29,0,0,0,101,BOS,27,23,29,26,0,0,0,105,20101029
2011,IND,27,23,23,31,0,0,0,104,CHA,31,27,22,21,0,0,0,101,20101029
2011,MEM,24,17,28,22,0,0,0,91,DAL,29,21,25,15,0,0,0,90,20101029
2011,OKC,26,30,27,22,0,0,0,105,DET,21,30,28,25,0,0,0,104,20101029
2011,LAC,28,26,13,24,0,0,0,91,GSW,27,31,32,19,0,0,0,109,20101029
2011,ORL,24,21,10,15,0,0,0,70,MIA,24,27,28,17,0,0,0,96,20101029
2011,MIL,28,18,18,21,0,0,0,85,MIN,27,28,19,22,0,0,0,96,20101029
2011,SAC,21,32,24,23,0,0,0,100,NJN,29,32,15,30,0,0,0,106,20101029
2011,DEN,25,25,21,24,0,0,0,95,NOH,27,32,13,29,0,0,0,101,20101029
2011,ATL,33,29,22,20,0,0,0,104,PHI,30,22,22,27,0,0,0,101,20101029
2011,LAL,28,29,30,27,0,0,0,114,PHO,27,23,29,27,0,0,0,106,20101029
2011,CLE,20,18,17,26,0,0,0,81,TOR,24,22,31,24,0,0,0,101,20101029
2011,WAS,27,13,30,25,0,0,0,95,ATL,18,26,26,29,0,0,0,99,20101030
2011,DET,24,39,19,9,0,0,0,91,CHI,21,23,23,34,0,0,0,101,20101030
2011,SAC,34,19,31,23,0,0,0,107,CLE,34,33,15,22,0,0,0,104,20101030
2011,DEN,24,24,24,35,0,0,0,107,HOU,27,24,18,25,0,0,0,94,20101030
2011,PHI,26,25,15,20,0,0,0,86,IND,21,30,27,21,0,0,0,99,20101030
2011,MIN,19,27,29,14,0,0,0,89,MEM,34,25,28,22,0,0,0,109,20101030
2011,CHA,18,22,22,26,0,0,0,88,MIL,27,21,25,25,0,0,0,98,20101030
2011,POR,26,18,30,26,0,0,0,100,NYK,19,25,30,21,0,0,0,95,20101030
2011,NOH,17,26,33,23,0,0,0,99,SAS,24,18,18,30,0,0,0,90,20101030
2011,DAL,27,22,29,21,0,0,0,99,LAC,23,24,19,17,0,0,0,83,20101031
2011,GSW,14,24,26,19,0,0,0,83,LAL,34,22,25,26,0,0,0,107,20101031
2011,MIA,29,29,27,16,0,0,0,101,NJN,18,24,19,17,0,0,0,78,20101031
2011,UTA,27,29,35,29,0,0,0,120,OKC,23,17,34,25,0,0,0,99,20101031
2011,POR,21,26,26,25,0,0,0,98,CHI,32,24,32,22,0,0,0,110,20101101
2011,SAS,26,24,25,22,0,0,0,97,LAC,26,18,21,23,0,0,0,88,20101101
2011,TOR,33,29,24,22,0,0,0,108,SAC,16,35,27,33,0,0,0,111,20101101
2011,ATL,40,19,15,26,0,0,0,100,CLE,27,20,26,15,0,0,0,88,20101102
2011,BOS,31,26,31,21,0,0,0,109,DET,26,18,24,18,0,0,0,86,20101102
2011,MEM,23,23,30,29,0,0,0,105,LAL,34,39,24,27,0,0,0,124,20101102
2011,MIN,27,26,17,27,0,0,0,97,MIA,33,36,29,31,0,0,0,129,20101102
2011,POR,21,26,26,17,0,0,0,90,MIL,27,18,17,14,0,0,0,76,20101102
2011,PHI,28,20,18,40,9,0,0,115,WAS,27,23,22,34,10,0,0,116,20101102
2011,DET,22,26,18,19,0,0,0,85,ATL,24,20,26,24,0,0,0,94,20101103
2011,MIL,16,31,16,28,11,0,0,102,BOS,25,22,15,29,14,0,0,105,20101103
2011,DAL,23,27,34,18,0,0,0,102,DEN,27,25,28,21,0,0,0,101,20101103
2011,MEM,26,26,31,26,0,0,0,109,GSW,27,37,24,27,0,0,0,115,20101103
2011,NOH,28,15,30,34,0,0,0,107,HOU,28,21,22,28,0,0,0,99,20101103
2011,OKC,21,22,23,26,0,0,0,92,LAC,27,26,27,27,0,0,0,107,20101103
2011,CHA,23,18,21,23,0,0,0,85,NJN,19,21,21,22,0,0,0,83,20101103
2011,MIN,18,27,18,23,0,0,0,86,ORL,37,41,24,26,0,0,0,128,20101103
2011,IND,16,15,27,17,0,0,0,75,PHI,31,26,21,23,0,0,0,101,20101103
2011,SAS,23,27,31,31,0,0,0,112,PHO,22,28,29,31,0,0,0,110,20101103
2011,LAL,35,27,30,20,0,0,0,112,SAC,33,20,25,22,0,0,0,100,20101103
2011,TOR,22,25,37,24,0,0,0,108,UTA,41,25,25,34,0,0,0,125,20101103
2011,NYK,34,36,23,27,0,0,0,120,CHI,30,22,31,29,0,0,0,112,20101104
2011,OKC,29,22,24,25,7,0,0,107,POR,23,35,23,19,6,0,0,106,20101104
2011,CHI,23,15,26,32,9,0,0,105,BOS,19,30,23,24,14,0,0,110,20101105
2011,LAC,28,26,17,33,0,0,0,104,DEN,24,29,29,29,0,0,0,111,20101105
2011,CHA,15,24,25,26,0,0,0,90,DET,32,23,17,25,0,0,0,97,20101105
2011,UTA,16,23,17,22,0,0,0,78,GSW,17,23,20,25,0,0,0,85,20101105
2011,MIL,18,34,18,24,0,0,0,94,IND,20,40,16,14,0,0,0,90,20101105
2011,TOR,20,38,20,25,0,0,0,103,LAL,33,22,27,26,0,0,0,108,20101105
2011,ATL,26,30,27,30,0,0,0,113,MIN,25,26,20,32,0,0,0,103,20101105
2011,MIA,17,24,23,29,0,0,0,93,NOH,29,21,22,24,0,0,0,96,20101105
2011,WAS,27,22,24,18,0,0,0,91,NYK,26,32,23,31,0,0,0,112,20101105
2011,NJN,18,33,16,23,0,0,0,90,ORL,20,28,32,25,0,0,0,105,20101105
2011,CLE,34,27,18,44,0,0,0,123,PHI,20,33,31,32,0,0,0,116,20101105
2011,MEM,35,20,21,23,10,9,0,118,PHO,20,25,25,29,10,14,0,123,20101105
2011,ORL,23,20,30,18,0,0,0,91,CHA,15,21,26,26,0,0,0,88,20101106
2011,DEN,26,27,26,24,0,0,0,103,DAL,24,28,27,13,0,0,0,92,20101106
2011,NJN,25,26,17,21,0,0,0,89,MIA,24,31,32,14,0,0,0,101,20101106
2011,NOH,23,18,24,22,0,0,0,87,MIL,18,17,19,27,0,0,0,81,20101106
2011,TOR,17,17,25,25,0,0,0,84,POR,18,27,28,24,0,0,0,97,20101106
2011,MEM,30,23,27,20,0,0,0,100,SAC,24,25,18,24,0,0,0,91,20101106
2011,HOU,34,18,32,29,8,0,0,121,SAS,34,23,34,22,11,0,0,124,20101106
2011,LAC,35,20,18,18,6,10,0,107,UTA,22,17,31,21,6,12,0,109,20101106
2011,CLE,27,32,17,31,0,0,0,107,WAS,28,23,25,26,0,0,0,102,20101106
2011,PHO,30,31,29,28,0,0,0,118,ATL,28,22,38,26,0,0,0,114,20101107
2011,GSW,18,27,31,21,0,0,0,97,DET,23,26,24,29,0,0,0,102,20101107
2011,MIN,14,23,30,27,0,0,0,94,HOU,26,34,37,23,0,0,0,120,20101107
2011,POR,14,22,28,32,0,0,0,96,LAL,27,31,31,32,0,0,0,121,20101107
2011,PHI,33,21,26,26,0,0,0,106,NYK,25,31,25,15,0,0,0,96,20101107
2011,BOS,28,30,15,19,0,0,0,92,OKC,21,16,27,19,0,0,0,83,20101107
2011,SAS,19,25,27,24,0,0,0,95,CHA,26,22,21,22,0,0,0,91,20101108
2011,DEN,28,15,27,22,0,0,0,92,CHI,23,27,18,26,0,0,0,94,20101108
2011,BOS,19,21,29,18,0,0,0,87,DAL,23,27,20,19,0,0,0,89,20101108
2011,PHO,26,26,23,24,0,0,0,99,MEM,28,27,33,21,0,0,0,109,20101108
2011,ATL,23,24,23,19,0,0,0,89,ORL,21,30,21,21,0,0,0,93,20101108
2011,GSW,26,29,29,25,0,0,0,109,TOR,19,22,31,30,0,0,0,102,20101108
2011,DEN,25,24,27,37,0,0,0,113,IND,27,32,54,31,0,0,0,144,20101109
2011,MIN,28,24,22,20,0,0,0,94,LAL,26,32,24,17,0,0,0,99,20101109
2011,UTA,13,19,30,42,12,0,0,116,MIA,25,26,24,29,10,0,0,114,20101109
2011,NYK,19,24,24,13,0,0,0,80,MIL,41,23,26,17,0,0,0,107,20101109
2011,CLE,23,22,18,30,0,0,0,93,NJN,23,19,23,26,0,0,0,91,20101109
2011,LAC,18,23,19,22,0,0,0,82,NOH,27,21,22,31,0,0,0,101,20101109
2011,DET,25,20,18,15,0,0,0,78,POR,36,17,21,26,0,0,0,100,20101109
2011,MIL,21,33,34,20,0,0,0,108,ATL,26,14,19,32,0,0,0,91,20101110
2011,NJN,18,24,25,28,0,0,0,95,CLE,25,27,17,18,0,0,0,87,20101110
2011,DAL,27,28,31,20,0,0,0,106,MEM,21,29,19,22,0,0,0,91,20101110
2011,GSW,34,26,29,33,0,0,0,122,NYK,32,24,25,36,0,0,0,117,20101110
2011,PHI,28,23,23,29,0,0,0,103,OKC,32,27,26,24,0,0,0,109,20101110
2011,UTA,22,13,30,39,0,0,0,104,ORL,23,22,29,20,0,0,0,94,20101110
2011,MIN,27,24,23,24,0,0,0,98,SAC,22,23,27,17,0,0,0,89,20101110
2011,LAC,20,24,21,30,0,0,0,95,SAS,24,27,28,28,0,0,0,107,20101110
2011,CHA,26,22,21,32,0,0,0,101,TOR,24,24,26,22,0,0,0,96,20101110
2011,HOU,21,25,26,19,0,0,0,91,WAS,30,23,20,25,0,0,0,98,20101110
2011,GSW,20,18,25,27,0,0,0,90,CHI,34,32,28,26,0,0,0,120,20101111
2011,LAL,26,38,29,19,0,0,0,112,DEN,24,35,26,33,0,0,0,118,20101111
2011,BOS,27,34,27,24,0,0,0,112,MIA,20,26,32,29,0,0,0,107,20101111
2011,UTA,25,17,21,27,0,0,0,90,ATL,26,19,24,17,0,0,0,86,20101112
2011,PHI,22,26,27,15,0,0,0,90,DAL,31,24,23,21,0,0,0,99,20101112
2011,HOU,26,22,30,24,0,0,0,102,IND,23,27,28,21,0,0,0,99,20101112
2011,DET,26,31,17,29,10,0,0,113,LAC,19,28,27,29,4,0,0,107,20101112
2011,NYK,30,35,22,16,0,0,0,103,MIN,27,24,29,32,0,0,0,112,20101112
2011,POR,35,30,22,21,0,0,0,108,OKC,29,32,23,26,0,0,0,110,20101112
2011,TOR,30,29,30,21,0,0,0,110,ORL,31,28,23,24,0,0,0,106,20101112
2011,SAC,24,19,25,21,0,0,0,89,PHO,30,22,25,26,0,0,0,103,20101112
2011,CHA,19,23,26,25,0,0,0,93,WAS,22,21,22,20,0,0,0,85,20101112
2011,UTA,13,20,30,33,0,0,0,96,CHA,28,21,24,22,0,0,0,95,20101113
2011,WAS,25,17,16,38,0,0,0,96,CHI,24,26,22,31,0,0,0,103,20101113
2011,IND,26,28,19,26,0,0,0,99,CLE,30,24,14,17,0,0,0,85,20101113
2011,BOS,27,27,19,26,17,0,0,116,MEM,27,22,24,26,11,0,0,110,20101113
2011,TOR,25,25,23,27,0,0,0,100,MIA,34,29,20,26,0,0,0,109,20101113
2011,GSW,16,14,21,21,0,0,0,72,MIL,24,19,23,13,0,0,0,79,20101113
2011,ORL,31,21,16,23,0,0,0,91,NJN,25,26,18,21,0,0,0,90,20101113
2011,POR,19,16,31,21,0,0,0,87,NOH,26,22,27,32,0,0,0,107,20101113
2011,PHI,28,24,12,29,0,0,0,93,SAS,39,22,35,20,0,0,0,116,20101113
2011,MIN,27,25,20,33,0,0,0,105,ATL,30,30,23,28,0,0,0,111,20101114
2011,PHO,23,33,36,29,0,0,0,121,LAL,25,28,31,32,0,0,0,116,20101114
2011,HOU,26,32,26,20,0,0,0,104,NYK,27,25,23,21,0,0,0,96,20101114
2011,SAS,30,31,21,35,0,0,0,117,OKC,35,31,14,24,0,0,0,104,20101114
2011,DET,22,28,25,25,0,0,0,100,SAC,19,26,27,22,0,0,0,94,20101114
2011,MIN,27,33,21,29,0,0,0,110,CHA,22,38,24,29,0,0,0,113,20101115
2011,NOH,24,28,24,19,0,0,0,95,DAL,27,20,22,29,0,0,0,98,20101115
2011,DET,21,21,27,28,0,0,0,97,GSW,34,31,22,14,0,0,0,101,20101115
2011,NJN,24,31,21,34,0,0,0,110,LAC,23,21,26,26,0,0,0,96,20101115
2011,MEM,12,22,22,16,0,0,0,72,ORL,20,27,22,20,0,0,0,89,20101115
2011,DEN,22,36,18,18,0,0,0,94,PHO,20,26,23,31,0,0,0,100,20101115
2011,OKC,27,31,35,22,0,0,0,115,UTA,33,23,29,23,0,0,0,108,20101115
2011,PHI,23,31,16,23,0,0,0,93,CLE,19,35,26,21,0,0,0,101,20101116
2011,NYK,26,28,28,36,0,0,0,118,DEN,26,35,33,26,0,0,0,120,20101116
2011,CHI,19,30,14,32,0,0,0,95,HOU,26,15,30,21,0,0,0,92,20101116
2011,ATL,21,29,27,25,0,0,0,102,IND,24,25,16,27,0,0,0,92,20101116
2011,POR,22,29,20,29,0,0,0,100,MEM,17,28,25,29,0,0,0,99,20101116
2011,LAL,32,25,33,28,0,0,0,118,MIL,29,30,22,26,0,0,0,107,20101116
2011,TOR,23,24,21,26,0,0,0,94,WAS,27,27,36,19,0,0,0,109,20101116
2011,WAS,28,16,25,14,0,0,0,83,BOS,33,27,29,25,0,0,0,114,20101117
2011,LAL,34,25,25,19,0,0,0,103,DET,25,20,18,27,0,0,0,90,20101117
2011,PHO,24,19,30,23,0,0,0,96,MIA,27,37,36,23,0,0,0,123,20101117
2011,LAC,28,33,24,26,0,0,0,111,MIN,28,33,27,25,0,0,0,113,20101117
2011,DAL,31,21,17,28,0,0,0,97,NOH,23,19,33,24,0,0,0,99,20101117
2011,HOU,23,30,26,20,0,0,0,99,OKC,28,36,30,22,0,0,0,116,20101117
2011,TOR,25,21,23,25,0,0,0,94,PHI,26,21,24,15,0,0,0,86,20101117
2011,NYK,14,40,29,30,0,0,0,113,SAC,27,22,25,32,0,0,0,106,20101117
2011,CHI,25,22,12,35,0,0,0,94,SAS,18,19,37,29,0,0,0,103,20101117
2011,NJN,25,22,23,18,0,0,0,88,UTA,24,29,24,21,0,0,0,98,20101117
2011,LAC,25,18,16,21,0,0,0,80,IND,22,31,27,27,0,0,0,107,20101118
2011,PHO,15,19,25,30,0,0,0,89,ORL,31,31,29,14,0,0,0,105,20101118
2011,DEN,28,17,26,12,0,0,0,83,POR,16,27,26,17,0,0,0,86,20101118
2011,OKC,25,24,28,12,0,0,0,89,BOS,23,23,23,15,0,0,0,84,20101119
2011,CHI,19,20,17,32,0,0,0,88,DAL,13,22,24,24,0,0,0,83,20101119
2011,NYK,31,41,26,27,0,0,0,125,GSW,31,28,25,35,0,0,0,119,20101119
2011,CHA,23,14,31,19,0,0,0,87,MIA,31,25,19,20,0,0,0,95,20101119
2011,LAL,20,31,33,28,0,0,0,112,MIN,21,20,30,24,0,0,0,95,20101119
2011,CLE,28,15,25,33,0,0,0,101,NOH,26,36,19,27,0,0,0,108,20101119
2011,MIL,25,18,16,20,0,0,0,79,PHI,20,29,23,18,0,0,0,90,20101119
2011,NJN,19,27,17,18,0,0,0,81,SAC,21,22,21,22,0,0,0,86,20101119
2011,HOU,27,16,31,22,0,0,0,96,TOR,28,23,24,31,0,0,0,106,20101119
2011,SAS,24,20,26,24,0,0,0,94,UTA,14,26,28,14,0,0,0,82,20101119
2011,MEM,24,21,23,18,0,0,0,86,WAS,25,18,23,23,0,0,0,89,20101119
2011,DAL,28,27,22,21,0,0,0,98,ATL,25,18,25,25,0,0,0,93,20101120
2011,PHO,25,26,23,31,0,0,0,105,CHA,30,25,34,34,0,0,0,123,20101120
2011,NJN,25,29,21,28,0,0,0,103,DEN,28,31,24,24,0,0,0,107,20101120
2011,ORL,29,20,22,19,0,0,0,90,IND,26,26,14,20,0,0,0,86,20101120
2011,NYK,28,30,35,31,0,0,0,124,LAC,29,24,32,30,0,0,0,115,20101120
2011,MIA,17,22,29,27,0,0,0,95,MEM,26,17,25,29,0,0,0,97,20101120
2011,OKC,26,21,15,20,0,0,0,82,MIL,19,18,19,25,0,0,0,81,20101120
2011,UTA,19,26,20,38,0,0,0,103,POR,24,24,26,20,0,0,0,94,20101120
2011,CLE,29,28,18,17,0,0,0,92,SAS,28,36,25,27,0,0,0,116,20101120
2011,WAS,17,38,23,24,8,0,0,110,DET,24,28,25,25,13,0,0,115,20101121
2011,GSW,21,20,19,29,0,0,0,89,LAL,37,32,26,22,0,0,0,117,20101121
2011,NOH,14,25,20,16,0,0,0,75,SAC,16,23,17,15,0,0,0,71,20101121
2011,BOS,31,27,17,26,0,0,0,101,TOR,23,38,21,20,0,0,0,102,20101121
2011,BOS,39,25,21,14,0,0,0,99,ATL,13,29,14,20,0,0,0,76,20101122
2011,DEN,21,30,28,27,0,0,0,106,GSW,24,28,19,18,0,0,0,89,20101122
2011,PHO,26,33,31,33,0,0,0,123,HOU,25,20,31,40,0,0,0,116,20101122
2011,NOH,37,20,16,22,0,0,0,95,LAC,33,22,22,22,0,0,0,99,20101122
2011,IND,19,35,20,19,0,0,0,93,MIA,22,19,23,13,0,0,0,77,20101122
2011,MIN,27,27,27,26,0,0,0,107,OKC,28,37,25,27,0,0,0,117,20101122
2011,ORL,30,22,25,20,0,0,0,97,SAS,28,25,21,32,0,0,0,106,20101122
2011,SAC,22,15,19,27,0,0,0,83,UTA,20,29,29,16,0,0,0,94,20101122
2011,DET,17,25,19,23,0,0,0,84,DAL,24,14,18,32,0,0,0,88,20101123
2011,CLE,16,21,19,33,0,0,0,89,IND,24,38,21,17,0,0,0,100,20101123
2011,CHI,26,23,24,18,0,0,0,91,LAL,26,25,23,24,0,0,0,98,20101123
2011,ATL,21,22,24,26,8,0,0,101,NJN,31,20,19,23,14,0,0,107,20101123
2011,CHA,26,23,26,32,0,0,0,107,NYK,32,28,29,21,0,0,0,110,20101123
2011,PHI,30,22,25,29,8,0,0,114,WAS,20,18,35,33,10,0,0,116,20101123
2011,NJN,17,29,17,20,0,0,0,83,BOS,18,20,23,28,0,0,0,89,20101124
2011,NYK,24,27,30,18,0,0,0,99,CHA,25,23,23,24,0,0,0,95,20101124
2011,MIL,22,22,24,13,0,0,0,81,CLE,19,15,31,18,0,0,0,83,20101124
2011,GSW,23,28,27,23,0,0,0,101,HOU,36,23,23,29,0,0,0,111,20101124
2011,DET,21,29,18,16,0,0,0,84,MEM,24,23,33,25,0,0,0,105,20101124
2011,SAS,18,23,30,35,7,0,0,113,MIN,33,22,27,24,3,0,0,109,20101124
2011,DAL,24,31,20,36,0,0,0,111,OKC,27,29,25,22,0,0,0,103,20101124
2011,MIA,18,25,28,24,0,0,0,95,ORL,26,25,23,30,0,0,0,104,20101124
2011,CHI,17,33,22,29,10,12,0,123,PHO,36,26,22,17,10,4,0,115,20101124
2011,PHI,18,25,28,19,0,0,0,90,TOR,33,29,25,19,0,0,0,106,20101124
2011,NOH,30,21,21,15,0,0,0,87,UTA,31,30,19,25,0,0,0,105,20101124
2011,WAS,18,18,27,33,0,0,0,96,ATL,28,25,36,27,0,0,0,116,20101125
2011,SAC,25,25,19,13,0,0,0,82,LAC,30,24,30,16,0,0,0,100,20101125
2011,TOR,20,32,15,34,0,0,0,101,BOS,31,27,28,24,0,0,0,110,20101126
2011,HOU,26,26,16,21,0,0,0,89,CHA,22,23,27,27,0,0,0,99,20101126
2011,CHI,20,18,35,24,0,0,0,97,DEN,25,23,28,22,0,0,0,98,20101126
2011,MIL,18,25,21,25,0,0,0,89,DET,29,26,20,28,0,0,0,103,20101126
2011,OKC,23,21,27,25,14,0,0,110,IND,20,32,24,20,10,0,0,106,20101126
2011,GSW,24,29,29,29,0,0,0,111,MEM,30,33,24,29,0,0,0,116,20101126
2011,PHI,17,30,24,19,0,0,0,90,MIA,25,26,22,26,0,0,0,99,20101126
2011,CLE,22,27,25,26,0,0,0,100,ORL,32,30,23,26,0,0,0,111,20101126
2011,LAC,21,30,30,27,0,0,0,108,PHO,44,23,31,18,0,0,0,116,20101126
2011,NOH,26,28,21,22,0,0,0,97,POR,33,15,17,13,0,0,0,78,20101126
2011,DAL,27,22,22,32,0,0,0,103,SAS,29,22,22,21,0,0,0,94,20101126
2011,LAL,33,17,22,24,0,0,0,96,UTA,17,29,29,27,0,0,0,102,20101126
2011,MEM,32,19,16,19,0,0,0,86,CLE,22,23,30,17,0,0,0,92,20101127
2011,MIA,26,23,17,29,0,0,0,95,DAL,26,25,31,24,0,0,0,106,20101127
2011,CHA,16,37,19,29,0,0,0,101,MIL,29,31,22,22,0,0,0,104,20101127
2011,GSW,28,20,36,20,0,0,0,104,MIN,26,25,17,26,0,0,0,94,20101127
2011,ATL,32,24,19,24,0,0,0,99,NYK,22,16,28,24,0,0,0,90,20101127
2011,NJN,24,24,18,20,0,0,0,86,PHI,27,19,20,36,0,0,0,102,20101127
2011,CHI,21,23,25,27,0,0,0,96,SAC,28,29,19,9,0,0,0,85,20101127
2011,ORL,30,25,19,26,0,0,0,100,WAS,20,23,29,27,0,0,0,99,20101127
2011,PHO,18,39,32,44,0,0,0,133,DEN,31,37,37,33,0,0,0,138,20101128
2011,NYK,28,25,22,24,10,16,0,125,DET,25,30,23,21,10,7,0,116,20101128
2011,OKC,25,17,29,27,0,0,0,98,HOU,33,17,27,22,0,0,0,99,20101128
2011,UTA,30,22,27,30,0,0,0,109,LAC,32,28,14,23,0,0,0,97,20101128
2011,IND,23,28,26,18,0,0,0,95,LAL,26,19,24,23,0,0,0,92,20101128
2011,POR,26,26,26,18,0,0,0,96,NJN,23,21,29,25,0,0,0,98,20101128
2011,SAS,26,18,28,37,0,0,0,109,NOH,34,27,16,18,0,0,0,95,20101128
2011,ATL,27,25,25,19,0,0,0,96,TOR,23,23,11,21,0,0,0,78,20101128
2011,HOU,26,19,26,20,0,0,0,91,DAL,25,27,31,18,0,0,0,101,20101129
2011,WAS,21,23,25,25,0,0,0,94,MIA,24,28,28,25,0,0,0,105,20101129
2011,NOH,19,29,22,19,0,0,0,89,OKC,23,27,18,27,0,0,0,95,20101129
2011,MIL,26,26,21,15,0,0,0,88,UTA,30,30,20,29,0,0,0,109,20101129
2011,BOS,21,35,24,26,0,0,0,106,CLE,23,22,20,22,0,0,0,87,20101130
2011,SAS,30,28,33,27,0,0,0,118,GSW,26,22,25,25,0,0,0,98,20101130
2011,LAL,27,22,16,31,0,0,0,96,MEM,27,24,19,28,0,0,0,98,20101130
2011,NJN,28,30,15,27,0,0,0,100,NYK,30,25,33,23,0,0,0,111,20101130
2011,DET,23,22,16,18,0,0,0,79,ORL,18,25,21,26,0,0,0,90,20101130
2011,POR,29,17,22,11,0,0,0,79,PHI,29,18,19,22,0,0,0,88,20101130
2011,IND,22,30,28,27,0,0,0,107,SAC,23,29,17,29,0,0,0,98,20101130
2011,MEM,29,28,19,33,0,0,0,109,ATL,27,36,23,26,0,0,0,112,20101201
2011,POR,26,23,23,23,0,0,0,95,BOS,20,28,31,20,0,0,0,99,20101201
2011,ORL,28,33,24,22,0,0,0,107,CHI,22,15,25,16,0,0,0,78,20101201
2011,MIN,20,23,21,22,0,0,0,86,DAL,29,26,28,17,0,0,0,100,20101201
2011,MIL,22,28,21,23,0,0,0,94,DEN,19,26,31,29,0,0,0,105,20101201
2011,LAL,26,30,22,21,0,0,0,99,HOU,23,30,23,33,0,0,0,109,20101201
2011,SAS,24,16,28,17,0,0,0,85,LAC,25,23,25,17,0,0,0,90,20101201
2011,DET,18,24,9,21,0,0,0,72,MIA,29,25,19,24,0,0,0,97,20101201
2011,OKC,16,28,27,22,7,10,13,123,NJN,22,27,13,31,7,10,10,120,20101201
2011,CHA,24,18,20,11,0,0,0,73,NOH,28,15,22,24,0,0,0,89,20101201
2011,WAS,25,27,29,27,0,0,0,108,TOR,34,38,29,26,0,0,0,127,20101201
2011,IND,17,29,22,20,0,0,0,88,UTA,35,19,31,25,0,0,0,110,20101201
2011,MIA,31,28,36,23,0,0,0,118,CLE,23,17,25,25,0,0,0,90,20101202
2011,PHO,31,21,23,32,0,0,0,107,GSW,20,29,23,29,0,0,0,101,20101202
2011,PHI,26,28,20,14,0,0,0,88,ATL,18,28,23,24,0,0,0,93,20101203
2011,CHI,19,29,19,25,0,0,0,92,BOS,31,22,29,22,0,0,0,104,20101203
2011,NJN,16,16,16,31,5,0,0,84,CHA,18,15,27,19,12,0,0,91,20101203
2011,LAC,29,19,29,27,0,0,0,104,DEN,25,24,32,28,0,0,0,109,20101203
2011,ORL,24,30,24,26,0,0,0,104,DET,26,29,18,18,0,0,0,91,20101203
2011,SAC,16,19,17,28,0,0,0,80,LAL,21,31,30,31,0,0,0,113,20101203
2011,HOU,38,31,29,29,0,0,0,127,MEM,31,29,30,21,0,0,0,111,20101203
2011,NYK,21,34,24,21,0,0,0,100,NOH,26,27,20,19,0,0,0,92,20101203
2011,IND,28,31,17,21,0,0,0,97,PHO,20,32,22,31,0,0,0,105,20101203
2011,MIN,25,29,32,15,0,0,0,101,SAS,25,28,18,36,0,0,0,107,20101203
2011,OKC,25,34,18,22,0,0,0,99,TOR,28,24,34,25,0,0,0,111,20101203
2011,DAL,23,16,27,27,0,0,0,93,UTA,20,23,19,19,0,0,0,81,20101203
2011,POR,24,22,10,23,0,0,0,79,WAS,18,16,23,26,0,0,0,83,20101203
2011,HOU,23,21,35,30,7,0,0,116,CHI,25,31,25,28,10,0,0,119,20101204
2011,ATL,15,21,25,16,0,0,0,77,MIA,26,24,13,26,0,0,0,89,20101204
2011,ORL,16,26,20,23,0,0,0,85,MIL,24,25,20,27,0,0,0,96,20101204
2011,CLE,24,30,17,24,0,0,0,95,MIN,37,36,29,27,0,0,0,129,20101204
2011,CHA,16,29,22,24,0,0,0,91,PHI,32,24,29,24,0,0,0,109,20101204
2011,DAL,28,26,26,25,0,0,0,105,SAC,37,18,25,23,0,0,0,103,20101204
2011,MEM,16,31,30,30,0,0,0,107,DEN,33,29,14,32,0,0,0,108,20101205
2011,CLE,24,22,21,25,0,0,0,92,DET,19,32,27,24,0,0,0,102,20101205
2011,BOS,27,30,23,20,0,0,0,100,NJN,25,12,16,22,0,0,0,75,20101205
2011,GSW,17,25,28,39,0,0,0,109,OKC,32,22,36,24,0,0,0,114,20101205
2011,WAS,31,30,17,30,0,0,0,108,PHO,28,36,31,30,0,0,0,125,20101205
2011,LAC,15,22,27,27,0,0,0,91,POR,30,29,17,24,0,0,0,100,20101205
2011,NOH,23,18,18,25,0,0,0,84,SAS,34,34,22,19,0,0,0,109,20101205
2011,NYK,33,27,22,34,0,0,0,116,TOR,18,32,25,24,0,0,0,99,20101205
2011,OKC,22,26,18,24,0,0,0,90,CHI,24,29,29,17,0,0,0,99,20101206
2011,TOR,18,26,23,33,0,0,0,100,IND,31,37,21,35,0,0,0,124,20101206
2011,SAC,20,24,19,28,0,0,0,91,LAC,16,34,29,19,0,0,0,98,20101206
2011,MIA,25,21,23,19,0,0,0,88,MIL,21,14,24,19,0,0,0,78,20101206
2011,MIN,36,32,18,28,0,0,0,114,NYK,32,29,31,29,0,0,0,121,20101206
2011,ATL,19,17,18,26,0,0,0,80,ORL,19,15,19,21,0,0,0,74,20101206
2011,MEM,16,24,25,20,0,0,0,85,UTA,20,21,29,24,0,0,0,94,20101206
2011,NJN,26,21,24,30,0,0,0,101,ATL,27,33,23,33,0,0,0,116,20101207
2011,DEN,16,31,29,22,0,0,0,98,CHA,21,31,24,24,0,0,0,100,20101207
2011,GSW,26,22,24,28,0,0,0,100,DAL,27,23,21,34,0,0,0,105,20101207
2011,DET,24,21,21,17,0,0,0,83,HOU,29,25,21,22,0,0,0,97,20101207
2011,WAS,23,33,28,24,0,0,0,108,LAL,36,33,18,28,0,0,0,115,20101207
2011,CLE,26,28,20,23,0,0,0,97,PHI,35,31,23,28,0,0,0,117,20101207
2011,PHO,23,24,28,24,0,0,0,99,POR,29,22,18,37,0,0,0,106,20101207
2011,DEN,21,31,17,20,0,0,0,89,BOS,35,24,21,25,0,0,0,105,20101208
2011,CHI,21,20,19,28,0,0,0,88,CLE,15,20,33,15,0,0,0,83,20101208
2011,LAL,20,21,24,22,0,0,0,87,LAC,18,25,28,15,0,0,0,86,20101208
2011,IND,27,21,31,16,0,0,0,95,MIL,33,23,22,19,0,0,0,97,20101208
2011,OKC,22,31,31,27,0,0,0,111,MIN,40,24,22,17,0,0,0,103,20101208
2011,DET,15,19,23,17,0,0,0,74,NOH,22,22,29,20,0,0,0,93,20101208
2011,TOR,32,25,27,26,0,0,0,110,NYK,28,31,25,29,0,0,0,113,20101208
2011,MEM,25,28,25,14,12,0,0,104,PHO,22,19,23,28,6,0,0,98,20101208
2011,WAS,27,18,25,21,0,0,0,91,SAC,26,33,33,24,0,0,0,116,20101208
2011,GSW,19,28,27,20,0,0,0,94,SAS,29,28,29,25,0,0,0,111,20101208
2011,MIA,28,28,21,34,0,0,0,111,UTA,27,23,28,20,0,0,0,98,20101208
2011,NJN,19,21,29,20,0,0,0,89,DAL,30,25,24,23,0,0,0,102,20101209
2011,BOS,29,27,25,21,0,0,0,102,PHI,32,23,25,21,0,0,0,101,20101209
2011,ORL,22,24,16,21,0,0,0,83,POR,14,31,22,30,0,0,0,97,20101209
2011,LAL,22,10,26,26,0,0,0,84,CHI,12,24,30,22,0,0,0,88,20101210
2011,MIA,26,22,36,22,0,0,0,106,GSW,20,25,20,19,0,0,0,84,20101210
2011,CHA,22,28,19,23,0,0,0,92,IND,30,27,22,21,0,0,0,100,20101210
2011,HOU,24,19,28,20,0,0,0,91,MIL,27,20,26,24,0,0,0,97,20101210
2011,DET,23,24,23,29,0,0,0,99,MIN,19,31,26,33,0,0,0,109,20101210
2011,OKC,31,21,22,23,0,0,0,97,NOH,32,27,12,21,0,0,0,92,20101210
2011,POR,28,33,26,14,0,0,0,101,PHO,22,31,20,21,0,0,0,94,20101210
2011,ATL,21,27,21,23,0,0,0,92,SAS,26,27,18,37,0,0,0,108,20101210
2011,DEN,39,35,24,25,0,0,0,123,TOR,33,32,21,30,0,0,0,116,20101210
2011,ORL,31,26,15,33,0,0,0,105,UTA,30,28,24,35,0,0,0,117,20101210
2011,NYK,19,30,27,25,0,0,0,101,WAS,23,31,19,22,0,0,0,95,20101210
2011,IND,14,21,25,23,0,0,0,83,ATL,16,32,27,22,0,0,0,97,20101211
2011,BOS,20,22,22,29,0,0,0,93,CHA,16,16,15,15,0,0,0,62,20101211
2011,MIN,18,19,28,17,0,0,0,82,CHI,27,31,29,26,0,0,0,113,20101211
2011,UTA,19,23,28,27,0,0,0,97,DAL,34,20,27,22,0,0,0,103,20101211
2011,TOR,28,25,30,37,0,0,0,120,DET,29,43,27,17,0,0,0,116,20101211
2011,CLE,29,29,17,20,0,0,0,95,HOU,37,29,26,18,0,0,0,110,20101211
2011,MEM,19,22,22,21,0,0,0,84,LAC,27,20,19,17,0,0,0,83,20101211
2011,MIA,17,30,31,26,0,0,0,104,SAC,24,18,20,21,0,0,0,83,20101211
2011,ORL,35,24,10,25,0,0,0,94,LAC,14,26,19,26,0,0,0,85,20101212
2011,LAL,30,22,17,30,0,0,0,99,NJN,24,18,25,25,0,0,0,92,20101212
2011,DEN,24,41,24,36,0,0,0,125,NYK,35,31,31,32,0,0,0,129,20101212
2011,CLE,17,28,13,19,0,0,0,77,OKC,31,25,30,20,0,0,0,106,20101212
2011,NOH,13,10,23,24,0,0,0,70,PHI,20,25,22,21,0,0,0,88,20101212
2011,POR,17,23,21,17,0,0,0,78,SAS,26,24,23,22,0,0,0,95,20101212
2011,IND,18,23,17,15,0,0,0,73,CHI,27,16,22,27,0,0,0,92,20101213
2011,MIL,15,28,32,28,0,0,0,103,DAL,25,27,22,25,0,0,0,99,20101213
2011,POR,18,24,22,9,0,0,0,73,MEM,23,26,12,25,0,0,0,86,20101213
2011,NOH,23,31,21,9,0,0,0,84,MIA,25,28,29,14,0,0,0,96,20101213
2011,GSW,23,23,24,25,0,0,0,95,UTA,20,23,31,34,0,0,0,108,20101213
2011,TOR,29,24,19,19,0,0,0,91,CHA,20,27,25,25,0,0,0,97,20101214
2011,ORL,31,24,23,16,0,0,0,94,DEN,29,32,18,32,0,0,0,111,20101214
2011,ATL,19,18,24,19,0,0,0,80,DET,28,21,15,39,0,0,0,103,20101214
2011,MIN,25,26,25,23,0,0,0,99,GSW,17,37,25,29,0,0,0,108,20101214
2011,SAC,30,18,24,33,0,0,0,105,HOU,27,31,33,27,0,0,0,118,20101214
2011,PHI,26,14,19,23,0,0,0,82,NJN,20,14,21,22,0,0,0,77,20101214
2011,LAL,22,35,35,11,0,0,0,103,WAS,24,22,24,19,0,0,0,89,20101214
2011,POR,14,25,29,30,0,0,0,98,DAL,17,34,27,25,0,0,0,103,20101215
2011,LAL,36,23,28,22,0,0,0,109,IND,22,15,32,25,0,0,0,94,20101215
2011,CHA,20,16,19,25,0,0,0,80,MEM,24,35,25,29,0,0,0,113,20101215
2011,CLE,26,23,22,24,0,0,0,95,MIA,24,22,27,28,0,0,0,101,20101215
2011,SAC,29,28,20,14,0,0,0,91,NOH,23,18,28,25,0,0,0,94,20101215
2011,BOS,24,27,32,35,0,0,0,118,NYK,32,26,32,26,0,0,0,116,20101215
2011,HOU,31,25,20,29,0,0,0,105,OKC,31,31,25,30,0,0,0,117,20101215
2011,LAC,29,27,18,17,0,0,0,91,PHI,28,25,34,18,0,0,0,105,20101215
2011,MIN,30,26,30,36,0,0,0,122,PHO,31,25,35,37,0,0,0,128,20101215
2011,MIL,20,15,28,27,0,0,0,90,SAS,25,26,20,21,0,0,0,92,20101215
2011,CHI,23,40,28,19,0,0,0,110,TOR,18,26,20,29,0,0,0,93,20101215
2011,ATL,20,23,26,21,0,0,0,90,BOS,22,22,31,27,0,0,0,102,20101216
2011,SAS,28,29,28,28,0,0,0,113,DEN,37,23,24,28,0,0,0,112,20101216
2011,WAS,17,21,29,22,0,0,0,89,NJN,32,23,19,23,0,0,0,97,20101216
2011,CHA,20,19,19,27,0,0,0,85,ATL,25,21,22,22,0,0,0,90,20101217
2011,PHO,25,17,17,32,0,0,0,91,DAL,22,32,26,26,0,0,0,106,20101217
2011,LAC,25,26,29,29,0,0,0,109,DET,19,27,16,26,0,0,0,88,20101217
2011,MEM,13,20,27,27,0,0,0,87,HOU,34,27,28,14,0,0,0,103,20101217
2011,CLE,23,25,26,25,0,0,0,99,IND,19,34,31,24,0,0,0,108,20101217
2011,UTA,14,19,21,17,0,0,0,71,NOH,21,29,31,19,0,0,0,100,20101217
2011,MIA,34,23,33,23,0,0,0,113,NYK,25,32,17,17,0,0,0,91,20101217
2011,SAC,22,24,21,20,0,0,0,87,OKC,21,32,19,30,0,0,0,102,20101217
2011,LAL,18,26,14,35,0,0,0,93,PHI,21,18,23,19,0,0,0,81,20101217
2011,MIN,24,30,24,24,0,0,0,102,POR,25,36,21,25,0,0,0,107,20101217
2011,NJN,23,25,23,21,0,0,0,92,TOR,21,21,27,29,0,0,0,98,20101217
2011,LAC,28,33,22,17,0,0,0,100,CHI,31,22,23,23,0,0,0,99,20101218
2011,NYK,27,25,22,19,9,0,0,102,CLE,21,28,25,19,16,0,0,109,20101218
2011,MIN,27,23,25,38,0,0,0,113,DEN,35,27,26,27,0,0,0,115,20101218
2011,UTA,19,24,28,24,0,0,0,95,MIL,25,21,22,18,0,0,0,86,20101218
2011,PHI,20,20,31,26,0,0,0,97,ORL,21,18,25,25,0,0,0,89,20101218
2011,GSW,18,24,23,30,0,0,0,95,POR,21,30,23,22,0,0,0,96,20101218
2011,MEM,31,18,22,29,6,0,0,106,SAS,28,25,27,20,12,0,0,112,20101218
2011,MIA,19,27,26,23,0,0,0,95,WAS,25,22,27,20,0,0,0,94,20101218
2011,IND,23,25,17,23,0,0,0,88,BOS,30,21,18,30,0,0,0,99,20101219
2011,NOH,20,31,27,22,8,0,0,108,DET,20,21,31,28,11,0,0,111,20101219
2011,ATL,30,13,19,20,0,0,0,82,NJN,23,20,19,27,0,0,0,89,20101219
2011,PHO,25,29,28,31,0,0,0,113,OKC,23,22,40,25,0,0,0,110,20101219
2011,HOU,26,26,27,23,0,0,0,102,SAC,31,26,24,12,0,0,0,93,20101219
2011,LAL,28,29,29,34,0,0,0,120,TOR,34,15,30,31,0,0,0,110,20101219
2011,ORL,14,24,20,23,0,0,0,81,ATL,20,23,22,26,0,0,0,91,20101220
2011,UTA,24,25,27,25,0,0,0,101,CLE,20,24,20,26,0,0,0,90,20101220
2011,HOU,26,24,31,40,0,0,0,121,GSW,26,20,29,37,0,0,0,112,20101220
2011,NOH,16,27,26,24,0,0,0,93,IND,24,28,16,26,0,0,0,94,20101220
2011,MIN,31,27,21,11,0,0,0,90,LAC,34,34,26,19,0,0,0,113,20101220
2011,DAL,23,20,22,33,0,0,0,98,MIA,22,22,24,28,0,0,0,96,20101220
2011,MIL,18,17,25,20,0,0,0,80,POR,25,34,19,28,0,0,0,106,20101220
2011,PHO,26,28,24,32,0,0,0,110,SAS,27,26,40,25,0,0,0,118,20101220
2011,CHA,25,20,11,19,0,0,0,75,WAS,32,18,31,27,0,0,0,108,20101220
2011,OKC,21,24,23,31,0,0,0,99,CHA,23,17,29,12,0,0,0,81,20101221
2011,PHI,19,24,11,22,0,0,0,76,CHI,33,28,31,29,0,0,0,121,20101221
2011,MIL,25,25,22,26,0,0,0,98,LAL,22,24,20,13,0,0,0,79,20101221
2011,NJN,26,19,28,28,0,0,0,101,MEM,18,25,24,27,0,0,0,94,20101221
2011,DAL,27,22,27,29,0,0,0,105,ORL,21,24,27,27,0,0,0,99,20101221
2011,GSW,26,23,21,32,15,0,0,117,SAC,18,30,36,18,7,0,0,109,20101221
2011,CLE,22,24,23,15,0,0,0,84,ATL,17,32,28,21,0,0,0,98,20101222
2011,PHI,17,27,17,19,0,0,0,80,BOS,23,15,26,20,0,0,0,84,20101222
2011,HOU,32,24,18,23,0,0,0,97,LAC,28,15,19,30,0,0,0,92,20101222
2011,UTA,20,25,26,41,0,0,0,112,MIN,29,27,27,24,0,0,0,107,20101222
2011,NJN,29,21,13,28,0,0,0,91,NOH,32,25,26,22,0,0,0,105,20101222
2011,OKC,28,27,23,20,0,0,0,98,NYK,27,36,27,22,0,0,0,112,20101222
2011,DEN,27,29,33,14,0,0,0,103,SAS,26,33,21,29,0,0,0,109,20101222
2011,DET,24,38,24,29,0,0,0,115,TOR,23,21,24,25,0,0,0,93,20101222
2011,CHI,29,17,27,14,0,0,0,87,WAS,33,17,20,10,0,0,0,80,20101222
2011,SAS,26,27,23,25,0,0,0,101,ORL,28,34,35,26,0,0,0,123,20101223
2011,MIA,19,26,27,23,0,0,0,95,PHO,22,17,20,24,0,0,0,83,20101223
2011,MIL,24,19,19,22,0,0,0,84,SAC,25,14,25,15,0,0,0,79,20101223
2011,POR,28,29,23,22,0,0,0,102,GSW,25,31,22,31,0,0,0,109,20101225
2011,MIA,20,27,28,21,0,0,0,96,LAL,14,24,26,16,0,0,0,80,20101225
2011,CHI,20,34,29,12,0,0,0,95,NYK,21,31,33,18,0,0,0,103,20101225
2011,DEN,34,24,27,21,0,0,0,106,OKC,26,30,32,26,0,0,0,114,20101225
2011,BOS,20,26,17,15,0,0,0,78,ORL,19,17,21,29,0,0,0,86,20101225
2011,MIN,17,34,19,28,0,0,0,98,CLE,28,21,24,24,0,0,0,97,20101226
2011,PHI,13,30,23,29,0,0,0,95,DEN,25,21,25,18,0,0,0,89,20101226
2011,CHI,23,17,28,17,10,0,0,95,DET,15,19,23,28,7,0,0,92,20101226
2011,MEM,32,19,26,27,0,0,0,104,IND,20,26,18,26,0,0,0,90,20101226
2011,PHO,18,31,29,25,0,0,0,103,LAC,33,28,18,29,0,0,0,108,20101226
2011,ATL,27,28,16,15,0,0,0,86,NOH,25,21,28,19,0,0,0,93,20101226
2011,WAS,23,19,23,15,0,0,0,80,SAS,27,21,33,13,0,0,0,94,20101226
2011,DET,26,14,29,31,0,0,0,100,CHA,26,30,29,20,0,0,0,105,20101227
2011,PHI,30,19,22,24,0,0,0,95,GSW,25,30,21,34,0,0,0,110,20101227
2011,WAS,27,21,25,20,0,0,0,93,HOU,28,19,21,32,0,0,0,100,20101227
2011,TOR,24,20,19,22,0,0,0,85,MEM,16,32,29,19,0,0,0,96,20101227
2011,ATL,29,28,20,18,0,0,0,95,MIL,18,24,25,13,0,0,0,80,20101227
2011,NOH,35,22,20,21,0,0,0,98,MIN,27,27,28,31,0,0,0,113,20101227
2011,ORL,24,27,30,23,0,0,0,104,NJN,25,19,25,19,0,0,0,88,20101227
2011,DAL,34,22,23,24,0,0,0,103,OKC,29,27,25,12,0,0,0,93,20101227
2011,LAC,28,30,18,24,0,0,0,100,SAC,21,28,27,23,0,0,0,99,20101227
2011,POR,20,25,21,30,0,0,0,96,UTA,27,20,19,25,0,0,0,91,20101227
2011,MIL,15,30,17,15,0,0,0,77,CHI,27,17,23,23,0,0,0,90,20101228
2011,ORL,30,30,15,35,0,0,0,110,CLE,33,24,17,21,0,0,0,95,20101228
2011,TOR,23,23,18,20,0,0,0,84,DAL,13,27,19,17,0,0,0,76,20101228
2011,POR,21,20,17,19,0,0,0,77,DEN,25,23,30,17,0,0,0,95,20101228
2011,BOS,19,26,21,29,0,0,0,95,IND,26,21,20,16,0,0,0,83,20101228
2011,NYK,18,22,25,33,0,0,0,98,MIA,34,19,27,26,0,0,0,106,20101228
2011,LAL,18,26,18,20,0,0,0,82,SAS,27,15,29,26,0,0,0,97,20101228
2011,GSW,27,20,22,24,0,0,0,93,ATL,29,23,26,25,0,0,0,103,20101229
2011,CLE,20,24,23,25,0,0,0,92,CHA,33,24,24,20,0,0,0,101,20101229
2011,BOS,21,16,25,30,0,0,0,92,DET,27,18,29,30,0,0,0,104,20101229
2011,MIA,35,24,29,37,0,0,0,125,HOU,28,34,22,35,0,0,0,119,20101229
2011,UTA,23,28,30,22,0,0,0,103,LAC,31,26,13,25,0,0,0,95,20101229
2011,DEN,23,30,29,37,0,0,0,119,MIN,30,29,24,30,0,0,0,113,20101229
2011,LAL,26,33,24,20,0,0,0,103,NOH,23,18,19,28,0,0,0,88,20101229
2011,NJN,24,22,24,23,0,0,0,93,OKC,24,33,31,26,0,0,0,114,20101229
2011,PHI,33,33,26,31,0,0,0,123,PHO,35,30,21,24,0,0,0,110,20101229
2011,MEM,27,24,23,24,0,0,0,98,SAC,24,26,20,30,0,0,0,100,20101229
2011,IND,19,25,23,23,0,0,0,90,WAS,19,25,28,32,0,0,0,104,20101229
2011,SAS,29,24,18,28,0,0,0,99,DAL,27,19,18,29,0,0,0,93,20101230
2011,NYK,23,21,27,32,0,0,0,103,ORL,22,40,20,30,0,0,0,112,20101230
2011,UTA,25,16,27,21,0,0,0,89,POR,29,17,33,21,0,0,0,100,20101230
2011,NOH,23,14,29,17,0,0,0,83,BOS,19,20,18,24,0,0,0,81,20101231
2011,GSW,30,22,25,19,0,0,0,96,CHA,28,18,24,25,0,0,0,95,20101231
2011,NJN,21,23,19,18,0,0,0,81,CHI,23,23,24,20,0,0,0,90,20101231
2011,TOR,34,21,20,30,0,0,0,105,HOU,20,42,22,30,0,0,0,114,20101231
2011,WAS,22,12,28,24,0,0,0,86,IND,25,24,27,19,0,0,0,95,20101231
2011,PHI,19,25,29,25,0,0,0,98,LAL,29,23,30,20,0,0,0,102,20101231
2011,ATL,24,29,26,15,0,0,0,94,OKC,33,27,23,20,0,0,0,103,20101231
2011,DET,14,18,26,17,0,0,0,75,PHO,24,26,18,24,0,0,0,92,20101231
2011,CLE,28,33,9,21,0,0,0,91,CHI,24,29,32,15,0,0,0,100,20110101
2011,SAC,23,16,21,26,0,0,0,86,DEN,23,28,18,35,0,0,0,104,20110101
2011,GSW,36,36,12,23,0,0,0,107,MIA,28,30,25,31,0,0,0,114,20110101
2011,DAL,18,32,21,16,0,0,0,87,MIL,25,27,21,26,0,0,0,99,20110101
2011,NJN,29,26,9,24,0,0,0,88,MIN,36,18,23,26,0,0,0,103,20110101
2011,OKC,17,19,17,21,0,0,0,74,SAS,31,18,28,24,0,0,0,101,20110101
2011,MEM,21,17,31,23,0,0,0,92,UTA,21,27,23,27,0,0,0,98,20110101
2011,NOH,24,18,26,24,0,0,0,92,WAS,23,24,15,19,0,0,0,81,20110101
2011,DAL,27,28,24,25,0,0,0,104,CLE,25,22,22,26,0,0,0,95,20110102
2011,ATL,18,24,28,37,0,0,0,107,LAC,31,22,21,24,0,0,0,98,20110102
2011,MEM,23,25,31,25,0,0,0,104,LAL,18,21,23,23,0,0,0,85,20110102
2011,IND,32,23,22,15,0,0,0,92,NYK,30,25,24,19,0,0,0,98,20110102
2011,HOU,25,23,14,23,0,0,0,85,POR,27,27,25,21,0,0,0,100,20110102
2011,PHO,27,21,25,16,0,0,0,89,SAC,17,22,26,29,0,0,0,94,20110102
2011,BOS,24,19,28,22,0,0,0,93,TOR,23,19,20,17,0,0,0,79,20110102
2011,MIN,25,22,26,20,0,0,0,93,BOS,17,26,27,26,0,0,0,96,20110103
2011,MIA,23,24,31,18,0,0,0,96,CHA,28,15,16,23,0,0,0,82,20110103
2011,HOU,21,31,29,25,0,0,0,106,DEN,25,27,29,32,0,0,0,113,20110103
2011,PHI,26,14,18,19,0,0,0,77,NOH,23,20,25,16,0,0,0,84,20110103
2011,GSW,28,25,18,19,0,0,0,90,ORL,24,20,35,31,0,0,0,110,20110103
2011,DET,28,23,28,18,0,0,0,97,UTA,25,28,25,24,0,0,0,102,20110103
2011,TOR,27,14,28,22,0,0,0,91,CHI,29,30,22,30,0,0,0,111,20110104
2011,POR,24,16,20,21,0,0,0,81,DAL,24,19,19,22,0,0,0,84,20110104
2011,DET,19,23,17,24,0,0,0,83,LAL,24,21,31,32,0,0,0,108,20110104
2011,OKC,27,28,22,28,0,0,0,105,MEM,31,24,24,31,0,0,0,110,20110104
2011,MIL,20,31,19,19,0,0,0,89,MIA,26,21,26,28,0,0,0,101,20110104
2011,SAS,35,34,26,20,0,0,0,115,NYK,36,36,29,27,0,0,0,128,20110104
2011,ATL,27,27,23,31,0,0,0,108,SAC,23,17,23,39,0,0,0,102,20110104
2011,SAS,25,26,21,31,0,0,0,103,BOS,27,22,28,28,0,0,0,105,20110105
2011,TOR,26,40,24,30,0,0,0,120,CLE,38,25,21,21,0,0,0,105,20110105
2011,POR,31,24,19,29,0,0,0,103,HOU,25,22,33,20,0,0,0,100,20110105
2011,DEN,23,20,31,19,0,0,0,93,LAC,30,21,31,24,0,0,0,106,20110105
2011,CHA,24,33,14,24,13,0,0,108,MIN,23,20,30,22,10,0,0,105,20110105
2011,CHI,24,23,18,29,0,0,0,94,NJN,25,21,32,18,0,0,0,96,20110105
2011,GSW,29,18,25,38,0,0,0,110,NOH,34,24,24,21,0,0,0,103,20110105
2011,MIL,17,16,24,30,0,0,0,87,ORL,25,24,22,26,0,0,0,97,20110105
2011,WAS,26,26,23,22,0,0,0,97,PHI,29,21,26,33,0,0,0,109,20110105
2011,LAL,31,18,31,19,0,0,0,99,PHO,24,26,23,22,0,0,0,95,20110105
2011,ATL,30,25,31,24,0,0,0,110,UTA,17,24,28,18,0,0,0,87,20110105
2011,OKC,23,28,22,26,0,0,0,99,DAL,30,25,15,25,0,0,0,95,20110106
2011,DEN,27,28,26,21,0,0,0,102,SAC,29,40,22,31,0,0,0,122,20110106
2011,TOR,22,23,32,25,0,0,0,102,BOS,34,33,27,28,0,0,0,122,20110107
2011,CLE,24,25,28,21,0,0,0,98,GSW,33,32,23,28,0,0,0,116,20110107
2011,SAS,19,29,16,26,0,0,0,90,IND,20,27,28,12,0,0,0,87,20110107
2011,NOH,24,22,25,26,0,0,0,97,LAL,27,24,29,21,0,0,0,101,20110107
2011,UTA,23,21,21,34,0,0,0,99,MEM,27,22,27,34,0,0,0,110,20110107
2011,MIA,30,25,20,16,10,0,0,101,MIL,18,30,24,19,4,0,0,95,20110107
2011,POR,37,26,25,20,0,0,0,108,MIN,27,16,29,26,0,0,0,98,20110107
2011,HOU,28,22,21,24,0,0,0,95,ORL,27,26,39,18,0,0,0,110,20110107
2011,CHI,30,26,18,25,0,0,0,99,PHI,28,26,32,19,0,0,0,105,20110107
2011,NYK,30,25,38,28,0,0,0,121,PHO,22,23,26,25,0,0,0,96,20110107
2011,NJN,13,24,20,20,0,0,0,77,WAS,30,26,15,26,0,0,0,97,20110107
2011,IND,24,26,18,25,0,0,0,93,ATL,29,26,29,24,0,0,0,108,20110108
2011,WAS,20,26,25,18,0,0,0,89,CHA,26,23,28,27,0,0,0,104,20110108
2011,BOS,21,21,22,15,0,0,0,79,CHI,22,24,21,23,0,0,0,90,20110108
2011,ORL,19,32,29,37,0,0,0,117,DAL,28,29,24,26,0,0,0,107,20110108
2011,PHI,34,22,18,25,10,0,0,109,DET,30,22,19,28,13,0,0,112,20110108
2011,UTA,19,19,26,25,14,0,0,103,HOU,27,25,15,22,10,0,0,99,20110108
2011,MIL,28,27,33,27,0,0,0,115,NJN,15,30,20,27,0,0,0,92,20110108
2011,MEM,20,27,30,23,0,0,0,100,OKC,27,22,34,26,0,0,0,109,20110108
2011,NOH,23,31,24,18,0,0,0,96,DEN,22,21,23,21,0,0,0,87,20110109
2011,GSW,28,20,25,18,0,0,0,91,LAC,32,30,29,14,0,0,0,105,20110109
2011,NYK,21,26,23,17,0,0,0,87,LAL,25,27,29,28,0,0,0,109,20110109
2011,CLE,26,26,29,19,0,0,0,100,PHO,26,25,30,27,0,0,0,108,20110109
2011,MIA,27,19,19,28,14,0,0,107,POR,26,18,23,26,7,0,0,100,20110109
2011,MIN,21,23,23,24,0,0,0,91,SAS,18,32,24,20,0,0,0,94,20110109
2011,SAC,31,19,35,27,0,0,0,112,TOR,34,23,28,33,0,0,0,118,20110109
2011,HOU,27,23,30,28,0,0,0,108,BOS,22,27,25,28,0,0,0,102,20110110
2011,MEM,15,16,26,25,0,0,0,82,CHA,22,22,24,28,0,0,0,96,20110110
2011,DET,25,30,15,12,0,0,0,82,CHI,20,23,33,19,0,0,0,95,20110110
2011,PHO,32,23,17,26,0,0,0,98,DEN,20,44,38,30,0,0,0,132,20110111
2011,CLE,12,13,16,16,0,0,0,57,LAL,27,30,35,20,0,0,0,112,20110111
2011,SAS,36,27,25,19,0,0,0,107,MIN,25,28,23,20,0,0,0,96,20110111
2011,IND,27,30,27,27,0,0,0,111,PHI,23,26,32,22,0,0,0,103,20110111
2011,NYK,29,27,19,25,0,0,0,100,POR,23,27,16,20,0,0,0,86,20110111
2011,SAC,19,37,27,43,7,0,0,133,WAS,38,16,40,32,10,0,0,136,20110111
2011,SAC,22,27,18,28,0,0,0,95,BOS,28,29,33,29,0,0,0,119,20110112
2011,CHI,22,20,28,21,0,0,0,91,CHA,36,19,14,27,0,0,0,96,20110112
2011,MEM,21,22,30,34,0,0,0,107,DET,26,20,18,35,0,0,0,99,20110112
2011,LAL,21,24,24,46,0,0,0,115,GSW,26,27,22,35,0,0,0,110,20110112
2011,OKC,31,21,30,36,0,0,0,118,HOU,31,23,25,33,0,0,0,112,20110112
2011,DAL,26,26,17,20,0,0,0,89,IND,25,27,25,25,0,0,0,102,20110112
2011,MIA,26,32,20,27,0,0,0,105,LAC,44,24,18,25,0,0,0,111,20110112
2011,SAS,21,22,22,26,0,0,0,91,MIL,26,25,15,18,0,0,0,84,20110112
2011,ORL,21,18,22,20,8,0,0,89,NOH,17,23,27,14,11,0,0,92,20110112
2011,NJN,28,29,27,19,6,0,0,109,PHO,28,27,18,30,15,0,0,118,20110112
2011,ATL,27,33,15,29,0,0,0,104,TOR,21,34,22,24,0,0,0,101,20110112
2011,NYK,32,25,37,31,0,0,0,125,UTA,31,34,35,31,0,0,0,131,20110112
2011,MIA,23,20,25,34,0,0,0,102,DEN,26,34,38,32,0,0,0,130,20110113
2011,WAS,18,30,30,19,0,0,0,97,MIN,28,27,27,27,0,0,0,109,20110113
2011,ORL,27,33,26,38,0,0,0,124,OKC,35,29,32,29,0,0,0,125,20110113
2011,CHA,24,18,24,28,0,0,0,94,BOS,24,18,27,30,0,0,0,99,20110114
2011,LAC,39,23,24,26,0,0,0,112,GSW,35,34,25,28,0,0,0,122,20110114
2011,NOH,21,29,14,31,15,0,0,110,HOU,28,19,29,19,10,0,0,105,20110114
2011,CHI,28,25,26,20,0,0,0,99,IND,24,17,22,23,0,0,0,86,20110114
2011,NJN,24,16,23,25,0,0,0,88,LAL,22,23,25,30,0,0,0,100,20110114
2011,SAC,24,22,23,24,0,0,0,93,NYK,15,27,16,25,0,0,0,83,20110114
2011,MIL,23,26,23,22,0,0,0,94,PHI,28,27,22,18,0,0,0,95,20110114
2011,POR,36,23,27,25,0,0,0,111,PHO,28,28,29,30,0,0,0,115,20110114
2011,DAL,19,23,19,28,0,0,0,89,SAS,27,30,28,16,0,0,0,101,20110114
2011,DET,31,30,22,18,0,0,0,101,TOR,26,28,20,21,0,0,0,95,20110114
2011,CLE,25,25,33,16,0,0,0,99,UTA,31,39,23,28,0,0,0,121,20110114
2011,HOU,29,27,27,29,0,0,0,112,ATL,31,27,24,24,0,0,0,106,20110115
2011,NOH,25,23,21,19,0,0,0,88,CHA,21,21,25,14,0,0,0,81,20110115
2011,MIA,19,34,17,26,0,0,0,96,CHI,28,20,25,26,0,0,0,99,20110115
2011,CLE,22,27,21,29,0,0,0,99,DEN,34,46,25,22,0,0,0,127,20110115
2011,SAC,36,34,10,26,0,0,0,106,DET,27,32,23,28,0,0,0,110,20110115
2011,DAL,19,17,12,22,0,0,0,70,MEM,31,15,21,22,0,0,0,89,20110115
2011,ORL,20,28,33,27,0,0,0,108,MIN,29,26,18,26,0,0,0,99,20110115
2011,NJN,26,27,23,13,0,0,0,89,POR,18,28,28,22,0,0,0,96,20110115
2011,TOR,25,17,25,28,0,0,0,95,WAS,19,28,28,23,0,0,0,98,20110115
2011,LAL,22,23,26,21,0,0,0,92,LAC,27,17,24,31,0,0,0,99,20110116
2011,DEN,24,21,22,30,0,0,0,97,SAS,20,37,25,28,0,0,0,110,20110116
2011,SAC,32,30,20,16,0,0,0,98,ATL,27,26,20,27,0,0,0,100,20110117
2011,ORL,22,32,27,25,0,0,0,106,BOS,27,28,26,28,0,0,0,109,20110117
2011,DAL,18,19,25,27,0,0,0,89,DET,21,20,34,28,0,0,0,103,20110117
2011,NJN,28,18,27,27,0,0,0,100,GSW,28,26,25,30,0,0,0,109,20110117
2011,MIL,15,24,27,18,0,0,0,84,HOU,18,21,35,19,0,0,0,93,20110117
2011,IND,31,27,22,27,0,0,0,107,LAC,26,29,26,33,0,0,0,114,20110117
2011,OKC,28,27,20,19,0,0,0,94,LAL,28,30,23,20,0,0,0,101,20110117
2011,CHI,26,27,26,17,0,0,0,96,MEM,17,25,18,24,0,0,0,84,20110117
2011,TOR,16,28,21,16,0,0,0,81,NOH,20,17,25,23,0,0,0,85,20110117
2011,PHO,39,22,36,32,0,0,0,129,NYK,30,34,27,30,0,0,0,121,20110117
2011,CHA,23,16,20,27,6,0,0,92,PHI,22,18,25,21,10,0,0,96,20110117
2011,MIN,29,17,27,29,0,0,0,102,POR,30,20,38,25,0,0,0,113,20110117
2011,UTA,18,21,29,33,0,0,0,101,WAS,21,21,36,30,0,0,0,108,20110117
2011,CHA,27,20,17,19,0,0,0,83,CHI,24,20,22,16,0,0,0,82,20110118
2011,ATL,19,15,24,19,16,0,0,93,MIA,11,24,20,22,12,0,0,89,20110118
2011,DET,22,23,16,21,0,0,0,82,BOS,22,20,16,28,0,0,0,86,20110119
2011,PHO,36,26,28,16,0,0,0,106,CLE,28,21,28,21,0,0,0,98,20110119
2011,LAL,31,25,17,27,0,0,0,100,DAL,23,29,30,27,0,0,0,109,20110119
2011,OKC,24,31,31,21,0,0,0,107,DEN,27,28,30,27,0,0,0,112,20110119
2011,IND,29,29,25,25,0,0,0,108,GSW,28,25,28,29,0,0,0,110,20110119
2011,NYK,27,23,21,18,0,0,0,89,HOU,36,24,22,22,0,0,0,104,20110119
2011,MIN,19,29,31,32,0,0,0,111,LAC,29,31,32,34,0,0,0,126,20110119
2011,WAS,27,22,17,21,0,0,0,87,MIL,19,28,28,25,0,0,0,100,20110119
2011,UTA,19,29,16,31,0,0,0,95,NJN,27,21,29,26,0,0,0,103,20110119
2011,MEM,26,25,16,25,10,0,0,102,NOH,18,24,25,25,11,0,0,103,20110119
2011,PHI,21,27,22,20,8,0,0,98,ORL,17,27,19,27,9,0,0,99,20110119
2011,POR,21,25,19,20,9,0,0,94,SAC,26,22,17,20,5,0,0,90,20110119
2011,TOR,23,30,16,26,0,0,0,95,SAS,22,20,33,29,0,0,0,104,20110119
2011,PHI,27,23,18,29,0,0,0,97,CHA,30,26,18,26,0,0,0,100,20110120
2011,DAL,20,15,25,17,0,0,0,77,CHI,19,25,12,26,0,0,0,82,20110120
2011,LAC,27,23,21,22,0,0,0,93,POR,23,32,29,24,0,0,0,108,20110120
2011,NOH,19,30,21,30,0,0,0,100,ATL,17,17,11,14,0,0,0,59,20110121
2011,UTA,19,22,22,23,0,0,0,86,BOS,30,29,26,25,0,0,0,110,20110121
2011,MIL,27,26,26,23,0,0,0,102,CLE,25,16,29,18,0,0,0,88,20110121
2011,LAL,22,27,33,25,0,0,0,107,DEN,25,27,20,25,0,0,0,97,20110121
2011,SAC,28,23,23,30,8,0,0,112,GSW,27,24,31,22,15,0,0,119,20110121
2011,HOU,37,30,21,22,0,0,0,110,MEM,32,26,29,28,0,0,0,115,20110121
2011,DET,18,23,19,14,0,0,0,74,NJN,21,25,21,22,0,0,0,89,20110121
2011,TOR,18,23,16,15,0,0,0,72,ORL,26,21,26,39,0,0,0,112,20110121
2011,NYK,27,23,21,21,0,0,0,92,SAS,29,32,16,24,0,0,0,101,20110121
2011,PHO,22,30,31,26,0,0,0,109,WAS,33,20,18,20,0,0,0,91,20110121
2011,ATL,24,20,32,27,0,0,0,103,CHA,29,20,18,20,0,0,0,87,20110122
2011,CLE,17,21,24,17,0,0,0,79,CHI,22,26,24,20,0,0,0,92,20110122
2011,PHO,17,21,23,13,0,0,0,74,DET,21,15,11,28,0,0,0,75,20110122
2011,ORL,34,34,32,18,0,0,0,118,HOU,26,25,25,28,0,0,0,104,20110122
2011,GSW,22,34,26,27,0,0,0,109,LAC,34,31,21,27,0,0,0,113,20110122
2011,TOR,17,23,37,26,0,0,0,103,MIA,32,34,26,28,0,0,0,120,20110122
2011,MEM,21,22,29,22,0,0,0,94,MIL,19,21,19,22,0,0,0,81,20110122
2011,DAL,22,26,20,19,0,0,0,87,NJN,26,19,23,18,0,0,0,86,20110122
2011,SAS,12,26,10,24,0,0,0,72,NOH,13,28,31,24,0,0,0,96,20110122
2011,NYK,30,30,17,21,0,0,0,98,OKC,31,22,22,26,0,0,0,101,20110122
2011,UTA,22,19,22,22,0,0,0,85,PHI,26,21,23,26,0,0,0,96,20110122
2011,IND,28,25,17,22,0,0,0,92,POR,19,27,21,30,0,0,0,97,20110122
2011,BOS,35,21,16,11,0,0,0,83,WAS,20,26,24,15,0,0,0,85,20110122
2011,IND,30,21,27,29,0,0,0,107,DEN,27,32,34,28,0,0,0,121,20110123
2011,MIL,18,14,26,25,0,0,0,83,CHI,19,29,20,24,0,0,0,92,20110124
2011,SAS,34,28,28,23,0,0,0,113,GSW,34,21,23,24,0,0,0,102,20110124
2011,HOU,39,26,35,29,0,0,0,129,MIN,31,32,25,37,0,0,0,125,20110124
2011,CLE,29,25,23,24,0,0,0,101,NJN,26,22,25,30,0,0,0,103,20110124
2011,OKC,33,12,26,18,0,0,0,89,NOH,19,31,21,20,0,0,0,91,20110124
2011,WAS,26,36,29,15,0,0,0,106,NYK,33,29,31,22,0,0,0,115,20110124
2011,DET,27,29,19,28,0,0,0,103,ORL,26,20,19,31,0,0,0,96,20110124
2011,PHO,25,22,23,25,0,0,0,95,PHI,26,35,26,18,0,0,0,105,20110124
2011,SAC,25,20,25,26,0,0,0,96,POR,20,23,22,16,0,0,0,81,20110124
2011,MEM,25,26,29,20,0,0,0,100,TOR,24,25,25,24,0,0,0,98,20110124
2011,CLE,26,19,24,26,0,0,0,95,BOS,34,33,24,21,0,0,0,112,20110125
2011,LAC,33,29,16,27,0,0,0,105,DAL,25,29,27,31,0,0,0,112,20110125
2011,UTA,22,16,27,26,0,0,0,91,LAL,37,29,27,27,0,0,0,120,20110125
2011,CHA,21,31,24,18,0,0,0,94,SAC,19,23,25,22,0,0,0,89,20110125
2011,DEN,33,35,28,24,0,0,0,120,WAS,26,31,22,30,0,0,0,109,20110125
2011,DEN,29,27,24,29,0,0,0,109,DET,24,26,24,26,0,0,0,100,20110126
2011,NOH,34,27,32,19,0,0,0,112,GSW,21,28,27,27,0,0,0,103,20110126
2011,LAC,22,30,21,10,0,0,0,83,HOU,27,28,15,26,0,0,0,96,20110126
2011,ORL,24,38,24,25,0,0,0,111,IND,21,27,24,24,0,0,0,96,20110126
2011,ATL,23,24,28,15,0,0,0,90,MIL,22,22,20,34,0,0,0,98,20110126
2011,OKC,25,29,29,27,8,0,0,118,MIN,28,28,23,31,7,0,0,117,20110126
2011,MEM,32,21,13,22,0,0,0,88,NJN,16,26,18,33,0,0,0,93,20110126
2011,CHA,31,28,33,22,0,0,0,114,PHO,26,31,30,20,0,0,0,107,20110126
2011,PHI,20,30,34,23,0,0,0,107,TOR,29,21,27,17,0,0,0,94,20110126
2011,SAS,29,29,30,24,0,0,0,112,UTA,25,24,29,27,0,0,0,105,20110126
2011,HOU,15,32,34,25,0,0,0,106,DAL,33,31,24,23,0,0,0,111,20110127
2011,MIA,24,24,25,15,0,0,0,88,NYK,23,23,18,29,0,0,0,93,20110127
2011,BOS,21,20,23,24,0,0,0,88,POR,18,19,21,20,0,0,0,78,20110127
2011,NYK,21,22,33,26,0,0,0,102,ATL,30,30,31,20,0,0,0,111,20110128
2011,ORL,23,28,17,22,0,0,0,90,CHI,24,22,34,19,0,0,0,99,20110128
2011,DEN,31,39,23,24,0,0,0,117,CLE,24,26,33,20,0,0,0,103,20110128
2011,CHA,22,22,27,30,20,0,0,121,GSW,28,22,26,25,12,0,0,113,20110128
2011,NJN,27,27,24,14,0,0,0,92,IND,33,35,36,20,0,0,0,124,20110128
2011,SAC,30,29,26,15,0,0,0,100,LAL,33,22,16,24,0,0,0,95,20110128
2011,DET,22,20,26,19,0,0,0,87,MIA,19,20,25,24,0,0,0,88,20110128
2011,WAS,29,23,28,23,7,7,0,117,OKC,21,35,19,28,7,14,0,124,20110128
2011,MEM,21,19,17,42,0,0,0,99,PHI,18,26,29,21,0,0,0,94,20110128
2011,BOS,16,19,23,13,0,0,0,71,PHO,30,19,26,13,0,0,0,88,20110128
2011,MIL,32,23,26,23,12,0,0,116,TOR,22,35,21,26,6,0,0,110,20110128
2011,MIN,25,30,22,23,0,0,0,100,UTA,32,26,27,23,0,0,0,108,20110128
2011,IND,27,24,21,17,0,0,0,89,CHI,25,30,22,33,0,0,0,110,20110129
2011,ATL,24,25,29,13,0,0,0,91,DAL,28,24,25,25,0,0,0,102,20110129
2011,CHA,23,19,18,28,0,0,0,88,LAC,24,33,26,20,0,0,0,103,20110129
2011,WAS,28,22,17,26,0,0,0,93,MEM,33,26,27,21,0,0,0,107,20110129
2011,NJN,25,12,24,20,0,0,0,81,MIL,22,23,23,23,0,0,0,91,20110129
2011,TOR,20,19,20,28,0,0,0,87,MIN,21,28,31,23,0,0,0,103,20110129
2011,NOH,22,24,21,29,0,0,0,96,SAC,24,32,20,26,0,0,0,102,20110129
2011,HOU,26,25,20,24,0,0,0,95,SAS,25,28,23,32,0,0,0,108,20110129
2011,UTA,25,20,16,20,0,0,0,81,GSW,31,18,22,25,0,0,0,96,20110130
2011,BOS,22,28,27,32,0,0,0,109,LAL,21,33,18,24,0,0,0,96,20110130
2011,DET,31,31,29,15,0,0,0,106,NYK,30,30,31,33,0,0,0,124,20110130
2011,MIA,35,29,21,23,0,0,0,108,OKC,38,23,24,18,0,0,0,103,20110130
2011,CLE,17,26,20,24,0,0,0,87,ORL,33,23,23,24,0,0,0,103,20110130
2011,DEN,34,17,21,27,0,0,0,99,PHI,32,22,28,28,0,0,0,110,20110130
2011,NOH,25,28,27,22,0,0,0,102,PHO,27,26,35,16,0,0,0,104,20110130
2011,WAS,25,24,19,24,0,0,0,92,DAL,21,29,24,28,0,0,0,102,20110131
2011,TOR,21,24,25,23,0,0,0,93,IND,32,19,24,29,0,0,0,104,20110131
2011,MIL,16,31,26,25,0,0,0,98,LAC,26,23,28,28,0,0,0,105,20110131
2011,ORL,28,30,16,23,0,0,0,97,MEM,21,33,32,14,0,0,0,100,20110131
2011,CLE,20,37,15,18,0,0,0,90,MIA,35,31,23,28,0,0,0,117,20110131
2011,DEN,21,29,28,21,0,0,0,99,NJN,31,32,22,30,0,0,0,115,20110131
2011,CHA,18,23,21,16,0,0,0,78,UTA,24,19,19,21,0,0,0,83,20110131
2011,HOU,23,25,26,24,8,0,0,106,LAL,31,23,20,24,16,0,0,114,20110201
2011,WAS,26,18,21,24,0,0,0,89,NOH,29,26,25,17,0,0,0,97,20110201
2011,SAS,22,30,19,15,0,0,0,86,POR,24,23,24,28,0,0,0,99,20110201
2011,BOS,27,18,29,21,0,0,0,95,SAC,20,34,17,19,0,0,0,90,20110201
2011,TOR,24,21,24,18,0,0,0,87,ATL,28,26,21,25,0,0,0,100,20110202
2011,IND,35,24,30,28,0,0,0,117,CLE,25,29,33,25,0,0,0,112,20110202
2011,POR,23,23,24,20,0,0,0,90,DEN,22,23,32,32,0,0,0,109,20110202
2011,CHA,25,19,24,29,0,0,0,97,DET,21,20,24,22,0,0,0,87,20110202
2011,CHI,28,27,27,24,0,0,0,106,LAC,23,26,22,17,0,0,0,88,20110202
2011,MEM,26,23,30,23,0,0,0,102,MIN,20,21,16,27,0,0,0,84,20110202
2011,PHI,28,25,25,28,0,0,0,106,NJN,26,18,22,26,0,0,0,92,20110202
2011,DAL,27,29,30,27,0,0,0,113,NYK,34,18,21,24,0,0,0,97,20110202
2011,NOH,25,30,17,21,0,0,0,93,OKC,29,20,32,23,0,0,0,104,20110202
2011,MIL,17,14,22,24,0,0,0,77,PHO,25,27,19,21,0,0,0,92,20110202
2011,HOU,30,24,25,18,0,0,0,97,UTA,26,29,27,14,0,0,0,96,20110202
2011,MIL,22,25,26,21,0,0,0,94,GSW,18,28,26,28,0,0,0,100,20110203
2011,SAS,22,20,24,23,0,0,0,89,LAL,18,24,21,25,0,0,0,88,20110203
2011,MIA,30,25,24,25,0,0,0,104,ORL,26,19,18,37,0,0,0,100,20110203
2011,LAC,19,31,17,33,0,0,0,100,ATL,22,25,32,22,0,0,0,101,20110204
2011,DAL,34,20,23,24,0,0,0,101,BOS,27,24,26,20,0,0,0,97,20110204
2011,MIA,29,30,24,26,0,0,0,109,CHA,26,29,22,20,0,0,0,97,20110204
2011,UTA,23,27,32,31,0,0,0,113,DEN,24,23,30,29,0,0,0,106,20110204
2011,NJN,22,22,19,19,0,0,0,82,DET,28,20,24,20,0,0,0,92,20110204
2011,POR,25,29,18,15,0,0,0,87,IND,32,28,26,14,0,0,0,100,20110204
2011,CLE,32,27,25,21,0,0,0,105,MEM,26,26,31,29,0,0,0,112,20110204
2011,NYK,21,31,30,16,0,0,0,98,PHI,35,16,22,27,0,0,0,100,20110204
2011,OKC,31,32,17,31,0,0,0,111,PHO,36,24,27,20,0,0,0,107,20110204
2011,SAS,34,27,30,22,0,0,0,113,SAC,19,24,32,25,0,0,0,100,20110204
2011,MIN,31,24,25,20,0,0,0,100,TOR,33,26,27,25,0,0,0,111,20110204
2011,ORL,29,22,23,36,0,0,0,110,WAS,21,28,15,28,0,0,0,92,20110204
2011,DAL,31,24,27,19,0,0,0,101,CHA,22,23,21,26,0,0,0,92,20110205
2011,POR,23,32,31,25,0,0,0,111,CLE,20,37,26,22,0,0,0,105,20110205
2011,CHI,25,22,25,18,0,0,0,90,GSW,23,25,25,28,0,0,0,101,20110205
2011,MEM,26,25,20,16,6,0,0,93,HOU,20,23,24,20,8,0,0,95,20110205
2011,DET,26,26,14,23,0,0,0,89,MIL,22,25,13,18,0,0,0,78,20110205
2011,DEN,25,34,28,26,0,0,0,113,MIN,23,23,38,16,0,0,0,100,20110205
2011,LAL,27,29,25,20,0,0,0,101,NOH,19,31,32,13,0,0,0,95,20110205
2011,OKC,27,35,30,29,0,0,0,121,UTA,37,20,24,24,0,0,0,105,20110205
2011,ATL,28,24,24,23,0,0,0,99,WAS,19,27,25,21,0,0,0,92,20110205
2011,ORL,22,21,18,19,0,0,0,80,BOS,17,29,24,21,0,0,0,91,20110206
2011,LAC,19,17,25,18,0,0,0,79,MIA,20,27,23,27,0,0,0,97,20110206
2011,IND,33,23,25,24,0,0,0,105,NJN,24,19,24,19,0,0,0,86,20110206
2011,PHI,24,27,29,23,0,0,0,103,NYK,31,24,31,31,0,0,0,117,20110206
2011,BOS,29,21,19,20,0,0,0,89,CHA,25,26,14,29,0,0,0,94,20110207
2011,CLE,28,21,24,23,0,0,0,96,DAL,29,30,18,22,0,0,0,99,20110207
2011,HOU,25,27,29,27,0,0,0,108,DEN,26,24,16,37,0,0,0,103,20110207
2011,PHO,33,29,27,15,0,0,0,104,GSW,17,28,30,17,0,0,0,92,20110207
2011,LAL,26,24,23,20,0,0,0,93,MEM,29,16,23,16,0,0,0,84,20110207
2011,MIN,23,37,22,22,0,0,0,104,NOH,23,23,24,22,0,0,0,92,20110207
2011,CHI,26,24,22,31,0,0,0,103,POR,28,22,25,34,0,0,0,109,20110207
2011,UTA,30,25,25,27,0,0,0,107,SAC,30,26,31,17,0,0,0,104,20110207
2011,PHI,33,32,23,29,0,0,0,117,ATL,15,18,25,25,0,0,0,83,20110208
2011,SAS,26,26,19,29,0,0,0,100,DET,25,26,15,23,0,0,0,89,20110208
2011,MIN,27,29,27,29,0,0,0,112,HOU,29,24,32,23,0,0,0,108,20110208
2011,IND,29,37,31,15,0,0,0,112,MIA,33,30,27,27,0,0,0,117,20110208
2011,TOR,17,21,20,16,0,0,0,74,MIL,24,16,26,26,0,0,0,92,20110208
2011,MEM,24,20,30,21,10,0,0,105,OKC,27,27,17,24,6,0,0,101,20110208
2011,LAC,23,23,19,20,0,0,0,85,ORL,21,21,24,35,0,0,0,101,20110208
2011,DET,25,30,26,22,0,0,0,103,CLE,16,27,27,24,0,0,0,94,20110209
2011,DEN,35,33,24,22,0,0,0,114,GSW,34,36,30,16,0,0,0,116,20110209
2011,CHA,28,20,22,33,0,0,0,103,IND,29,29,23,23,0,0,0,104,20110209
2011,NOH,27,15,29,20,10,0,0,101,NJN,23,23,23,22,12,0,0,103,20110209
2011,LAC,28,30,30,28,0,0,0,116,NYK,29,18,31,30,0,0,0,108,20110209
2011,ORL,18,31,25,25,0,0,0,99,PHI,27,20,22,26,0,0,0,95,20110209
2011,DAL,20,36,18,28,0,0,0,102,SAC,28,19,26,27,0,0,0,100,20110209
2011,SAS,31,29,21,30,0,0,0,111,TOR,29,27,28,16,0,0,0,100,20110209
2011,CHI,21,23,22,25,0,0,0,91,UTA,23,18,19,26,0,0,0,86,20110209
2011,MIL,19,18,23,25,0,0,0,85,WAS,22,25,30,23,0,0,0,100,20110209
2011,LAL,20,25,27,20,0,0,0,92,BOS,27,26,15,18,0,0,0,86,20110210
2011,DAL,19,39,34,28,0,0,0,120,DEN,33,26,29,33,0,0,0,121,20110210
2011,GSW,22,20,19,27,0,0,0,88,PHO,32,33,22,25,0,0,0,112,20110210
2011,NJN,24,28,20,22,0,0,0,94,CHA,21,16,23,29,0,0,0,89,20110211
2011,LAC,33,20,28,29,9,0,0,119,CLE,29,23,31,27,16,0,0,126,20110211
2011,MIA,25,39,22,20,0,0,0,106,DET,21,22,22,27,0,0,0,92,20110211
2011,MIN,31,27,32,15,0,0,0,105,IND,31,25,27,33,0,0,0,116,20110211
2011,MIL,17,23,28,18,0,0,0,86,MEM,20,25,18,26,0,0,0,89,20110211
2011,LAL,30,32,23,28,0,0,0,113,NYK,28,20,20,28,0,0,0,96,20110211
2011,NOH,28,33,19,19,0,0,0,99,ORL,24,28,28,13,0,0,0,93,20110211
2011,SAS,22,24,12,13,0,0,0,71,PHI,27,19,14,17,0,0,0,77,20110211
2011,POR,23,32,17,30,0,0,0,102,TOR,19,28,23,26,0,0,0,96,20110211
2011,PHO,19,25,27,24,0,0,0,95,UTA,31,25,13,14,0,0,0,83,20110211
2011,CHA,27,12,29,20,0,0,0,88,ATL,27,25,20,14,0,0,0,86,20110212
2011,DAL,23,34,26,23,0,0,0,106,HOU,25,19,23,35,0,0,0,102,20110212
2011,IND,32,19,24,28,0,0,0,103,MIL,29,20,23,25,0,0,0,97,20110212
2011,PHI,28,26,31,22,0,0,0,107,MIN,32,18,24,13,0,0,0,87,20110212
2011,NYK,27,32,13,33,0,0,0,105,NJN,21,33,14,27,0,0,0,95,20110212
2011,CHI,24,18,30,25,0,0,0,97,NOH,22,31,21,14,0,0,0,88,20110212
2011,OKC,27,27,21,24,0,0,0,99,SAC,24,21,27,25,0,0,0,97,20110212
2011,SAS,37,35,29,17,0,0,0,118,WAS,18,27,20,29,0,0,0,94,20110212
2011,MIA,20,23,18,21,0,0,0,82,BOS,15,24,35,11,0,0,0,85,20110213
2011,WAS,35,33,27,20,0,0,0,115,CLE,23,23,33,21,0,0,0,100,20110213
2011,POR,20,27,27,31,0,0,0,105,DET,21,28,21,30,0,0,0,100,20110213
2011,OKC,20,23,23,28,0,0,0,94,GSW,23,24,27,26,0,0,0,100,20110213
2011,DEN,26,41,23,18,0,0,0,108,MEM,31,24,27,34,0,0,0,116,20110213
2011,LAL,21,20,19,15,0,0,0,75,ORL,24,21,22,22,0,0,0,89,20110213
2011,SAC,30,20,28,35,0,0,0,113,PHO,32,25,24,27,0,0,0,108,20110213
2011,LAC,24,24,23,22,0,0,0,93,TOR,24,24,30,20,0,0,0,98,20110213
2011,LAL,22,21,17,29,0,0,0,89,CHA,24,25,29,31,0,0,0,109,20110214
2011,ATL,20,33,21,20,0,0,0,94,DET,27,24,17,11,0,0,0,79,20110214
2011,DEN,32,22,14,34,0,0,0,102,HOU,19,39,30,33,0,0,0,121,20110214
2011,LAC,17,28,20,13,0,0,0,78,MIL,22,25,24,31,0,0,0,102,20110214
2011,POR,29,27,21,18,0,0,0,95,MIN,14,34,13,20,0,0,0,81,20110214
2011,SAS,27,32,21,22,0,0,0,102,NJN,23,25,18,19,0,0,0,85,20110214
2011,CHA,23,22,28,21,0,0,0,94,CHI,29,23,26,28,0,0,0,106,20110215
2011,NOH,32,21,18,18,0,0,0,89,GSW,22,36,25,19,0,0,0,102,20110215
2011,MIA,41,17,24,28,0,0,0,110,IND,19,35,29,20,0,0,0,103,20110215
2011,PHI,10,34,31,16,0,0,0,91,MEM,26,29,22,25,0,0,0,102,20110215
2011,SAC,24,26,25,21,0,0,0,96,OKC,37,31,32,26,0,0,0,126,20110215
2011,UTA,27,26,20,28,0,0,0,101,PHO,29,21,26,26,0,0,0,102,20110215
2011,NJN,22,24,24,10,0,0,0,80,BOS,27,19,24,24,0,0,0,94,20110216
2011,LAL,21,25,25,28,0,0,0,99,CLE,29,22,23,30,0,0,0,104,20110216
2011,SAC,25,23,28,24,0,0,0,100,DAL,25,36,35,20,0,0,0,116,20110216
2011,IND,22,33,23,26,5,0,0,109,DET,33,27,24,20,11,0,0,115,20110216
2011,PHI,23,32,31,28,0,0,0,114,HOU,23,29,26,27,0,0,0,105,20110216
2011,DEN,27,19,25,23,0,0,0,94,MIL,16,27,28,16,0,0,0,87,20110216
2011,LAC,23,20,29,26,0,0,0,98,MIN,20,22,20,28,0,0,0,90,20110216
2011,ATL,19,26,20,25,0,0,0,90,NYK,26,26,26,24,0,0,0,102,20110216
2011,WAS,18,21,16,21,0,0,0,76,ORL,17,31,32,21,0,0,0,101,20110216
2011,NOH,26,23,27,20,0,0,0,96,POR,35,13,22,33,0,0,0,103,20110216
2011,MIA,29,21,30,23,0,0,0,103,TOR,27,19,26,23,0,0,0,95,20110216
2011,GSW,20,28,28,31,0,0,0,107,UTA,23,25,28,24,0,0,0,100,20110216
2011,SAS,25,26,24,24,0,0,0,99,CHI,30,28,25,26,0,0,0,109,20110217
2011,DAL,28,26,31,27,0,0,0,112,PHO,25,26,29,26,0,0,0,106,20110217
2011,TOR,27,17,25,32,0,0,0,101,CHA,33,28,28,25,0,0,0,114,20110222
2011,MEM,23,19,34,31,0,0,0,107,DEN,32,29,41,18,0,0,0,120,20110222
2011,HOU,20,31,27,30,0,0,0,108,DET,28,23,24,25,0,0,0,100,20110222
2011,BOS,31,29,28,27,0,0,0,115,GSW,30,30,18,15,0,0,0,93,20110222
2011,ATL,15,18,21,26,0,0,0,80,LAL,28,26,26,24,0,0,0,104,20110222
2011,SAC,16,28,26,27,0,0,0,97,MIA,35,28,30,24,0,0,0,117,20110222
2011,MIN,23,21,23,21,0,0,0,88,MIL,26,18,23,27,0,0,0,94,20110222
2011,LAC,23,23,21,21,0,0,0,88,OKC,23,39,16,33,0,0,0,111,20110222
2011,IND,25,33,32,23,0,0,0,113,WAS,30,19,19,28,0,0,0,96,20110222
2011,HOU,28,33,30,33,0,0,0,124,CLE,27,38,23,31,0,0,0,119,20110223
2011,UTA,26,29,22,22,0,0,0,99,DAL,23,36,29,30,0,0,0,118,20110223
2011,DET,19,24,30,28,0,0,0,101,IND,26,25,27,24,0,0,0,102,20110223
2011,MEM,26,28,22,28,0,0,0,104,MIN,18,24,26,27,0,0,0,95,20110223
2011,LAC,16,22,24,25,0,0,0,87,NOH,23,22,28,25,0,0,0,98,20110223
2011,MIL,24,33,22,29,0,0,0,108,NYK,33,26,27,28,0,0,0,114,20110223
2011,SAC,31,27,21,32,0,0,0,111,ORL,25,36,23,21,0,0,0,105,20110223
2011,WAS,31,18,15,30,0,0,0,94,PHI,24,30,34,29,0,0,0,117,20110223
2011,ATL,31,16,24,26,0,0,0,97,PHO,33,28,19,25,0,0,0,105,20110223
2011,LAL,23,18,26,20,19,0,0,106,POR,29,18,22,18,14,0,0,101,20110223
2011,OKC,37,16,27,25,0,0,0,105,SAS,31,33,24,21,0,0,0,109,20110223
2011,CHI,29,29,23,32,0,0,0,113,TOR,25,30,30,33,0,0,0,118,20110223
2011,MIA,31,22,14,22,0,0,0,89,CHI,23,21,27,22,0,0,0,93,20110224
2011,BOS,23,13,24,15,0,0,0,75,DEN,18,19,24,28,0,0,0,89,20110224
2011,SAC,30,14,29,25,0,0,0,98,CHA,28,24,26,32,0,0,0,110,20110225
2011,NYK,30,23,22,34,0,0,0,109,CLE,28,25,30,32,0,0,0,115,20110225
2011,ATL,29,26,26,14,0,0,0,95,GSW,17,18,20,24,0,0,0,79,20110225
2011,UTA,24,19,22,30,0,0,0,95,IND,13,25,25,21,0,0,0,84,20110225
2011,LAC,31,19,17,28,0,0,0,95,LAL,30,22,33,23,0,0,0,108,20110225
2011,WAS,25,36,23,29,0,0,0,113,MIA,20,43,25,33,0,0,0,121,20110225
2011,NOH,35,20,24,16,0,0,0,95,MIN,26,17,18,20,0,0,0,81,20110225
2011,OKC,22,26,22,18,0,0,0,88,ORL,28,31,21,31,0,0,0,111,20110225
2011,DET,22,27,26,19,0,0,0,94,PHI,29,30,27,24,0,0,0,110,20110225
2011,DEN,19,20,33,25,9,0,0,106,POR,25,24,16,32,10,0,0,107,20110225
2011,NJN,25,29,18,24,0,0,0,96,SAS,29,24,35,18,0,0,0,106,20110225
2011,PHO,35,25,26,24,0,0,0,110,TOR,14,28,20,30,0,0,0,92,20110225
2011,UTA,28,25,31,32,0,0,0,116,DET,27,31,25,37,0,0,0,120,20110226
2011,NJN,33,25,24,26,0,0,0,108,HOU,37,34,28,24,0,0,0,123,20110226
2011,BOS,18,22,34,25,0,0,0,99,LAC,26,21,21,24,0,0,0,92,20110226
2011,SAC,28,21,17,26,0,0,0,92,MEM,23,33,33,31,0,0,0,120,20110226
2011,CHI,21,18,31,13,0,0,0,83,MIL,25,14,20,16,0,0,0,75,20110226
2011,DAL,23,36,19,27,0,0,0,105,WAS,22,27,23,27,0,0,0,99,20110226
2011,PHI,22,27,26,20,0,0,0,95,CLE,23,20,21,27,0,0,0,91,20110227
2011,PHO,33,27,22,17,11,0,0,110,IND,29,22,21,27,9,0,0,108,20110227
2011,NYK,23,29,13,26,0,0,0,91,MIA,34,17,15,20,0,0,0,86,20110227
2011,GSW,41,32,16,34,0,0,0,123,MIN,32,37,35,22,0,0,0,126,20110227
2011,HOU,21,19,22,29,0,0,0,91,NOH,27,28,17,17,0,0,0,89,20110227
2011,LAL,22,29,21,18,0,0,0,90,OKC,28,28,13,18,0,0,0,87,20110227
2011,CHA,28,23,18,17,0,0,0,86,ORL,30,29,21,20,0,0,0,100,20110227
2011,ATL,19,29,20,22,0,0,0,90,POR,18,18,13,34,0,0,0,83,20110227
2011,MEM,16,19,28,25,0,0,0,88,SAS,26,17,16,36,0,0,0,95,20110227
2011,DAL,24,26,25,39,0,0,0,114,TOR,30,27,15,24,0,0,0,96,20110227
2011,ATL,25,22,23,20,0,0,0,90,DEN,21,25,25,29,0,0,0,100,20110228
2011,PHO,26,26,17,27,8,0,0,104,NJN,23,28,15,30,7,0,0,103,20110228
2011,LAC,29,23,31,16,0,0,0,99,SAC,29,22,27,27,0,0,0,105,20110228
2011,BOS,30,26,23,28,0,0,0,107,UTA,21,32,22,27,0,0,0,102,20110228
2011,CHI,25,25,28,27,0,0,0,105,WAS,20,17,20,20,0,0,0,77,20110228
2011,GSW,19,27,25,29,0,0,0,100,IND,29,14,37,29,0,0,0,109,20110301
2011,SAS,30,22,15,26,0,0,0,93,MEM,32,29,22,26,0,0,0,109,20110301
2011,DET,22,28,25,15,0,0,0,90,MIL,28,23,21,20,0,0,0,92,20110301
2011,LAL,18,22,25,25,0,0,0,90,MIN,21,24,16,18,0,0,0,79,20110301
2011,NYK,21,37,26,26,0,0,0,110,ORL,32,15,32,37,0,0,0,116,20110301
2011,DAL,23,28,28,22,0,0,0,101,PHI,22,22,33,16,0,0,0,93,20110301
2011,HOU,30,23,30,20,0,0,0,103,POR,26,16,26,19,0,0,0,87,20110301
2011,NOH,20,22,20,28,0,0,0,90,TOR,27,30,15,24,0,0,0,96,20110301
2011,CHI,28,22,13,17,0,0,0,80,ATL,19,14,25,25,0,0,0,83,20110302
2011,PHO,21,21,30,31,0,0,0,103,BOS,32,30,29,24,0,0,0,115,20110302
2011,SAS,24,33,32,20,0,0,0,109,CLE,25,27,20,27,0,0,0,99,20110302
2011,CHA,23,23,21,13,0,0,0,80,DEN,31,31,29,29,0,0,0,120,20110302
2011,MIN,30,33,26,27,0,0,0,116,DET,32,29,24,20,0,0,0,105,20110302
2011,HOU,21,33,15,34,0,0,0,103,LAC,23,26,26,31,0,0,0,106,20110302
2011,NOH,25,17,20,26,0,0,0,88,NYK,27,25,30,25,0,0,0,107,20110302
2011,IND,18,24,20,27,0,0,0,89,OKC,27,36,26,24,0,0,0,113,20110302
2011,POR,30,31,18,28,0,0,0,107,SAC,29,24,20,29,0,0,0,102,20110302
2011,GSW,32,30,29,15,0,0,0,106,WAS,33,20,21,28,0,0,0,102,20110302
2011,ORL,22,23,26,28,0,0,0,99,MIA,30,33,17,16,0,0,0,96,20110303
2011,DEN,30,28,16,29,0,0,0,103,UTA,23,28,25,25,0,0,0,101,20110303
2011,OKC,31,25,27,28,0,0,0,111,ATL,26,25,22,31,0,0,0,104,20110304
2011,GSW,27,26,28,22,0,0,0,103,BOS,32,32,24,19,0,0,0,107,20110304
2011,IND,33,24,24,27,0,0,0,108,DAL,35,33,22,26,0,0,0,116,20110304
2011,CHA,19,16,22,27,0,0,0,84,LAL,29,16,24,23,0,0,0,92,20110304
2011,NOH,20,25,27,26,0,0,0,98,MEM,20,25,27,19,0,0,0,91,20110304
2011,PHO,22,23,31,26,0,0,0,102,MIL,26,22,15,25,0,0,0,88,20110304
2011,TOR,23,28,30,22,0,0,0,103,NJN,27,20,31,38,0,0,0,116,20110304
2011,CLE,32,26,27,34,0,0,0,119,NYK,32,32,24,27,0,0,0,115,20110304
2011,CHI,21,28,16,24,0,0,0,89,ORL,21,14,22,24,0,0,0,81,20110304
2011,MIN,31,18,29,22,0,0,0,100,PHI,22,34,29,26,0,0,0,111,20110304
2011,MIA,12,38,22,23,0,0,0,95,SAS,36,26,32,31,0,0,0,125,20110304
2011,IND,18,31,19,27,0,0,0,95,HOU,29,36,29,18,0,0,0,112,20110305
2011,DEN,23,15,27,29,0,0,0,94,LAC,30,18,23,29,0,0,0,100,20110305
2011,TOR,30,32,26,22,9,7,10,136,NJN,23,42,23,22,9,7,11,137,20110305
2011,CHA,16,19,17,17,0,0,0,69,POR,15,25,25,28,0,0,0,93,20110305
2011,SAC,29,20,23,23,7,0,0,102,UTA,30,27,15,23,14,0,0,109,20110305
2011,MIN,29,20,23,24,0,0,0,96,WAS,25,26,17,35,0,0,0,103,20110305
2011,NYK,24,20,18,30,0,0,0,92,ATL,19,23,14,23,0,0,0,79,20110306
2011,NOH,27,24,22,23,0,0,0,96,CLE,24,24,18,15,0,0,0,81,20110306
2011,MEM,21,17,41,25,0,0,0,104,DAL,27,28,23,25,0,0,0,103,20110306
2011,WAS,22,29,22,29,0,0,0,102,DET,29,31,22,31,0,0,0,113,20110306
2011,CHI,18,22,23,24,0,0,0,87,MIA,22,27,16,21,0,0,0,86,20110306
2011,BOS,27,16,26,20,0,0,0,89,MIL,26,23,16,18,0,0,0,83,20110306
2011,PHO,28,33,30,18,9,0,0,118,OKC,25,32,29,23,13,0,0,122,20110306
2011,GSW,25,31,24,26,11,0,0,117,PHI,31,33,16,26,19,0,0,125,20110306
2011,LAL,34,31,16,18,0,0,0,99,SAS,13,24,15,31,0,0,0,83,20110306
2011,LAC,27,22,22,21,0,0,0,92,CHA,26,21,20,20,0,0,0,87,20110307
2011,NOH,23,20,17,17,0,0,0,77,CHI,26,17,23,19,0,0,0,85,20110307
2011,OKC,24,22,27,28,0,0,0,101,MEM,25,33,21,28,0,0,0,107,20110307
2011,DAL,22,26,25,35,0,0,0,108,MIN,30,20,30,25,0,0,0,105,20110307
2011,UTA,24,24,26,35,0,0,0,109,NYK,40,26,36,29,0,0,0,131,20110307
2011,POR,24,23,23,19,0,0,0,89,ORL,19,24,23,19,0,0,0,85,20110307
2011,HOU,29,36,30,28,0,0,0,123,SAC,30,28,16,27,0,0,0,101,20110307
2011,LAL,27,30,24,20,0,0,0,101,ATL,25,24,16,22,0,0,0,87,20110308
2011,GSW,18,29,29,19,0,0,0,95,CLE,30,16,19,20,0,0,0,85,20110308
2011,PHI,34,31,19,26,0,0,0,110,IND,23,30,17,30,0,0,0,100,20110308
2011,POR,25,32,20,28,0,0,0,105,MIA,25,26,24,21,0,0,0,96,20110308
2011,HOU,26,24,32,28,0,0,0,110,PHO,24,24,31,34,0,0,0,113,20110308
2011,MIL,22,29,24,20,0,0,0,95,WAS,21,15,16,24,0,0,0,76,20110308
2011,LAC,30,30,16,32,0,0,0,108,BOS,17,25,24,37,0,0,0,103,20110309
2011,CHI,27,25,23,26,0,0,0,101,CHA,24,25,20,15,0,0,0,84,20110309
2011,NYK,30,31,35,14,0,0,0,110,MEM,27,26,29,26,0,0,0,108,20110309
2011,CLE,27,22,18,23,0,0,0,90,MIL,23,39,26,22,0,0,0,110,20110309
2011,IND,19,21,16,19,0,0,0,75,MIN,27,23,29,22,0,0,0,101,20110309
2011,GSW,22,27,28,13,0,0,0,90,NJN,29,22,23,20,0,0,0,94,20110309
2011,DAL,16,30,24,22,0,0,0,92,NOH,16,27,17,33,0,0,0,93,20110309
2011,OKC,28,27,27,19,9,0,0,110,PHI,34,21,25,21,4,0,0,105,20110309
2011,ORL,29,27,20,30,0,0,0,106,SAC,33,26,20,23,0,0,0,102,20110309
2011,DET,26,26,23,29,0,0,0,104,SAS,40,27,21,23,0,0,0,111,20110309
2011,UTA,31,21,18,26,0,0,0,96,TOR,26,24,26,18,0,0,0,94,20110309
2011,NYK,21,30,34,24,0,0,0,109,DAL,31,41,27,28,0,0,0,127,20110310
2011,LAL,26,27,17,18,0,0,0,88,MIA,29,26,13,26,0,0,0,94,20110310
2011,DEN,30,29,31,26,0,0,0,116,PHO,25,24,17,31,0,0,0,97,20110310
2011,POR,25,20,25,22,0,0,0,92,CHA,22,23,19,33,0,0,0,97,20110311
2011,ATL,20,30,10,16,0,0,0,76,CHI,22,26,24,22,0,0,0,94,20110311
2011,ORL,27,29,25,20,19,0,0,120,GSW,20,22,30,29,22,0,0,123,20110311
2011,UTA,28,29,15,29,0,0,0,101,MIN,39,27,31,25,0,0,0,122,20110311
2011,LAC,26,25,16,27,4,0,0,98,NJN,14,23,31,26,8,0,0,102,20110311
2011,DET,26,24,25,19,0,0,0,94,OKC,22,33,31,18,0,0,0,104,20110311
2011,BOS,22,23,23,18,0,0,0,86,PHI,25,24,23,17,0,0,0,89,20110311
2011,SAC,20,26,25,32,0,0,0,103,SAS,22,30,23,33,0,0,0,108,20110311
2011,IND,27,21,25,25,0,0,0,98,TOR,32,30,21,25,0,0,0,108,20110311
2011,POR,18,20,16,28,0,0,0,82,ATL,19,16,27,29,0,0,0,91,20110312
2011,UTA,17,24,30,29,0,0,0,100,CHI,37,31,20,30,0,0,0,118,20110312
2011,LAL,22,28,23,23,0,0,0,96,DAL,21,23,21,26,0,0,0,91,20110312
2011,DET,28,32,14,27,0,0,0,101,DEN,33,33,27,38,0,0,0,131,20110312
2011,SAS,36,23,22,34,0,0,0,115,HOU,25,24,33,25,0,0,0,107,20110312
2011,MEM,22,15,23,25,0,0,0,85,MIA,28,27,29,34,0,0,0,118,20110312
2011,PHI,25,16,16,17,0,0,0,74,MIL,26,33,21,22,0,0,0,102,20110312
2011,SAC,24,33,28,18,0,0,0,103,NOH,31,26,27,31,0,0,0,115,20110312
2011,LAC,38,26,27,31,0,0,0,122,WAS,27,28,18,28,0,0,0,101,20110312
2011,MIL,9,13,16,18,0,0,0,56,BOS,20,19,21,27,0,0,0,87,20110313
2011,OKC,29,21,25,20,0,0,0,95,CLE,14,24,18,19,0,0,0,75,20110313
2011,MIN,23,21,15,18,0,0,0,77,GSW,26,23,26,25,0,0,0,100,20110313
2011,IND,29,25,31,21,0,0,0,106,NYK,21,25,26,21,0,0,0,93,20110313
2011,ORL,32,29,26,24,0,0,0,111,PHO,26,26,13,23,0,0,0,88,20110313
2011,CHA,24,26,26,19,0,0,0,95,TOR,22,25,24,19,0,0,0,90,20110313
2011,PHO,16,26,22,29,0,0,0,93,HOU,27,23,24,21,0,0,0,95,20110314
2011,ORL,25,21,20,18,0,0,0,84,LAL,19,22,30,26,0,0,0,97,20110314
2011,LAC,20,16,20,26,0,0,0,82,MEM,21,29,28,27,0,0,0,105,20110314
2011,SAS,19,20,24,17,0,0,0,80,MIA,22,27,28,33,0,0,0,110,20110314
2011,BOS,23,15,23,18,0,0,0,79,NJN,14,22,31,21,0,0,0,88,20110314
2011,DEN,23,35,36,20,0,0,0,114,NOH,21,24,30,28,0,0,0,103,20110314
2011,GSW,20,39,25,35,0,0,0,119,SAC,35,36,36,22,0,0,0,129,20110314
2011,PHI,23,19,27,34,4,0,0,107,UTA,28,32,22,21,9,0,0,112,20110314
2011,OKC,33,35,27,21,0,0,0,116,WAS,24,23,23,19,0,0,0,89,20110314
2011,MIL,17,22,16,30,0,0,0,85,ATL,28,27,29,26,0,0,0,110,20110315
2011,WAS,19,27,14,19,0,0,0,79,CHI,31,19,25,23,0,0,0,98,20110315
2011,NYK,27,27,28,35,0,0,0,117,IND,29,28,30,32,0,0,0,119,20110315
2011,DAL,32,24,24,21,0,0,0,101,POR,29,24,29,22,0,0,0,104,20110315
2011,DEN,17,29,26,30,0,0,0,102,ATL,20,22,21,24,0,0,0,87,20110316
2011,IND,20,20,20,20,0,0,0,80,BOS,15,32,27,18,0,0,0,92,20110316
2011,TOR,24,28,24,17,0,0,0,93,DET,38,25,24,20,0,0,0,107,20110316
2011,DAL,25,28,28,31,0,0,0,112,GSW,34,25,22,25,0,0,0,106,20110316
2011,CHA,22,17,18,21,0,0,0,78,HOU,29,20,19,26,0,0,0,94,20110316
2011,PHI,24,25,30,25,0,0,0,104,LAC,24,22,19,29,0,0,0,94,20110316
2011,OKC,24,22,21,29,0,0,0,96,MIA,18,27,17,23,0,0,0,85,20110316
2011,ORL,23,23,15,18,14,0,0,93,MIL,14,23,27,15,10,0,0,89,20110316
2011,PHO,29,17,19,30,0,0,0,95,NOH,31,25,21,23,0,0,0,100,20110316
2011,CLE,18,27,28,24,0,0,0,97,SAC,28,23,23,19,0,0,0,93,20110316
2011,MIN,32,18,30,24,0,0,0,104,UTA,35,36,21,27,0,0,0,119,20110316
2011,CHI,24,19,17,24,0,0,0,84,NJN,20,16,14,23,0,0,0,73,20110317
2011,MEM,29,22,23,25,0,0,0,99,NYK,29,30,33,28,0,0,0,120,20110317
2011,CLE,12,22,11,25,0,0,0,70,POR,37,27,25,22,0,0,0,111,20110317
2011,MIA,25,25,36,20,0,0,0,106,ATL,21,16,20,28,0,0,0,85,20110318
2011,SAS,30,20,23,24,0,0,0,97,DAL,20,25,21,25,0,0,0,91,20110318
2011,NYK,25,28,25,17,0,0,0,95,DET,26,29,15,29,0,0,0,99,20110318
2011,BOS,22,18,16,21,0,0,0,77,HOU,28,34,19,12,0,0,0,93,20110318
2011,CHI,21,27,25,29,6,0,0,108,IND,31,31,27,13,13,0,0,115,20110318
2011,MIN,27,24,23,24,0,0,0,98,LAL,21,28,29,28,0,0,0,106,20110318
2011,NJN,26,28,19,22,0,0,0,95,MIL,29,23,28,30,0,0,0,110,20110318
2011,CHA,18,25,22,17,0,0,0,82,OKC,26,19,29,25,0,0,0,99,20110318
2011,DEN,21,21,18,22,0,0,0,82,ORL,18,29,17,21,0,0,0,85,20110318
2011,GSW,20,18,27,32,0,0,0,97,PHO,27,23,34,24,0,0,0,108,20110318
2011,PHI,32,23,25,22,0,0,0,102,SAC,23,15,16,26,0,0,0,80,20110318
2011,WAS,27,26,24,30,0,0,0,107,TOR,33,29,26,28,0,0,0,116,20110318
2011,CLE,28,22,28,14,0,0,0,92,LAC,25,29,28,18,0,0,0,100,20110319
2011,IND,20,21,19,18,0,0,0,78,MEM,27,31,18,23,0,0,0,99,20110319
2011,DEN,21,26,24,27,0,0,0,98,MIA,29,27,23,24,0,0,0,103,20110319
2011,BOS,14,26,27,22,0,0,0,89,NOH,28,23,13,21,0,0,0,85,20110319
2011,PHI,27,27,29,18,0,0,0,101,POR,36,26,25,23,0,0,0,110,20110319
2011,CHA,13,28,27,30,0,0,0,98,SAS,24,34,32,19,0,0,0,109,20110319
2011,DET,17,33,24,22,0,0,0,96,ATL,21,34,24,25,0,0,0,104,20110320
2011,GSW,23,20,20,10,0,0,0,73,DAL,31,20,25,25,0,0,0,101,20110320
2011,UTA,19,28,28,33,0,0,0,108,HOU,30,25,22,33,0,0,0,110,20110320
2011,PHO,27,27,27,27,0,0,0,108,LAC,23,26,29,21,0,0,0,99,20110320
2011,POR,20,28,18,14,0,0,0,80,LAL,27,17,18,22,0,0,0,84,20110320
2011,NYK,9,32,31,23,0,0,0,95,MIL,32,15,28,25,0,0,0,100,20110320
2011,SAC,28,29,28,42,0,0,0,127,MIN,23,25,27,20,0,0,0,95,20110320
2011,TOR,25,23,28,19,0,0,0,95,OKC,22,22,22,27,0,0,0,93,20110320
2011,NJN,35,21,12,24,0,0,0,92,WAS,23,20,28,27,0,0,0,98,20110320
2011,SAC,28,19,25,20,0,0,0,92,CHI,34,30,34,34,0,0,0,132,20110321
2011,ORL,30,26,24,17,0,0,0,97,CLE,15,23,20,28,0,0,0,86,20110321
2011,TOR,23,21,28,18,0,0,0,90,DEN,36,36,29,22,0,0,0,123,20110321
2011,UTA,21,21,23,20,0,0,0,85,MEM,29,25,26,23,0,0,0,103,20110321
2011,IND,15,25,29,33,0,0,0,102,NJN,19,25,17,37,0,0,0,98,20110321
2011,BOS,22,15,26,33,0,0,0,96,NYK,25,26,18,17,0,0,0,86,20110321
2011,GSW,21,24,24,27,0,0,0,96,SAS,32,22,32,25,0,0,0,111,20110321
2011,CHI,31,41,26,16,0,0,0,114,ATL,21,22,17,21,0,0,0,81,20110322
2011,PHO,31,29,26,26,9,9,7,137,LAL,27,39,29,17,9,9,9,139,20110322
2011,WAS,29,16,14,17,0,0,0,76,POR,35,27,29,20,0,0,0,111,20110322
2011,MEM,20,24,23,23,0,0,0,90,BOS,15,30,25,17,0,0,0,87,20110323
2011,IND,23,31,33,24,0,0,0,111,CHA,28,25,19,16,0,0,0,88,20110323
2011,NJN,17,22,23,20,16,0,0,98,CLE,22,20,20,20,12,0,0,94,20110323
2011,SAS,34,35,24,19,0,0,0,112,DEN,24,40,26,25,0,0,0,115,20110323
2011,MIA,21,32,20,27,0,0,0,100,DET,27,28,26,13,0,0,0,94,20110323
2011,GSW,33,24,28,27,0,0,0,112,HOU,36,30,34,31,0,0,0,131,20110323
2011,WAS,21,28,28,25,11,6,0,119,LAC,33,25,17,27,11,14,0,127,20110323
2011,SAC,25,28,22,22,0,0,0,97,MIL,32,24,18,16,0,0,0,90,20110323
2011,ORL,28,27,24,32,0,0,0,111,NYK,25,34,19,21,0,0,0,99,20110323
2011,UTA,25,20,24,25,0,0,0,94,OKC,32,18,28,28,0,0,0,106,20110323
2011,ATL,28,31,21,20,0,0,0,100,PHI,30,23,21,31,0,0,0,105,20110323
2011,TOR,32,29,25,20,0,0,0,106,PHO,26,29,31,28,0,0,0,114,20110323
2011,MIN,23,24,25,24,0,0,0,96,DAL,17,32,27,28,0,0,0,104,20110324
2011,NOH,27,29,22,27,16,0,0,121,UTA,32,22,24,27,12,0,0,117,20110324
2011,CHA,19,18,16,30,0,0,0,83,BOS,25,17,24,15,0,0,0,81,20110325
2011,MEM,22,24,27,23,0,0,0,96,CHI,21,28,25,25,0,0,0,99,20110325
2011,DET,24,27,17,23,0,0,0,91,CLE,26,26,23,22,0,0,0,97,20110325
2011,WAS,16,29,22,27,0,0,0,94,DEN,30,34,18,32,0,0,0,114,20110325
2011,TOR,36,22,16,26,0,0,0,100,GSW,45,39,32,22,0,0,0,138,20110325
2011,SAC,22,33,30,25,0,0,0,110,IND,18,19,31,25,0,0,0,93,20110325
2011,LAC,23,25,32,24,0,0,0,104,LAL,33,24,28,27,0,0,0,112,20110325
2011,PHI,27,23,32,17,0,0,0,99,MIA,20,31,26,34,0,0,0,111,20110325
2011,MIL,35,23,24,20,0,0,0,102,NYK,24,27,26,19,0,0,0,96,20110325
2011,MIN,27,26,29,21,0,0,0,103,OKC,30,34,24,23,0,0,0,111,20110325
2011,NJN,20,18,25,22,0,0,0,85,ORL,25,23,18,29,0,0,0,95,20110325
2011,NOH,21,29,23,33,0,0,0,106,PHO,27,29,22,22,0,0,0,100,20110325
2011,SAS,28,21,21,26,0,0,0,96,POR,24,23,26,25,0,0,0,98,20110325
2011,NJN,15,16,30,26,0,0,0,87,ATL,32,25,25,16,0,0,0,98,20110326
2011,NYK,31,20,28,27,0,0,0,106,CHA,30,34,28,22,0,0,0,114,20110326
2011,IND,25,22,18,23,0,0,0,88,DET,26,22,29,23,0,0,0,100,20110326
2011,TOR,21,23,29,17,0,0,0,90,LAC,18,25,23,28,0,0,0,94,20110326
2011,CHI,21,23,25,26,0,0,0,95,MIL,25,23,26,13,0,0,0,87,20110326
2011,DAL,20,23,15,36,0,0,0,94,UTA,22,25,13,17,0,0,0,77,20110326
2011,ATL,21,31,22,25,0,0,0,99,CLE,18,21,27,17,0,0,0,83,20110327
2011,WAS,36,31,17,20,0,0,0,104,GSW,35,29,26,24,0,0,0,114,20110327
2011,NOH,19,22,22,21,0,0,0,84,LAL,30,27,17,28,0,0,0,102,20110327
2011,SAS,23,27,27,27,0,0,0,104,MEM,24,31,26,30,0,0,0,111,20110327
2011,HOU,37,31,25,26,0,0,0,119,MIA,38,33,22,32,0,0,0,125,20110327
2011,BOS,32,15,17,21,0,0,0,85,MIN,13,21,28,20,0,0,0,82,20110327
2011,POR,20,21,31,18,0,0,0,90,OKC,21,34,23,21,0,0,0,99,20110327
2011,SAC,18,26,30,26,14,0,0,114,PHI,27,22,22,29,11,0,0,111,20110327
2011,DAL,17,27,21,26,0,0,0,91,PHO,26,23,18,16,0,0,0,83,20110327
2011,MIL,26,20,26,14,0,0,0,86,CHA,27,18,20,22,0,0,0,87,20110328
2011,PHI,27,26,16,28,0,0,0,97,CHI,13,24,27,21,0,0,0,85,20110328
2011,BOS,33,16,36,15,0,0,0,100,IND,27,30,24,26,0,0,0,107,20110328
2011,ORL,18,26,29,27,6,0,0,106,NYK,18,30,27,25,13,0,0,113,20110328
2011,POR,28,30,9,33,0,0,0,100,SAS,22,29,21,20,0,0,0,92,20110328
2011,WAS,16,35,22,12,15,0,0,100,UTA,21,22,20,22,10,0,0,95,20110328
2011,MIA,24,18,28,20,0,0,0,90,CLE,24,29,22,27,0,0,0,102,20110329
2011,HOU,34,27,22,29,0,0,0,112,NJN,21,22,20,24,0,0,0,87,20110329
2011,GSW,29,21,27,29,8,0,0,114,OKC,25,33,20,28,9,0,0,115,20110329
2011,PHO,34,27,32,20,0,0,0,113,SAC,30,29,26,31,0,0,0,116,20110329
2011,ORL,25,18,18,21,0,0,0,82,ATL,27,19,23,16,0,0,0,85,20110330
2011,CLE,26,24,26,21,0,0,0,97,CHA,28,19,29,22,0,0,0,98,20110330
2011,SAC,28,23,20,19,0,0,0,90,DEN,20,21,33,30,0,0,0,104,20110330
2011,DET,27,20,23,31,0,0,0,101,IND,24,35,32,20,0,0,0,111,20110330
2011,DAL,23,25,27,31,0,0,0,106,LAC,28,18,24,30,0,0,0,100,20110330
2011,GSW,24,29,19,19,0,0,0,91,MEM,29,19,31,31,0,0,0,110,20110330
2011,CHI,30,27,29,22,0,0,0,108,MIN,19,25,22,25,0,0,0,91,20110330
2011,POR,31,19,20,21,0,0,0,91,NOH,25,23,20,27,0,0,0,95,20110330
2011,NJN,36,32,24,24,0,0,0,116,NYK,30,28,33,29,0,0,0,120,20110330
2011,HOU,33,22,27,15,0,0,0,97,PHI,31,21,32,24,0,0,0,108,20110330
2011,OKC,33,22,24,37,0,0,0,116,PHO,28,23,22,25,0,0,0,98,20110330
2011,MIL,22,30,24,28,0,0,0,104,TOR,28,21,27,22,0,0,0,98,20110330
2011,MIA,32,31,25,35,0,0,0,123,WAS,29,23,29,26,0,0,0,107,20110330
2011,DAL,26,25,19,12,0,0,0,82,LAL,28,26,28,28,0,0,0,110,20110331
2011,BOS,31,18,28,30,0,0,0,107,SAS,33,16,21,27,0,0,0,97,20110331
2011,BOS,21,31,16,15,0,0,0,83,ATL,23,21,18,26,0,0,0,88,20110401
2011,CHI,31,27,22,21,0,0,0,101,DET,21,26,25,24,0,0,0,96,20110401
2011,SAS,27,29,29,23,6,0,0,114,HOU,31,33,23,21,11,0,0,119,20110401
2011,MIL,22,17,21,28,0,0,0,88,IND,14,32,23,20,0,0,0,89,20110401
2011,MIA,30,21,34,26,0,0,0,111,MIN,20,32,20,20,0,0,0,92,20110401
2011,MEM,23,28,20,22,0,0,0,93,NOH,12,26,23,20,0,0,0,81,20110401
2011,CHA,17,22,21,17,0,0,0,77,ORL,23,26,21,19,0,0,0,89,20110401
2011,NJN,21,22,22,25,0,0,0,90,PHI,29,31,34,21,0,0,0,115,20110401
2011,LAC,23,21,26,28,0,0,0,98,PHO,25,32,31,23,0,0,0,111,20110401
2011,OKC,30,29,11,21,0,0,0,91,POR,20,33,25,20,0,0,0,98,20110401
2011,DEN,21,27,31,20,0,0,0,99,SAC,28,23,16,23,0,0,0,90,20110401
2011,LAL,22,20,29,25,0,0,0,96,UTA,28,20,16,21,0,0,0,85,20110401
2011,CLE,26,31,25,25,0,0,0,107,WAS,29,23,31,32,0,0,0,115,20110401
2011,TOR,19,24,32,31,0,0,0,106,CHI,25,28,30,30,0,0,0,113,20110402
2011,DAL,29,21,17,25,0,0,0,92,GSW,28,20,24,27,0,0,0,99,20110402
2011,OKC,22,27,22,21,0,0,0,92,LAC,15,22,31,30,0,0,0,98,20110402
2011,MIN,20,24,20,25,0,0,0,89,MEM,29,27,17,33,0,0,0,106,20110402
2011,PHI,30,18,13,18,8,0,0,87,MIL,20,19,22,18,14,0,0,93,20110402
2011,DET,29,19,18,24,0,0,0,90,BOS,26,23,33,19,0,0,0,101,20110403
2011,WAS,22,26,28,21,0,0,0,97,CHA,19,24,22,26,0,0,0,91,20110403
2011,ATL,23,40,18,28,0,0,0,109,HOU,21,33,32,28,0,0,0,114,20110403
2011,DEN,21,19,29,26,0,0,0,95,LAL,20,27,22,21,0,0,0,90,20110403
2011,MIA,32,26,19,31,0,0,0,108,NJN,18,26,25,25,0,0,0,94,20110403
2011,IND,21,23,21,31,0,0,0,96,NOH,29,28,32,19,0,0,0,108,20110403
2011,CLE,25,32,31,19,0,0,0,107,NYK,36,31,26,30,0,0,0,123,20110403
2011,DAL,17,29,21,29,0,0,0,96,POR,23,38,24,19,0,0,0,104,20110403
2011,UTA,19,21,32,25,0,0,0,97,SAC,26,24,31,25,0,0,0,106,20110403
2011,PHO,20,26,25,26,0,0,0,97,SAS,35,35,21,23,0,0,0,114,20110403
2011,ORL,19,30,30,19,0,0,0,98,TOR,23,23,27,29,0,0,0,102,20110403
2011,SAS,16,27,23,31,0,0,0,97,ATL,21,25,19,25,0,0,0,90,20110405
2011,PHI,26,24,15,17,0,0,0,82,BOS,24,30,21,24,0,0,0,99,20110405
2011,PHO,24,16,30,24,0,0,0,94,CHI,25,28,28,16,0,0,0,97,20110405
2011,CHA,16,22,28,23,0,0,0,89,CLE,34,21,19,25,0,0,0,99,20110405
2011,OKC,27,21,21,32,0,0,0,101,DEN,16,31,20,27,0,0,0,94,20110405
2011,SAC,24,28,24,28,0,0,0,104,HOU,28,18,28,27,0,0,0,101,20110405
2011,UTA,20,14,23,29,0,0,0,86,LAL,24,16,17,28,0,0,0,85,20110405
2011,LAC,18,21,20,23,0,0,0,82,MEM,23,20,25,13,0,0,0,81,20110405
2011,MIN,23,27,25,30,0,0,0,105,NJN,29,32,24,22,0,0,0,107,20110405
2011,TOR,26,28,28,36,0,0,0,118,NYK,39,39,21,32,0,0,0,131,20110405
2011,MIL,14,19,22,17,0,0,0,72,ORL,26,16,15,21,0,0,0,78,20110405
2011,GSW,19,28,37,24,0,0,0,108,POR,19,28,21,19,0,0,0,87,20110405
2011,DET,22,32,27,24,0,0,0,105,WAS,31,21,26,29,0,0,0,107,20110405
2011,ORL,26,21,24,25,15,0,0,111,CHA,28,25,24,19,6,0,0,102,20110406
2011,DEN,23,30,19,32,0,0,0,104,DAL,17,26,26,27,0,0,0,96,20110406
2011,NJN,28,31,29,21,0,0,0,109,DET,32,22,35,27,0,0,0,116,20110406
2011,LAL,23,15,17,32,0,0,0,87,GSW,14,29,29,23,0,0,0,95,20110406
2011,WAS,29,27,31,25,0,0,0,112,IND,43,32,33,28,0,0,0,136,20110406
2011,MIL,25,20,18,27,0,0,0,90,MIA,15,25,23,22,0,0,0,85,20110406
2011,PHO,26,30,26,26,0,0,0,108,MIN,23,30,24,21,0,0,0,98,20110406
2011,HOU,38,17,16,22,0,0,0,93,NOH,21,30,23,27,0,0,0,101,20110406
2011,LAC,31,22,24,31,0,0,0,108,OKC,26,32,29,25,0,0,0,112,20110406
2011,NYK,26,23,29,19,0,0,0,97,PHI,19,22,24,27,0,0,0,92,20110406
2011,SAC,22,27,21,22,0,0,0,92,SAS,23,28,41,32,0,0,0,124,20110406
2011,CLE,28,32,17,27,0,0,0,104,TOR,17,23,24,32,0,0,0,96,20110406
2011,BOS,18,25,17,21,0,0,0,81,CHI,26,22,23,26,0,0,0,97,20110407
2011,POR,27,22,30,19,0,0,0,98,UTA,18,24,25,20,0,0,0,87,20110407
2011,WAS,23,33,19,13,0,0,0,88,BOS,28,31,24,21,0,0,0,104,20110408
2011,CHI,29,25,24,15,0,0,0,93,CLE,26,20,17,19,0,0,0,82,20110408
2011,LAC,35,19,21,21,0,0,0,96,DAL,19,28,30,30,0,0,0,107,20110408
2011,MIL,21,30,23,26,0,0,0,100,DET,26,29,29,26,0,0,0,110,20110408
2011,ATL,26,24,21,31,0,0,0,102,IND,33,23,26,32,0,0,0,114,20110408
2011,SAC,21,22,24,29,0,0,0,96,MEM,28,18,31,24,0,0,0,101,20110408
2011,CHA,25,19,25,34,0,0,0,103,MIA,31,24,28,29,0,0,0,112,20110408
2011,NYK,36,32,28,20,0,0,0,116,NJN,31,20,21,21,0,0,0,93,20110408
2011,PHO,30,23,26,18,0,0,0,97,NOH,31,28,26,24,0,0,0,109,20110408
2011,DEN,17,25,22,25,0,0,0,89,OKC,17,31,27,29,0,0,0,104,20110408
2011,TOR,18,24,30,21,0,0,0,93,PHI,28,26,19,25,0,0,0,98,20110408
2011,LAL,21,26,15,24,0,0,0,86,POR,21,32,21,19,0,0,0,93,20110408
2011,MIN,23,28,18,37,0,0,0,106,DEN,25,40,36,29,0,0,0,130,20110409
2011,LAC,18,19,18,23,0,0,0,78,HOU,25,28,21,25,0,0,0,99,20110409
2011,CLE,18,26,34,23,0,0,0,101,MIL,30,30,25,23,0,0,0,108,20110409
2011,UTA,22,24,30,26,0,0,0,102,SAS,25,32,32,22,0,0,0,111,20110409
2011,ATL,18,28,26,11,0,0,0,83,WAS,29,32,27,27,0,0,0,115,20110409
2011,DET,25,25,34,28,0,0,0,112,CHA,40,19,19,23,0,0,0,101,20110410
2011,PHO,17,22,21,30,0,0,0,90,DAL,36,29,15,35,0,0,0,115,20110410
2011,SAC,30,30,17,27,0,0,0,104,GSW,26,33,24,20,0,0,0,103,20110410
2011,NYK,33,34,20,23,0,0,0,110,IND,33,28,35,13,0,0,0,109,20110410
2011,OKC,36,30,22,32,0,0,0,120,LAL,31,33,26,16,0,0,0,106,20110410
2011,NOH,30,18,19,22,0,0,0,89,MEM,30,22,30,29,0,0,0,111,20110410
2011,BOS,22,18,19,18,0,0,0,77,MIA,21,26,27,26,0,0,0,100,20110410
2011,CHI,32,18,30,22,0,0,0,102,ORL,24,25,28,22,0,0,0,99,20110410
2011,NJN,22,20,20,30,0,0,0,92,TOR,31,30,21,17,0,0,0,99,20110410
2011,MIA,28,34,17,19,0,0,0,98,ATL,23,23,21,23,0,0,0,90,20110411
2011,GSW,32,22,37,20,0,0,0,111,DEN,31,23,44,36,0,0,0,134,20110411
2011,CLE,23,33,30,24,0,0,0,110,DET,33,24,18,26,0,0,0,101,20110411
2011,DAL,20,23,24,19,12,0,0,98,HOU,23,24,24,15,5,0,0,91,20110411
2011,TOR,33,18,20,15,0,0,0,86,MIL,25,21,23,24,0,0,0,93,20110411
2011,CHA,25,24,30,26,0,0,0,105,NJN,29,24,20,30,0,0,0,103,20110411
2011,UTA,29,18,23,20,0,0,0,90,NOH,21,16,20,21,0,0,0,78,20110411
2011,ORL,34,16,26,19,0,0,0,95,PHI,25,22,15,23,0,0,0,85,20110411
2011,MIN,33,32,27,29,6,0,0,127,PHO,24,34,34,29,14,0,0,135,20110411
2011,OKC,24,27,36,33,0,0,0,120,SAC,20,37,26,29,0,0,0,112,20110411
2011,BOS,23,21,16,24,10,0,0,94,WAS,19,18,23,24,11,0,0,95,20110411
2011,SAS,15,30,19,29,0,0,0,93,LAL,24,21,25,32,0,0,0,102,20110412
2011,CHI,24,28,32,19,0,0,0,103,NYK,27,28,18,17,0,0,0,90,20110412
2011,MEM,25,20,21,23,0,0,0,89,POR,27,18,29,28,0,0,0,102,20110412
2011,NYK,28,29,27,18,0,0,0,102,BOS,27,34,25,26,0,0,0,112,20110413
2011,ATL,18,25,23,19,0,0,0,85,CHA,29,32,13,22,0,0,0,96,20110413
2011,NJN,20,23,25,24,0,0,0,92,CHI,26,24,18,29,0,0,0,97,20110413
2011,WAS,35,15,24,19,0,0,0,93,CLE,23,24,24,29,0,0,0,100,20110413
2011,NOH,27,34,13,15,0,0,0,89,DAL,28,30,28,35,0,0,0,121,20110413
2011,POR,28,17,24,17,0,0,0,86,GSW,30,21,34,25,0,0,0,110,20110413
2011,MEM,20,17,37,29,0,0,0,103,LAC,34,32,26,18,0,0,0,110,20110413
2011,HOU,32,37,21,31,0,0,0,121,MIN,30,22,37,13,0,0,0,102,20110413
2011,MIL,16,30,18,32,14,0,0,110,OKC,21,22,31,22,10,0,0,106,20110413
2011,IND,14,15,26,19,0,0,0,74,ORL,28,25,18,21,0,0,0,92,20110413
2011,DET,29,23,31,21,0,0,0,104,PHI,24,32,21,23,0,0,0,100,20110413
2011,SAS,27,26,21,29,0,0,0,103,PHO,43,18,24,21,0,0,0,106,20110413
2011,LAL,31,25,32,11,17,0,0,116,SAC,26,22,22,29,9,0,0,108,20110413
2011,MIA,29,21,20,27,0,0,0,97,TOR,20,31,18,10,0,0,0,79,20110413
2011,DEN,31,27,20,25,0,0,0,103,UTA,29,32,21,25,0,0,0,107,20110413
2011,IND,27,28,24,20,0,0,0,99,CHI,23,28,20,33,0,0,0,104,20110416
2011,POR,22,15,20,24,0,0,0,81,DAL,21,26,14,28,0,0,0,89,20110416
2011,PHI,31,18,20,20,0,0,0,89,MIA,19,35,26,17,0,0,0,97,20110416
2011,ATL,17,38,30,18,0,0,0,103,ORL,19,29,23,22,0,0,0,93,20110416
2011,NYK,23,28,13,21,0,0,0,85,BOS,24,15,20,28,0,0,0,87,20110417
2011,NOH,26,29,18,36,0,0,0,109,LAL,24,23,25,28,0,0,0,100,20110417
2011,DEN,33,27,22,21,0,0,0,103,OKC,24,35,27,21,0,0,0,107,20110417
2011,MEM,27,18,25,31,0,0,0,101,SAS,22,21,31,24,0,0,0,98,20110417
2011,IND,18,29,20,23,0,0,0,90,CHI,17,27,23,29,0,0,0,96,20110418
2011,PHI,13,18,21,21,0,0,0,73,MIA,19,30,26,19,0,0,0,94,20110418
2011,NYK,21,24,22,26,0,0,0,93,BOS,23,21,30,22,0,0,0,96,20110419
2011,POR,24,28,20,17,0,0,0,89,DAL,22,28,23,28,0,0,0,101,20110419
2011,ATL,22,20,12,28,0,0,0,82,ORL,16,32,17,23,0,0,0,88,20110419
2011,NOH,23,18,15,22,0,0,0,78,LAL,23,24,16,24,0,0,0,87,20110420
2011,DEN,15,29,22,23,0,0,0,89,OKC,31,28,22,25,0,0,0,106,20110420
2011,MEM,17,27,21,22,0,0,0,87,SAS,17,24,25,27,0,0,0,93,20110420
2011,CHI,21,21,23,23,0,0,0,88,IND,17,25,22,20,0,0,0,84,20110421
2011,MIA,21,29,23,27,0,0,0,100,PHI,29,23,23,19,0,0,0,94,20110421
2011,DAL,23,29,20,20,0,0,0,92,POR,28,26,21,22,0,0,0,97,20110421
2011,ORL,25,17,20,22,0,0,0,84,ATL,25,26,15,22,0,0,0,88,20110422
2011,LAL,30,21,24,25,0,0,0,100,NOH,23,19,26,18,0,0,0,86,20110422
2011,BOS,27,25,34,27,0,0,0,113,NYK,20,24,19,33,0,0,0,96,20110422
2011,OKC,26,30,15,26,0,0,0,97,DEN,31,18,24,21,0,0,0,94,20110423
2011,CHI,19,14,23,28,0,0,0,84,IND,23,26,18,22,0,0,0,89,20110423
2011,SAS,20,22,24,22,0,0,0,88,MEM,29,23,19,20,0,0,0,91,20110423
2011,DAL,16,21,30,15,0,0,0,82,POR,11,24,14,35,0,0,0,84,20110423
2011,ORL,17,20,24,24,0,0,0,85,ATL,25,21,20,22,0,0,0,88,20110424
2011,LAL,25,20,22,21,0,0,0,88,NOH,22,27,20,24,0,0,0,93,20110424
2011,BOS,29,26,27,19,0,0,0,101,NYK,23,15,34,17,0,0,0,89,20110424
2011,MIA,16,31,19,16,0,0,0,82,PHI,28,18,18,22,0,0,0,86,20110424
2011,POR,20,23,20,19,0,0,0,82,DAL,15,29,31,18,0,0,0,93,20110425
2011,OKC,20,25,24,32,0,0,0,101,DEN,26,19,26,33,0,0,0,104,20110425
2011,SAS,26,24,15,21,0,0,0,86,MEM,21,27,30,26,0,0,0,104,20110425
2011,IND,25,21,19,24,0,0,0,89,CHI,36,18,30,32,0,0,0,116,20110426
2011,NOH,32,19,21,18,0,0,0,90,LAL,23,31,25,27,0,0,0,106,20110426
2011,ATL,13,22,18,23,0,0,0,76,ORL,26,32,21,22,0,0,0,101,20110426
2011,PHI,23,19,25,24,0,0,0,91,MIA,27,18,27,25,0,0,0,97,20110427
2011,DEN,28,22,26,21,0,0,0,97,OKC,25,25,22,28,0,0,0,100,20110427
2011,MEM,14,28,26,29,6,0,0,103,SAS,20,30,15,32,13,0,0,110,20110427
2011,ORL,18,18,19,26,0,0,0,81,ATL,23,19,20,22,0,0,0,84,20110428
2011,LAL,18,22,29,29,0,0,0,98,NOH,16,18,23,23,0,0,0,80,20110428
2011,DAL,19,33,23,28,0,0,0,103,POR,27,16,19,34,0,0,0,96,20110428
2011,SAS,16,27,23,25,0,0,0,91,MEM,24,22,24,29,0,0,0,99,20110429
2011,BOS,14,22,26,28,0,0,0,90,MIA,20,31,25,23,0,0,0,99,20110501
2011,MEM,28,29,27,30,0,0,0,114,OKC,24,23,24,30,0,0,0,101,20110501
2011,ATL,28,23,21,31,0,0,0,103,CHI,18,32,21,24,0,0,0,95,20110502
2011,DAL,25,19,27,25,0,0,0,96,LAL,23,30,25,16,0,0,0,94,20110502
2011,BOS,26,16,25,24,0,0,0,91,MIA,27,20,25,30,0,0,0,102,20110503
2011,MEM,17,27,24,34,0,0,0,102,OKC,28,26,22,35,0,0,0,111,20110503
2011,ATL,19,18,21,15,0,0,0,73,CHI,25,23,17,21,0,0,0,86,20110504
2011,DAL,26,25,17,25,0,0,0,93,LAL,20,29,13,19,0,0,0,81,20110504
2011,CHI,29,27,24,19,0,0,0,99,ATL,23,20,20,19,0,0,0,82,20110506
2011,LAL,27,24,21,20,0,0,0,92,DAL,29,18,19,32,0,0,0,98,20110506
2011,MIA,21,25,15,20,0,0,0,81,BOS,27,17,28,25,0,0,0,97,20110507
2011,OKC,20,31,25,10,7,0,0,93,MEM,22,21,20,23,15,0,0,101,20110507
2011,CHI,26,20,23,19,0,0,0,88,ATL,28,19,20,33,0,0,0,100,20110508
2011,LAL,23,16,23,24,0,0,0,86,DAL,27,36,23,36,0,0,0,122,20110508
2011,MIA,28,22,19,17,12,0,0,98,BOS,31,22,20,13,4,0,0,90,20110509
2011,OKC,16,33,22,25,13,10,14,133,MEM,28,25,19,24,13,10,4,123,20110509
2011,ATL,21,21,26,15,0,0,0,83,CHI,32,16,21,26,0,0,0,95,20110510
2011,BOS,24,25,24,14,0,0,0,87,MIA,16,31,24,26,0,0,0,97,20110511
2011,MEM,17,18,17,20,0,0,0,72,OKC,17,29,25,28,0,0,0,99,20110511
2011,CHI,27,18,25,23,0,0,0,93,ATL,17,18,18,20,0,0,0,73,20110512
2011,OKC,21,33,14,15,0,0,0,83,MEM,23,21,28,23,0,0,0,95,20110513
2011,MIA,23,25,15,19,0,0,0,82,CHI,20,28,24,31,0,0,0,103,20110515
2011,MEM,17,17,24,32,0,0,0,90,OKC,21,21,30,33,0,0,0,105,20110515
2011,OKC,27,21,31,33,0,0,0,112,DAL,20,35,35,31,0,0,0,121,20110517
2011,MIA,19,29,23,14,0,0,0,85,CHI,26,20,19,10,0,0,0,75,20110518
2011,OKC,26,33,18,29,0,0,0,106,DAL,31,26,19,24,0,0,0,100,20110519
2011,DAL,27,25,18,23,0,0,0,93,OKC,12,24,20,31,0,0,0,87,20110521
2011,CHI,15,25,25,20,0,0,0,85,MIA,18,25,25,28,0,0,0,96,20110522
2011,DAL,22,32,23,24,11,0,0,112,OKC,31,28,22,20,4,0,0,105,20110523
2011,CHI,19,27,22,17,8,0,0,93,MIA,16,28,19,22,16,0,0,101,20110524
2011,OKC,27,28,21,20,0,0,0,96,DAL,26,26,20,28,0,0,0,100,20110525
2011,MIA,21,17,19,26,0,0,0,83,CHI,25,20,17,18,0,0,0,80,20110526
2011,DAL,17,27,17,23,0,0,0,84,MIA,16,27,22,27,0,0,0,92,20110531
2011,DAL,28,23,20,24,0,0,0,95,MIA,28,23,24,18,0,0,0,93,20110602
2011,MIA,29,18,20,21,0,0,0,88,DAL,22,20,22,22,0,0,0,86,20110605
2011,MIA,21,26,22,14,0,0,0,83,DAL,21,24,20,21,0,0,0,86,20110607
2011,MIA,31,26,22,24,0,0,0,103,DAL,30,30,24,28,0,0,0,112,20110609
2011,DAL,32,21,28,24,0,0,0,105,MIA,27,24,21,23,0,0,0,95,20110612
2012,MIA,32,30,35,8,0,0,0,105,DAL,17,24,24,29,0,0,0,94,20111225
2012,LAC,24,17,34,30,0,0,0,105,GSW,20,23,25,18,0,0,0,86,20111225
2012,CHI,22,34,12,20,0,0,0,88,LAL,20,29,20,18,0,0,0,87,20111225
2012,BOS,23,29,35,17,0,0,0,104,NYK,34,28,17,27,0,0,0,106,20111225
2012,ORL,22,19,22,26,0,0,0,89,OKC,27,28,26,16,0,0,0,97,20111225
2012,MIL,27,25,14,29,0,0,0,95,CHA,19,22,30,25,0,0,0,96,20111226
2012,TOR,23,29,26,26,0,0,0,104,CLE,23,19,28,26,0,0,0,96,20111226
2012,DEN,32,37,28,18,0,0,0,115,DAL,23,19,26,25,0,0,0,93,20111226
2012,CHI,22,19,20,30,0,0,0,91,GSW,30,27,21,21,0,0,0,99,20111226
2012,DET,17,21,20,21,0,0,0,79,IND,26,26,24,15,0,0,0,91,20111226
2012,OKC,23,29,26,26,0,0,0,104,MIN,24,22,26,28,0,0,0,100,20111226
2012,HOU,23,27,23,22,0,0,0,95,ORL,27,26,24,27,0,0,0,104,20111226
2012,NOH,23,24,15,23,0,0,0,85,PHO,20,21,24,19,0,0,0,84,20111226
2012,PHI,15,29,28,31,0,0,0,103,POR,26,22,29,30,0,0,0,107,20111226
2012,LAL,20,20,24,27,0,0,0,91,SAC,21,28,29,22,0,0,0,100,20111226
2012,MEM,22,22,14,24,0,0,0,82,SAS,14,29,29,23,0,0,0,95,20111226
2012,NJN,13,24,29,24,0,0,0,90,WAS,26,19,22,17,0,0,0,84,20111226
2012,UTA,17,14,15,25,0,0,0,71,LAL,18,23,30,25,0,0,0,96,20111227
2012,BOS,27,27,29,24,0,0,0,107,MIA,30,39,22,24,0,0,0,115,20111227
2012,MIN,30,18,20,27,0,0,0,95,MIL,32,28,19,19,0,0,0,98,20111227
2012,ATL,28,24,25,29,0,0,0,106,NJN,11,19,25,15,0,0,0,70,20111227
2012,SAC,25,21,19,14,0,0,0,79,POR,23,23,28,27,0,0,0,101,20111227
2012,WAS,17,25,22,19,0,0,0,83,ATL,26,29,30,16,0,0,0,101,20111228
2012,MIA,20,25,24,27,0,0,0,96,CHA,32,28,10,25,0,0,0,95,20111228
2012,UTA,23,23,20,34,0,0,0,100,DEN,28,35,25,29,0,0,0,117,20111228
2012,CLE,25,25,29,26,0,0,0,105,DET,23,16,30,20,0,0,0,89,20111228
2012,NYK,23,20,21,14,0,0,0,78,GSW,21,16,27,28,0,0,0,92,20111228
2012,OKC,23,31,18,26,0,0,0,98,MEM,20,29,21,25,0,0,0,95,20111228
2012,BOS,18,21,24,15,0,0,0,78,NOH,24,24,24,25,0,0,0,97,20111228
2012,PHI,25,23,32,23,0,0,0,103,PHO,18,16,20,29,0,0,0,83,20111228
2012,LAC,19,35,17,19,0,0,0,90,SAS,26,32,38,19,0,0,0,115,20111228
2012,IND,18,20,25,27,0,0,0,90,TOR,11,23,21,30,0,0,0,85,20111228
2012,SAS,18,17,24,26,0,0,0,85,HOU,23,30,25,27,0,0,0,105,20111229
2012,NYK,24,27,21,10,0,0,0,82,LAL,31,32,17,19,0,0,0,99,20111229
2012,DAL,29,23,24,26,0,0,0,102,OKC,28,28,22,26,0,0,0,104,20111229
2012,NJN,16,28,18,16,0,0,0,78,ORL,28,22,25,19,0,0,0,94,20111229
2012,DEN,17,36,26,23,0,0,0,102,POR,30,23,30,28,0,0,0,111,20111229
2012,CHI,30,30,25,23,0,0,0,108,SAC,24,29,22,23,0,0,0,98,20111229
2012,NJN,19,18,35,26,0,0,0,98,ATL,20,23,33,29,0,0,0,105,20111230
2012,DET,22,21,21,21,0,0,0,85,BOS,24,26,36,10,0,0,0,96,20111230
2012,ORL,29,27,19,25,0,0,0,100,CHA,23,20,19,17,0,0,0,79,20111230
2012,TOR,23,23,24,16,0,0,0,86,DAL,29,21,27,22,0,0,0,99,20111230
2012,CLE,24,23,14,23,7,0,0,91,IND,22,23,25,14,14,0,0,98,20111230
2012,CHI,29,28,26,31,0,0,0,114,LAC,28,24,25,24,0,0,0,101,20111230
2012,HOU,28,23,16,26,0,0,0,93,MEM,30,27,31,25,0,0,0,113,20111230
2012,WAS,24,17,26,14,0,0,0,81,MIL,36,29,13,24,0,0,0,102,20111230
2012,MIA,31,20,31,21,0,0,0,103,MIN,20,33,22,26,0,0,0,101,20111230
2012,PHO,22,30,23,18,0,0,0,93,NOH,22,23,16,17,0,0,0,78,20111230
2012,PHI,29,22,22,26,0,0,0,99,UTA,22,31,18,31,0,0,0,102,20111230
2012,IND,18,26,20,24,0,0,0,88,DET,21,31,30,14,0,0,0,96,20111231
2012,PHI,19,31,22,35,0,0,0,107,GSW,25,17,12,25,0,0,0,79,20111231
2012,ATL,22,22,16,24,0,0,0,84,HOU,31,20,21,23,0,0,0,95,20111231
2012,DEN,23,22,26,18,0,0,0,89,LAL,22,24,23,23,0,0,0,92,20111231
2012,PHO,22,24,21,30,0,0,0,97,OKC,27,33,29,18,0,0,0,107,20111231
2012,NYK,35,21,22,36,0,0,0,114,SAC,20,22,23,27,0,0,0,92,20111231
2012,UTA,18,21,21,29,0,0,0,89,SAS,23,31,29,21,0,0,0,104,20111231
2012,MEM,12,16,16,20,0,0,0,64,CHI,25,29,30,20,0,0,0,104,20120101
2012,NJN,27,22,18,15,0,0,0,82,CLE,24,19,30,25,0,0,0,98,20120101
2012,LAL,21,15,35,19,0,0,0,90,DEN,26,21,25,27,0,0,0,99,20120101
2012,POR,17,19,16,36,0,0,0,88,LAC,21,23,25,24,0,0,0,93,20120101
2012,CHA,15,22,27,26,0,0,0,90,MIA,33,32,27,37,0,0,0,129,20120101
2012,DAL,25,16,28,13,0,0,0,82,MIN,25,25,24,25,0,0,0,99,20120101
2012,TOR,27,25,29,15,0,0,0,96,ORL,18,29,23,32,0,0,0,102,20120101
2012,NOH,22,18,18,22,0,0,0,80,SAC,21,17,30,28,0,0,0,96,20120101
2012,BOS,28,23,22,21,0,0,0,94,WAS,17,17,26,26,0,0,0,86,20120101
2012,WAS,24,24,22,22,0,0,0,92,BOS,23,24,22,31,0,0,0,100,20120102
2012,OKC,20,27,18,22,0,0,0,87,DAL,20,34,24,22,0,0,0,100,20120102
2012,MIL,30,18,26,12,0,0,0,86,DEN,24,24,20,23,0,0,0,91,20120102
2012,ORL,19,27,17,15,0,0,0,78,DET,21,23,24,21,0,0,0,89,20120102
2012,ATL,19,28,20,33,0,0,0,100,MIA,23,27,21,21,0,0,0,92,20120102
2012,SAS,25,34,21,16,0,0,0,96,MIN,35,31,28,12,0,0,0,106,20120102
2012,IND,29,19,29,31,0,0,0,108,NJN,21,21,22,30,0,0,0,94,20120102
2012,TOR,22,29,16,23,0,0,0,90,NYK,23,11,24,27,0,0,0,85,20120102
2012,GSW,26,21,22,22,0,0,0,91,PHO,25,26,21,30,0,0,0,102,20120102
2012,NOH,22,25,27,16,0,0,0,90,UTA,18,32,20,24,0,0,0,94,20120102
2012,ATL,23,15,18,18,0,0,0,74,CHI,15,11,16,34,0,0,0,76,20120103
2012,CHA,34,17,29,21,0,0,0,101,CLE,27,30,30,28,0,0,0,115,20120103
2012,HOU,25,21,29,24,0,0,0,99,LAL,31,19,26,32,0,0,0,108,20120103
2012,SAC,17,33,18,28,0,0,0,96,MEM,31,21,35,26,0,0,0,113,20120103
2012,POR,21,30,27,25,0,0,0,103,OKC,26,27,21,19,0,0,0,93,20120103
2012,MIL,16,18,21,18,0,0,0,73,UTA,22,21,19,23,0,0,0,85,20120103
2012,NJN,17,18,12,23,0,0,0,70,BOS,18,16,29,26,0,0,0,89,20120104
2012,PHO,25,16,25,23,0,0,0,89,DAL,25,24,28,21,0,0,0,98,20120104
2012,SAC,17,22,25,19,0,0,0,83,DEN,27,29,29,25,0,0,0,110,20120104
2012,CHI,22,29,20,28,0,0,0,99,DET,14,21,23,25,0,0,0,83,20120104
2012,HOU,26,29,20,14,0,0,0,89,LAC,41,26,23,27,0,0,0,117,20120104
2012,IND,27,12,27,17,0,0,0,83,MIA,29,33,26,30,0,0,0,118,20120104
2012,MEM,20,23,14,33,0,0,0,90,MIN,14,23,22,27,0,0,0,86,20120104
2012,PHI,16,24,27,34,0,0,0,101,NOH,27,20,26,20,0,0,0,93,20120104
2012,CHA,30,32,26,30,0,0,0,118,NYK,26,26,26,32,0,0,0,110,20120104
2012,WAS,14,24,22,25,0,0,0,85,ORL,31,25,27,20,0,0,0,103,20120104
2012,GSW,26,27,22,20,0,0,0,95,SAS,20,25,25,31,0,0,0,101,20120104
2012,CLE,18,21,12,26,0,0,0,77,TOR,21,25,20,26,0,0,0,92,20120104
2012,MIA,22,32,14,25,6,10,7,116,ATL,19,30,21,23,6,10,0,109,20120105
2012,LAL,31,25,18,22,0,0,0,96,POR,27,25,32,23,0,0,0,107,20120105
2012,MIL,30,28,24,18,0,0,0,100,SAC,25,12,31,35,0,0,0,103,20120105
2012,DAL,17,12,13,29,0,0,0,71,SAS,31,24,11,27,0,0,0,93,20120105
2012,IND,14,19,30,24,0,0,0,87,BOS,14,11,30,19,0,0,0,74,20120106
2012,ATL,20,23,27,21,11,0,0,102,CHA,18,20,23,30,5,0,0,96,20120106
2012,GSW,22,17,19,32,0,0,0,90,LAL,20,15,32,30,0,0,0,97,20120106
2012,CLE,28,24,24,22,0,0,0,98,MIN,24,21,19,23,0,0,0,87,20120106
2012,DEN,24,17,21,34,0,0,0,96,NOH,32,15,16,25,0,0,0,88,20120106
2012,HOU,20,21,24,29,0,0,0,94,OKC,30,28,28,23,0,0,0,109,20120106
2012,CHI,26,27,20,24,0,0,0,97,ORL,27,16,19,21,0,0,0,83,20120106
2012,DET,19,15,22,17,0,0,0,73,PHI,20,23,21,32,0,0,0,96,20120106
2012,POR,19,15,21,22,0,0,0,77,PHO,30,19,25,28,0,0,0,102,20120106
2012,NJN,22,26,27,22,0,0,0,97,TOR,21,19,24,21,0,0,0,85,20120106
2012,MEM,26,21,17,21,0,0,0,85,UTA,22,23,22,27,0,0,0,94,20120106
2012,NYK,18,28,26,27,0,0,0,99,WAS,32,15,22,27,0,0,0,96,20120106
2012,CHI,18,27,17,32,0,0,0,94,ATL,33,30,22,24,0,0,0,109,20120107
2012,NOH,20,21,24,16,0,0,0,81,DAL,26,26,23,21,0,0,0,96,20120107
2012,NYK,25,39,22,17,0,0,0,103,DET,24,18,15,23,0,0,0,80,20120107
2012,UTA,27,18,18,25,0,0,0,88,GSW,19,27,20,21,0,0,0,87,20120107
2012,OKC,23,25,24,26,0,0,0,98,HOU,21,25,26,23,0,0,0,95,20120107
2012,CHA,30,19,14,14,0,0,0,77,IND,22,21,28,28,0,0,0,99,20120107
2012,MIL,15,25,25,21,0,0,0,86,LAC,18,20,34,20,0,0,0,92,20120107
2012,MIA,31,26,21,23,0,0,0,101,NJN,18,17,29,26,0,0,0,90,20120107
2012,TOR,16,18,15,13,0,0,0,62,PHI,19,22,32,24,0,0,0,97,20120107
2012,DEN,25,30,30,32,0,0,0,117,SAS,37,25,32,27,0,0,0,121,20120107
2012,MEM,22,24,22,14,0,0,0,82,LAL,31,25,22,12,0,0,0,90,20120108
2012,SAS,22,26,21,27,0,0,0,96,OKC,24,30,37,17,0,0,0,108,20120108
2012,MIL,25,22,19,27,0,0,0,93,PHO,30,27,34,18,0,0,0,109,20120108
2012,CLE,17,18,22,21,0,0,0,78,POR,18,24,27,29,0,0,0,98,20120108
2012,ORL,19,30,32,23,0,0,0,104,SAC,21,26,32,18,0,0,0,97,20120108
2012,MIN,20,28,27,18,0,0,0,93,WAS,17,17,26,12,0,0,0,72,20120108
2012,DET,21,13,25,9,0,0,0,68,CHI,21,22,25,24,0,0,0,92,20120109
2012,NOH,26,28,24,16,0,0,0,94,DEN,27,19,18,17,0,0,0,81,20120109
2012,ATL,31,25,24,26,0,0,0,106,NJN,18,27,26,30,0,0,0,101,20120109
2012,CHA,21,24,20,22,0,0,0,87,NYK,24,26,22,19,0,0,0,91,20120109
2012,IND,20,20,24,22,0,0,0,86,PHI,25,20,28,23,0,0,0,96,20120109
2012,MIN,25,24,20,18,0,0,0,87,TOR,27,28,18,24,0,0,0,97,20120109
2012,HOU,20,23,24,15,0,0,0,82,CHA,23,16,14,17,0,0,0,70,20120110
2012,DAL,30,22,24,24,0,0,0,100,DET,20,18,17,31,0,0,0,86,20120110
2012,MIA,22,35,27,12,10,0,0,106,GSW,27,26,19,24,15,0,0,111,20120110
2012,PHO,19,23,26,15,0,0,0,83,LAL,25,21,27,26,0,0,0,99,20120110
2012,OKC,26,28,21,25,0,0,0,100,MEM,25,27,19,24,0,0,0,95,20120110
2012,SAS,33,26,22,22,0,0,0,103,MIL,25,34,20,27,0,0,0,106,20120110
2012,CHI,33,20,26,32,0,0,0,111,MIN,17,30,27,26,0,0,0,100,20120110
2012,SAC,22,20,18,25,0,0,0,85,PHI,26,26,32,28,0,0,0,112,20120110
2012,LAC,26,21,24,26,0,0,0,97,POR,24,30,24,27,0,0,0,105,20120110
2012,CLE,26,17,37,25,0,0,0,105,UTA,27,25,33,28,0,0,0,113,20120110
2012,TOR,20,14,18,26,0,0,0,78,WAS,17,29,25,22,0,0,0,93,20120110
2012,DAL,23,19,26,22,0,0,0,90,BOS,15,26,18,26,0,0,0,85,20120111
2012,WAS,15,22,16,11,0,0,0,64,CHI,17,28,12,21,0,0,0,78,20120111
2012,NJN,28,24,28,35,0,0,0,115,DEN,35,33,32,23,0,0,0,123,20120111
2012,ATL,20,30,9,25,0,0,0,84,IND,28,25,27,16,0,0,0,96,20120111
2012,MIA,24,24,21,17,3,0,0,89,LAC,21,22,27,16,9,0,0,95,20120111
2012,OKC,22,27,24,22,0,0,0,95,NOH,27,21,22,15,0,0,0,85,20120111
2012,PHI,15,20,21,23,0,0,0,79,NYK,28,17,22,18,0,0,0,85,20120111
2012,ORL,36,26,23,22,0,0,0,107,POR,22,28,18,36,0,0,0,104,20120111
2012,HOU,27,23,18,22,5,0,0,95,SAS,23,24,25,18,11,0,0,101,20120111
2012,SAC,23,18,22,35,0,0,0,98,TOR,19,21,23,28,0,0,0,91,20120111
2012,LAL,26,15,25,12,12,0,0,90,UTA,23,19,19,17,9,0,0,87,20120111
2012,CHA,21,26,19,15,0,0,0,81,ATL,25,32,28,26,0,0,0,111,20120112
2012,ORL,22,31,27,37,0,0,0,117,GSW,29,28,25,27,0,0,0,109,20120112
2012,NYK,19,19,14,31,0,0,0,83,MEM,28,21,26,19,0,0,0,94,20120112
2012,DET,27,16,25,25,0,0,0,93,MIL,31,21,27,23,0,0,0,102,20120112
2012,CLE,30,26,23,22,0,0,0,101,PHO,30,18,23,19,0,0,0,90,20120112
2012,CHI,26,26,15,21,0,0,0,88,BOS,13,20,26,20,0,0,0,79,20120113
2012,DET,27,24,27,20,0,0,0,98,CHA,23,16,20,22,0,0,0,81,20120113
2012,MIL,23,22,18,13,0,0,0,76,DAL,32,28,23,19,0,0,0,102,20120113
2012,MIA,21,32,28,23,0,0,0,104,DEN,30,25,31,31,0,0,0,117,20120113
2012,SAC,28,24,20,17,0,0,0,89,HOU,26,24,31,22,0,0,0,103,20120113
2012,CLE,28,13,29,22,0,0,0,92,LAL,32,27,23,15,0,0,0,97,20120113
2012,MIN,16,21,26,24,0,0,0,87,NOH,21,17,13,29,0,0,0,80,20120113
2012,WAS,23,17,18,31,0,0,0,89,PHI,33,21,38,28,0,0,0,120,20120113
2012,NJN,22,32,34,22,0,0,0,110,PHO,25,26,31,21,0,0,0,103,20120113
2012,POR,31,16,18,18,0,0,0,83,SAS,27,23,15,34,0,0,0,99,20120113
2012,IND,15,25,25,30,0,0,0,95,TOR,27,18,20,25,0,0,0,90,20120113
2012,MIN,24,29,18,20,0,0,0,91,ATL,18,24,21,30,0,0,0,93,20120114
2012,GSW,25,21,27,27,0,0,0,100,CHA,38,28,27,19,0,0,0,112,20120114
2012,TOR,14,23,15,12,0,0,0,64,CHI,23,14,19,21,0,0,0,77,20120114
2012,SAC,11,12,22,15,0,0,0,60,DAL,27,25,20,27,0,0,0,99,20120114
2012,POR,21,32,23,21,8,0,0,105,HOU,27,31,26,13,10,0,0,107,20120114
2012,BOS,24,24,19,16,0,0,0,83,IND,29,27,26,15,0,0,0,97,20120114
2012,LAL,24,18,30,22,0,0,0,94,LAC,31,24,21,26,0,0,0,102,20120114
2012,NOH,24,23,28,24,0,0,0,99,MEM,20,37,29,22,0,0,0,108,20120114
2012,NYK,22,25,18,27,0,0,0,92,OKC,32,38,22,12,0,0,0,104,20120114
2012,NJN,20,20,27,27,0,0,0,94,UTA,30,27,30,20,0,0,0,107,20120114
2012,PHI,23,29,25,26,0,0,0,103,WAS,26,14,20,30,0,0,0,90,20120114
2012,UTA,25,23,29,29,0,0,0,106,DEN,26,22,25,23,0,0,0,96,20120115
2012,GSW,24,20,30,25,0,0,0,99,DET,19,29,21,22,0,0,0,91,20120115
2012,PHO,26,16,26,23,0,0,0,91,SAS,30,26,22,24,0,0,0,102,20120115
2012,TOR,18,27,26,13,0,0,0,84,ATL,26,24,23,20,0,0,0,93,20120116
2012,OKC,25,21,26,25,0,0,0,97,BOS,17,22,23,26,0,0,0,88,20120116
2012,CLE,30,16,33,23,0,0,0,102,CHA,23,34,20,17,0,0,0,94,20120116
2012,NJN,17,23,23,28,0,0,0,91,LAC,32,21,21,27,0,0,0,101,20120116
2012,DAL,18,17,16,19,0,0,0,70,LAL,15,24,7,27,0,0,0,73,20120116
2012,CHI,21,17,28,20,0,0,0,86,MEM,28,30,19,25,0,0,0,102,20120116
2012,SAC,22,24,16,24,0,0,0,86,MIN,28,14,25,32,0,0,0,99,20120116
2012,POR,20,17,27,20,0,0,0,84,NOH,15,20,16,26,0,0,0,77,20120116
2012,ORL,17,28,28,29,0,0,0,102,NYK,23,28,24,18,0,0,0,93,20120116
2012,MIL,25,18,19,20,0,0,0,82,PHI,31,16,29,18,0,0,0,94,20120116
2012,HOU,27,31,33,23,0,0,0,114,WAS,28,26,21,31,0,0,0,106,20120116
2012,PHO,31,16,21,29,0,0,0,97,CHI,39,28,29,22,0,0,0,118,20120117
2012,GSW,26,29,26,24,0,0,0,105,CLE,26,24,29,16,0,0,0,95,20120117
2012,DET,20,20,19,21,0,0,0,80,HOU,28,19,22,28,0,0,0,97,20120117
2012,SAS,35,28,12,23,0,0,0,98,MIA,26,23,39,32,0,0,0,120,20120117
2012,DEN,26,37,22,20,0,0,0,105,MIL,21,23,23,28,0,0,0,95,20120117
2012,CHA,24,26,17,22,0,0,0,89,ORL,17,30,20,29,0,0,0,96,20120117
2012,LAC,17,24,18,20,0,0,0,79,UTA,29,23,26,30,0,0,0,108,20120117
2012,POR,17,25,20,27,0,0,0,89,ATL,21,30,24,17,0,0,0,92,20120118
2012,TOR,14,24,17,18,0,0,0,73,BOS,29,15,29,23,0,0,0,96,20120118
2012,DAL,27,24,20,18,0,0,0,89,LAC,31,21,19,20,0,0,0,91,20120118
2012,DET,20,22,29,14,0,0,0,85,MIN,17,19,28,29,0,0,0,93,20120118
2012,GSW,31,25,27,17,0,0,0,100,NJN,29,26,25,27,0,0,0,107,20120118
2012,MEM,33,22,17,21,0,0,0,93,NOH,22,26,19,20,0,0,0,87,20120118
2012,PHO,20,25,19,27,0,0,0,91,NYK,19,23,19,27,0,0,0,88,20120118
2012,SAS,13,24,20,18,10,0,0,85,ORL,19,21,18,17,8,0,0,83,20120118
2012,DEN,19,32,27,18,12,0,0,108,PHI,28,17,27,24,8,0,0,104,20120118
2012,IND,23,27,30,8,0,0,0,88,SAC,19,26,21,26,0,0,0,92,20120118
2012,OKC,22,29,25,26,0,0,0,102,WAS,18,28,26,33,0,0,0,105,20120118
2012,NOH,27,22,14,19,6,0,0,88,HOU,32,26,17,7,8,0,0,90,20120119
2012,LAL,20,17,19,31,0,0,0,87,MIA,25,27,25,21,0,0,0,98,20120119
2012,DAL,25,34,12,23,0,0,0,94,UTA,22,28,21,20,0,0,0,91,20120119
2012,PHO,20,26,14,19,0,0,0,79,BOS,15,20,20,16,0,0,0,71,20120120
2012,CHI,34,29,22,29,0,0,0,114,CLE,26,18,17,14,0,0,0,75,20120120
2012,MEM,22,27,24,25,0,0,0,98,DET,12,18,35,16,0,0,0,81,20120120
2012,IND,27,16,24,27,0,0,0,94,GSW,23,20,26,22,0,0,0,91,20120120
2012,MIN,22,26,24,29,0,0,0,101,LAC,31,28,20,19,0,0,0,98,20120120
2012,MIL,27,28,24,21,0,0,0,100,NYK,23,28,16,19,0,0,0,86,20120120
2012,LAL,10,21,21,28,0,0,0,80,ORL,22,26,19,25,0,0,0,92,20120120
2012,ATL,24,23,10,19,0,0,0,76,PHI,18,21,25,26,0,0,0,90,20120120
2012,SAC,32,18,23,15,0,0,0,88,SAS,20,27,20,19,0,0,0,86,20120120
2012,POR,27,20,24,23,0,0,0,94,TOR,14,18,28,24,0,0,0,84,20120120
2012,DEN,27,34,25,22,0,0,0,108,WAS,37,26,18,23,0,0,0,104,20120120
2012,CLE,19,23,21,31,0,0,0,94,ATL,27,34,28,32,0,0,0,121,20120121
2012,CHA,23,20,26,20,0,0,0,89,CHI,27,23,30,15,0,0,0,95,20120121
2012,POR,27,16,25,23,0,0,0,91,DET,26,28,19,21,0,0,0,94,20120121
2012,SAS,23,26,26,27,0,0,0,102,HOU,28,27,22,28,0,0,0,105,20120121
2012,SAC,21,39,16,19,0,0,0,95,MEM,34,34,34,26,0,0,0,128,20120121
2012,PHI,28,21,20,23,0,0,0,92,MIA,29,27,25,32,0,0,0,113,20120121
2012,OKC,28,20,15,21,0,0,0,84,NJN,18,17,16,23,0,0,0,74,20120121
2012,DAL,27,14,23,19,0,0,0,83,NOH,23,18,12,28,0,0,0,81,20120121
2012,DEN,25,21,26,26,7,14,0,119,NYK,24,30,18,26,7,9,0,114,20120121
2012,MIN,26,26,29,17,0,0,0,98,UTA,22,32,30,24,0,0,0,108,20120121
2012,TOR,11,26,21,33,0,0,0,91,LAC,27,22,27,27,0,0,0,103,20120122
2012,IND,14,35,28,21,0,0,0,98,LAL,27,25,26,18,0,0,0,96,20120122
2012,MIL,18,28,19,26,0,0,0,91,MIA,21,20,22,19,0,0,0,82,20120122
2012,CHA,21,21,19,26,0,0,0,87,NJN,28,30,17,22,0,0,0,97,20120122
2012,BOS,20,29,24,27,0,0,0,100,WAS,21,19,29,25,0,0,0,94,20120122
2012,ORL,20,16,10,10,0,0,0,56,BOS,22,24,23,18,0,0,0,87,20120123
2012,NJN,18,25,25,27,0,0,0,95,CHI,28,31,26,25,0,0,0,110,20120123
2012,PHO,27,19,19,22,0,0,0,87,DAL,32,17,25,19,0,0,0,93,20120123
2012,MEM,13,22,17,39,0,0,0,91,GSW,21,23,24,22,0,0,0,90,20120123
2012,ATL,28,20,22,27,0,0,0,97,MIL,23,25,16,28,0,0,0,92,20120123
2012,HOU,28,26,22,31,0,0,0,107,MIN,19,28,24,21,0,0,0,92,20120123
2012,SAS,30,26,23,25,0,0,0,104,NOH,28,27,25,22,0,0,0,102,20120123
2012,DET,12,21,25,21,0,0,0,79,OKC,29,31,25,14,0,0,0,99,20120123
2012,WAS,14,18,26,25,0,0,0,83,PHI,33,29,23,18,0,0,0,103,20120123
2012,SAC,21,17,18,33,0,0,0,89,POR,21,32,21,27,0,0,0,101,20120123
2012,NYK,26,26,21,38,0,0,0,111,CHA,23,19,15,21,0,0,0,78,20120124
2012,ORL,22,23,29,28,0,0,0,102,IND,29,16,17,21,0,0,0,83,20120124
2012,CLE,18,19,21,27,0,0,0,85,MIA,17,20,24,31,0,0,0,92,20120124
2012,TOR,17,31,31,20,0,0,0,99,PHO,27,25,19,25,0,0,0,96,20120124
2012,MEM,25,18,13,28,0,0,0,84,POR,25,22,23,27,0,0,0,97,20120124
2012,IND,24,20,31,20,0,0,0,95,CHI,23,31,20,16,0,0,0,90,20120125
2012,NYK,23,22,19,17,0,0,0,81,CLE,27,18,24,22,0,0,0,91,20120125
2012,MIN,26,26,26,27,0,0,0,105,DAL,27,27,18,18,0,0,0,90,20120125
2012,MIA,24,32,24,21,0,0,0,101,DET,17,33,24,24,0,0,0,98,20120125
2012,POR,26,27,20,20,0,0,0,93,GSW,24,24,31,22,0,0,0,101,20120125
2012,MIL,29,13,30,33,0,0,0,105,HOU,23,28,19,29,0,0,0,99,20120125
2012,LAC,27,24,20,20,0,0,0,91,LAL,25,24,19,28,0,0,0,96,20120125
2012,NOH,22,29,20,20,0,0,0,91,OKC,30,30,18,23,0,0,0,101,20120125
2012,NJN,22,21,23,16,15,0,0,97,PHI,18,27,16,21,8,0,0,90,20120125
2012,DEN,32,34,28,28,0,0,0,122,SAC,26,17,22,28,0,0,0,93,20120125
2012,ATL,18,26,17,22,0,0,0,83,SAS,24,24,28,29,0,0,0,105,20120125
2012,TOR,23,27,19,21,10,11,0,111,UTA,32,18,25,15,10,6,0,106,20120125
2012,CHA,17,11,21,26,0,0,0,75,WAS,31,17,23,21,0,0,0,92,20120125
2012,MEM,17,27,28,19,0,0,0,91,LAC,29,16,29,24,0,0,0,98,20120126
2012,BOS,16,21,27,27,0,0,0,91,ORL,32,26,17,8,0,0,0,83,20120126
2012,IND,17,17,27,26,0,0,0,87,BOS,23,19,29,23,0,0,0,94,20120127
2012,MIL,27,23,18,32,0,0,0,100,CHI,30,21,28,28,0,0,0,107,20120127
2012,NJN,30,17,25,27,0,0,0,99,CLE,20,17,24,35,0,0,0,96,20120127
2012,UTA,30,20,32,19,0,0,0,101,DAL,30,28,30,28,0,0,0,116,20120127
2012,TOR,12,20,32,17,0,0,0,81,DEN,28,26,24,18,0,0,0,96,20120127
2012,ATL,15,20,28,24,20,0,0,107,DET,17,29,22,19,14,0,0,101,20120127
2012,OKC,28,29,28,35,0,0,0,120,GSW,23,29,25,32,0,0,0,109,20120127
2012,WAS,21,20,21,14,0,0,0,76,HOU,17,27,34,25,0,0,0,103,20120127
2012,NYK,22,26,23,18,0,0,0,89,MIA,22,30,22,25,0,0,0,99,20120127
2012,SAS,22,20,22,15,0,0,0,79,MIN,21,20,23,23,0,0,0,87,20120127
2012,ORL,19,15,18,15,0,0,0,67,NOH,23,24,22,24,0,0,0,93,20120127
2012,CHA,10,27,14,21,0,0,0,72,PHI,23,36,18,12,0,0,0,89,20120127
2012,PHO,24,9,12,26,0,0,0,71,POR,21,26,31,31,0,0,0,109,20120127
2012,WAS,26,32,25,19,0,0,0,102,CHA,26,22,30,21,0,0,0,99,20120128
2012,NYK,21,25,14,24,0,0,0,84,HOU,20,33,22,22,0,0,0,97,20120128
2012,LAL,23,20,30,16,0,0,0,89,MIL,27,24,29,20,0,0,0,100,20120128
2012,DET,14,17,22,21,0,0,0,74,PHI,24,18,27,26,0,0,0,95,20120128
2012,MEM,16,16,24,28,0,0,0,84,PHO,24,24,15,23,0,0,0,86,20120128
2012,SAC,26,21,20,26,0,0,0,93,UTA,27,22,29,18,0,0,0,96,20120128
2012,CLE,23,21,18,26,0,0,0,88,BOS,24,19,27,17,0,0,0,87,20120129
2012,SAS,18,22,18,33,9,0,0,100,DAL,24,27,18,22,10,0,0,101,20120129
2012,LAC,23,25,29,32,0,0,0,109,DEN,26,27,30,22,0,0,0,105,20120129
2012,CHI,22,29,20,22,0,0,0,93,MIA,24,32,20,21,0,0,0,97,20120129
2012,LAL,22,31,26,27,0,0,0,106,MIN,19,26,29,27,0,0,0,101,20120129
2012,TOR,24,20,26,24,0,0,0,94,NJN,24,15,14,20,0,0,0,73,20120129
2012,ATL,27,19,30,18,0,0,0,94,NOH,11,24,17,20,0,0,0,72,20120129
2012,IND,29,19,32,26,0,0,0,106,ORL,22,29,17,17,0,0,0,85,20120129
2012,MIN,26,28,42,24,0,0,0,120,HOU,24,32,25,27,0,0,0,108,20120130
2012,OKC,25,21,24,30,0,0,0,100,LAC,36,28,26,22,0,0,0,112,20120130
2012,SAS,24,21,25,13,0,0,0,83,MEM,19,16,15,23,0,0,0,73,20120130
2012,NOH,29,20,19,27,0,0,0,95,MIA,27,24,36,22,0,0,0,109,20120130
2012,DET,16,25,19,22,0,0,0,82,MIL,30,17,28,28,0,0,0,103,20120130
2012,ORL,18,15,9,27,0,0,0,69,PHI,19,18,21,16,0,0,0,74,20120130
2012,DAL,31,35,30,26,0,0,0,122,PHO,24,24,22,29,0,0,0,99,20120130
2012,POR,26,19,25,19,0,0,0,89,UTA,20,19,30,24,0,0,0,93,20120130
2012,CHI,26,25,25,22,0,0,0,98,WAS,16,24,19,29,0,0,0,88,20120130
2012,BOS,28,23,25,17,0,0,0,93,CLE,24,15,19,32,0,0,0,90,20120131
2012,SAC,23,24,21,22,0,0,0,90,GSW,24,21,22,26,0,0,0,93,20120131
2012,NJN,24,29,19,27,0,0,0,99,IND,28,27,29,22,0,0,0,106,20120131
2012,CHA,18,18,22,15,0,0,0,73,LAL,30,30,13,33,0,0,0,106,20120131
2012,DEN,23,26,18,24,6,0,0,97,MEM,19,18,23,31,9,0,0,100,20120131
2012,DET,24,21,12,29,0,0,0,86,NYK,33,24,24,32,0,0,0,113,20120131
2012,ATL,23,33,21,23,0,0,0,100,TOR,18,19,23,17,0,0,0,77,20120131
2012,TOR,16,19,14,15,0,0,0,64,BOS,29,28,20,23,0,0,0,100,20120201
2012,OKC,21,28,22,24,0,0,0,95,DAL,29,23,14,20,0,0,0,86,20120201
2012,MIA,40,20,19,18,0,0,0,97,MIL,23,24,29,29,0,0,0,105,20120201
2012,IND,20,25,31,33,0,0,0,109,MIN,25,16,29,29,0,0,0,99,20120201
2012,DET,23,15,33,25,0,0,0,96,NJN,23,26,23,27,0,0,0,99,20120201
2012,PHO,25,31,32,32,0,0,0,120,NOH,27,32,28,16,0,0,0,103,20120201
2012,WAS,20,23,25,35,0,0,0,103,ORL,25,22,22,40,0,0,0,109,20120201
2012,CHI,21,23,11,27,0,0,0,82,PHI,27,22,26,23,0,0,0,98,20120201
2012,CHA,18,17,13,20,0,0,0,68,POR,35,26,31,20,0,0,0,112,20120201
2012,HOU,27,25,19,20,0,0,0,91,SAS,16,23,28,32,0,0,0,99,20120201
2012,LAC,32,24,16,35,0,0,0,107,UTA,29,29,16,31,0,0,0,105,20120201
2012,MEM,21,32,26,17,0,0,0,96,ATL,19,24,12,22,0,0,0,77,20120202
2012,UTA,22,24,31,24,0,0,0,101,GSW,25,23,40,31,0,0,0,119,20120202
2012,DEN,19,35,32,26,0,0,0,112,LAC,32,19,16,24,0,0,0,91,20120202
2012,CHI,29,26,22,28,0,0,0,105,NYK,25,19,31,27,0,0,0,102,20120202
2012,POR,30,26,13,23,0,0,0,92,SAC,27,20,24,24,0,0,0,95,20120202
2012,NOH,22,23,23,13,0,0,0,81,SAS,23,21,27,22,0,0,0,93,20120202
2012,NYK,28,27,17,17,0,0,0,89,BOS,27,22,20,22,0,0,0,91,20120203
2012,IND,29,23,24,22,0,0,0,98,DAL,28,25,16,18,0,0,0,87,20120203
2012,LAL,23,21,28,21,0,0,0,93,DEN,21,20,27,21,0,0,0,89,20120203
2012,MIL,26,15,20,19,0,0,0,80,DET,26,25,21,16,0,0,0,88,20120203
2012,PHO,20,19,22,20,0,0,0,81,HOU,30,29,21,19,0,0,0,99,20120203
2012,MIN,23,26,31,28,0,0,0,108,NJN,19,31,25,30,0,0,0,105,20120203
2012,MEM,30,20,27,17,0,0,0,94,OKC,25,19,25,32,0,0,0,101,20120203
2012,CLE,17,20,16,41,0,0,0,94,ORL,18,30,24,30,0,0,0,102,20120203
2012,MIA,25,26,16,32,0,0,0,99,PHI,24,23,16,16,0,0,0,79,20120203
2012,WAS,22,23,24,20,0,0,0,89,TOR,22,33,25,26,0,0,0,106,20120203
2012,PHI,20,37,24,17,0,0,0,98,ATL,21,20,21,25,0,0,0,87,20120204
2012,DAL,24,27,13,24,0,0,0,88,CLE,15,28,27,21,0,0,0,91,20120204
2012,NOH,23,21,17,26,0,0,0,87,DET,25,16,24,24,0,0,0,89,20120204
2012,ORL,23,16,23,23,0,0,0,85,IND,21,18,14,28,0,0,0,81,20120204
2012,CHI,30,37,20,26,0,0,0,113,MIL,16,27,21,26,0,0,0,90,20120204
2012,HOU,25,17,30,19,0,0,0,91,MIN,33,22,26,19,0,0,0,100,20120204
2012,NJN,30,18,24,20,0,0,0,92,NYK,20,26,24,29,0,0,0,99,20120204
2012,CHA,24,24,24,17,0,0,0,89,PHO,25,17,30,23,0,0,0,95,20120204
2012,DEN,26,27,18,26,0,0,0,97,POR,33,26,26,32,0,0,0,117,20120204
2012,GSW,28,26,22,26,4,0,0,106,SAC,27,26,34,15,12,0,0,114,20120204
2012,OKC,21,26,23,26,0,0,0,96,SAS,25,32,31,19,0,0,0,107,20120204
2012,LAL,25,24,18,20,0,0,0,87,UTA,22,25,20,29,0,0,0,96,20120204
2012,LAC,28,30,29,20,0,0,0,107,WAS,17,17,19,28,0,0,0,81,20120204
2012,MEM,16,19,26,19,0,0,0,80,BOS,24,19,26,29,0,0,0,98,20120205
2012,TOR,27,21,14,27,0,0,0,89,MIA,31,22,22,20,0,0,0,95,20120205
2012,PHO,27,28,29,15,0,0,0,99,ATL,23,25,16,26,0,0,0,90,20120206
2012,HOU,26,21,26,26,0,0,0,99,DEN,28,17,26,19,0,0,0,90,20120206
2012,SAS,26,26,15,22,0,0,0,89,MEM,18,28,27,11,0,0,0,84,20120206
2012,CHI,35,27,21,25,0,0,0,108,NJN,14,23,27,23,0,0,0,87,20120206
2012,SAC,20,19,30,31,0,0,0,100,NOH,29,23,26,14,0,0,0,92,20120206
2012,UTA,16,22,35,15,0,0,0,88,NYK,19,32,24,24,0,0,0,99,20120206
2012,LAC,21,21,23,29,13,0,0,107,ORL,30,17,15,32,8,0,0,102,20120206
2012,LAL,24,26,19,21,0,0,0,90,PHI,21,25,24,25,0,0,0,95,20120206
2012,OKC,29,31,25,18,8,0,0,111,POR,31,21,27,24,4,0,0,107,20120206
2012,TOR,19,23,30,33,3,0,0,108,WAS,29,28,25,23,6,0,0,111,20120206
2012,CHA,22,16,24,22,0,0,0,84,BOS,27,18,24,25,0,0,0,94,20120207
2012,OKC,29,30,32,28,0,0,0,119,GSW,35,22,36,23,0,0,0,116,20120207
2012,UTA,23,23,31,22,0,0,0,99,IND,27,30,27,20,0,0,0,104,20120207
2012,CLE,25,23,24,19,0,0,0,91,MIA,28,26,24,29,0,0,0,107,20120207
2012,PHO,34,33,21,19,0,0,0,107,MIL,30,20,31,24,0,0,0,105,20120207
2012,SAC,16,20,24,24,0,0,0,84,MIN,31,17,21,17,0,0,0,86,20120207
2012,IND,21,20,31,15,0,0,0,87,ATL,32,27,21,17,0,0,0,97,20120208
2012,LAC,24,16,24,28,0,0,0,92,CLE,19,21,30,29,0,0,0,99,20120208
2012,DAL,33,31,23,18,0,0,0,105,DEN,25,28,25,17,0,0,0,95,20120208
2012,MIN,21,13,20,26,0,0,0,80,MEM,26,18,22,19,0,0,0,85,20120208
2012,DET,20,31,23,25,0,0,0,99,NJN,20,19,28,25,0,0,0,92,20120208
2012,CHI,23,21,26,20,0,0,0,90,NOH,14,17,15,21,0,0,0,67,20120208
2012,MIA,18,32,11,28,0,0,0,89,ORL,26,27,24,25,0,0,0,102,20120208
2012,SAS,26,22,27,25,0,0,0,100,PHI,24,21,22,23,0,0,0,90,20120208
2012,HOU,30,30,17,26,0,0,0,103,POR,28,18,24,26,0,0,0,96,20120208
2012,MIL,28,30,18,29,0,0,0,105,TOR,29,22,22,26,0,0,0,99,20120208
2012,NYK,17,35,25,30,0,0,0,107,WAS,23,23,22,25,0,0,0,93,20120208
2012,LAL,22,23,22,15,6,0,0,88,BOS,26,21,17,18,5,0,0,87,20120209
2012,GSW,27,20,37,25,0,0,0,109,DEN,28,23,20,30,0,0,0,101,20120209
2012,HOU,26,28,20,22,0,0,0,96,PHO,29,15,32,13,0,0,0,89,20120209
2012,OKC,19,36,23,23,0,0,0,101,SAC,23,34,19,30,0,0,0,106,20120209
2012,CHI,30,26,23,16,0,0,0,95,CHA,16,18,17,13,0,0,0,64,20120210
2012,MIL,28,25,24,25,11,0,0,113,CLE,25,32,28,17,10,0,0,112,20120210
2012,NJN,15,18,31,28,0,0,0,92,DET,24,28,35,22,0,0,0,109,20120210
2012,IND,22,25,26,19,0,0,0,92,MEM,22,25,26,25,0,0,0,98,20120210
2012,DAL,29,27,22,26,0,0,0,104,MIN,16,29,28,24,0,0,0,97,20120210
2012,POR,21,21,28,24,0,0,0,94,NOH,19,27,21,19,0,0,0,86,20120210
2012,LAL,15,26,19,25,0,0,0,85,NYK,22,27,17,26,0,0,0,92,20120210
2012,ATL,20,21,20,17,11,0,0,89,ORL,17,22,15,24,9,0,0,87,20120210
2012,LAC,18,23,19,18,0,0,0,78,PHI,27,16,18,16,0,0,0,77,20120210
2012,BOS,14,20,17,23,0,0,0,74,TOR,26,15,22,23,0,0,0,86,20120210
2012,OKC,27,22,25,27,0,0,0,101,UTA,30,14,21,22,0,0,0,87,20120210
2012,MIA,23,29,22,32,0,0,0,106,WAS,19,23,25,22,0,0,0,89,20120210
2012,LAC,24,31,29,27,0,0,0,111,CHA,16,21,15,34,0,0,0,86,20120211
2012,PHI,21,37,21,20,0,0,0,99,CLE,19,22,19,24,0,0,0,84,20120211
2012,POR,14,18,23,26,6,7,0,94,DAL,25,18,18,20,6,10,0,97,20120211
2012,DEN,26,34,27,26,0,0,0,113,IND,35,25,24,25,0,0,0,109,20120211
2012,ORL,16,27,29,27,0,0,0,99,MIL,21,28,24,21,0,0,0,94,20120211
2012,NYK,30,24,28,18,0,0,0,100,MIN,33,29,25,11,0,0,0,98,20120211
2012,SAS,24,31,22,26,0,0,0,103,NJN,22,18,19,30,0,0,0,89,20120211
2012,PHO,31,22,22,23,0,0,0,98,SAC,24,20,16,24,0,0,0,84,20120211
2012,MIA,30,33,25,19,0,0,0,107,ATL,18,23,20,26,0,0,0,87,20120212
2012,CHI,23,20,23,25,0,0,0,91,BOS,28,20,24,23,0,0,0,95,20120212
2012,WAS,26,19,29,24,0,0,0,98,DET,18,27,18,14,0,0,0,77,20120212
2012,HOU,29,15,30,23,0,0,0,97,GSW,23,25,28,30,0,0,0,106,20120212
2012,UTA,22,24,23,29,0,0,0,98,MEM,18,22,26,22,0,0,0,88,20120212
2012,LAL,34,20,19,21,0,0,0,94,TOR,19,27,21,25,0,0,0,92,20120212
2012,PHI,28,27,16,27,0,0,0,98,CHA,17,28,22,22,0,0,0,89,20120213
2012,LAC,19,28,29,16,0,0,0,92,DAL,27,28,19,22,0,0,0,96,20120213
2012,PHO,27,19,27,23,0,0,0,96,GSW,20,23,33,26,0,0,0,102,20120213
2012,MIA,27,28,35,24,0,0,0,114,MIL,30,20,24,22,0,0,0,96,20120213
2012,UTA,21,15,15,29,0,0,0,80,NOH,20,21,25,20,0,0,0,86,20120213
2012,MIN,26,18,22,23,0,0,0,89,ORL,29,26,24,23,0,0,0,102,20120213
2012,SAC,24,28,25,38,0,0,0,115,CHI,27,29,32,33,0,0,0,121,20120214
2012,PHO,21,30,19,22,0,0,0,92,DEN,33,25,28,23,0,0,0,109,20120214
2012,SAS,32,23,19,25,0,0,0,99,DET,22,24,16,33,0,0,0,95,20120214
2012,MIA,33,35,22,15,0,0,0,105,IND,16,23,19,32,0,0,0,90,20120214
2012,ATL,24,17,10,27,0,0,0,78,LAL,27,15,17,27,0,0,0,86,20120214
2012,HOU,17,26,21,19,0,0,0,83,MEM,21,31,20,21,0,0,0,93,20120214
2012,UTA,19,20,24,22,0,0,0,85,OKC,25,28,26,32,0,0,0,111,20120214
2012,WAS,28,30,33,33,0,0,0,124,POR,26,20,36,27,0,0,0,109,20120214
2012,NYK,21,15,30,24,0,0,0,90,TOR,28,19,28,12,0,0,0,87,20120214
2012,DET,26,21,26,25,0,0,0,98,BOS,28,21,23,16,0,0,0,88,20120215
2012,IND,20,18,23,26,0,0,0,87,CLE,32,24,23,19,0,0,0,98,20120215
2012,DEN,17,22,15,30,0,0,0,84,DAL,27,24,32,19,0,0,0,102,20120215
2012,POR,20,37,15,21,0,0,0,93,GSW,27,27,16,21,0,0,0,91,20120215
2012,OKC,13,31,29,22,0,0,0,95,HOU,29,16,30,21,0,0,0,96,20120215
2012,WAS,20,27,19,18,0,0,0,84,LAC,23,27,24,28,0,0,0,102,20120215
2012,NOH,27,23,22,20,0,0,0,92,MIL,28,17,20,24,0,0,0,89,20120215
2012,CHA,30,18,18,24,0,0,0,90,MIN,25,21,30,26,0,0,0,102,20120215
2012,MEM,23,30,24,28,0,0,0,105,NJN,28,27,23,22,0,0,0,100,20120215
2012,SAC,17,19,19,30,0,0,0,85,NYK,25,29,23,23,0,0,0,100,20120215
2012,PHI,16,23,31,17,0,0,0,87,ORL,29,26,24,24,0,0,0,103,20120215
2012,ATL,21,26,26,28,0,0,0,101,PHO,31,25,21,22,0,0,0,99,20120215
2012,SAS,25,30,28,30,0,0,0,113,TOR,17,28,33,28,0,0,0,106,20120215
2012,BOS,24,11,24,21,0,0,0,80,CHI,18,26,16,29,0,0,0,89,20120216
2012,NJN,29,21,15,23,0,0,0,88,IND,21,29,14,29,0,0,0,93,20120216
2012,LAC,20,12,20,22,0,0,0,74,POR,27,16,17,11,0,0,0,71,20120216
2012,MIA,35,28,27,21,0,0,0,111,CLE,14,24,29,20,0,0,0,87,20120217
2012,SAC,31,29,28,20,0,0,0,108,DET,24,32,30,28,0,0,0,114,20120217
2012,MIN,30,31,30,20,0,0,0,111,HOU,29,25,23,21,0,0,0,98,20120217
2012,PHO,25,23,25,26,0,0,0,99,LAL,21,36,30,24,0,0,0,111,20120217
2012,DEN,15,28,30,29,0,0,0,102,MEM,34,26,23,20,0,0,0,103,20120217
2012,NOH,27,16,25,21,0,0,0,89,NYK,13,26,19,27,0,0,0,85,20120217
2012,GSW,24,24,17,22,0,0,0,87,OKC,20,38,26,26,0,0,0,110,20120217
2012,MIL,27,19,28,11,0,0,0,85,ORL,15,29,28,22,0,0,0,94,20120217
2012,DAL,21,16,24,21,0,0,0,82,PHI,27,24,8,16,0,0,0,75,20120217
2012,CHA,22,25,21,30,0,0,0,98,TOR,23,22,24,22,0,0,0,91,20120217
2012,WAS,20,30,28,22,0,0,0,100,UTA,32,30,38,14,0,0,0,114,20120217
2012,NJN,34,25,14,24,0,0,0,97,CHI,19,26,11,29,0,0,0,85,20120218
2012,SAS,15,30,25,25,8,0,0,103,LAC,26,17,24,28,5,0,0,100,20120218
2012,GSW,19,37,22,25,0,0,0,103,MEM,34,20,22,28,0,0,0,104,20120218
2012,ATL,25,12,19,21,0,0,0,77,POR,33,19,20,25,0,0,0,97,20120218
2012,SAC,31,18,19,24,0,0,0,92,CLE,27,23,25,18,0,0,0,93,20120219
2012,BOS,26,16,19,20,0,0,0,81,DET,26,29,20,21,0,0,0,96,20120219
2012,UTA,22,24,18,21,0,0,0,85,HOU,23,22,27,29,0,0,0,101,20120219
2012,CHA,12,21,15,25,0,0,0,73,IND,24,29,35,20,0,0,0,108,20120219
2012,ORL,19,12,23,24,0,0,0,78,MIA,22,21,27,20,0,0,0,90,20120219
2012,PHI,24,25,25,17,0,0,0,91,MIN,22,22,28,20,0,0,0,92,20120219
2012,MIL,23,20,27,22,0,0,0,92,NJN,17,19,20,29,0,0,0,85,20120219
2012,DAL,20,25,30,22,0,0,0,97,NYK,32,16,24,32,0,0,0,104,20120219
2012,DEN,27,31,25,28,7,0,0,118,OKC,25,28,30,28,13,0,0,124,20120219
2012,LAL,19,21,27,23,0,0,0,90,PHO,35,28,19,20,0,0,0,102,20120219
2012,ATL,17,20,27,15,0,0,0,79,CHI,35,20,18,17,0,0,0,90,20120220
2012,BOS,15,19,19,20,0,0,0,73,DAL,20,24,26,19,0,0,0,89,20120220
2012,MIN,30,16,27,20,8,0,0,101,DEN,18,33,25,17,10,0,0,103,20120220
2012,LAC,23,33,18,23,0,0,0,97,GSW,29,27,21,27,0,0,0,104,20120220
2012,MEM,28,26,22,17,0,0,0,93,HOU,31,27,18,21,0,0,0,97,20120220
2012,POR,7,23,36,26,0,0,0,92,LAL,29,23,28,23,0,0,0,103,20120220
2012,ORL,27,22,18,26,0,0,0,93,MIL,29,19,22,20,0,0,0,90,20120220
2012,NJN,18,32,32,18,0,0,0,100,NYK,21,21,22,28,0,0,0,92,20120220
2012,NOH,18,20,31,24,0,0,0,93,OKC,31,29,24,17,0,0,0,101,20120220
2012,WAS,25,23,13,27,0,0,0,88,PHO,31,22,32,19,0,0,0,104,20120220
2012,SAS,26,30,24,26,0,0,0,106,UTA,30,23,27,22,0,0,0,102,20120220
2012,DET,29,26,22,23,0,0,0,100,CLE,30,14,22,35,0,0,0,101,20120221
2012,NOH,31,25,20,24,8,0,0,108,IND,24,29,27,20,17,0,0,117,20120221
2012,PHI,10,32,18,16,0,0,0,76,MEM,30,17,22,20,0,0,0,89,20120221
2012,SAC,32,21,35,20,0,0,0,108,MIA,26,31,36,27,0,0,0,120,20120221
2012,SAS,23,20,22,32,0,0,0,97,POR,41,25,37,34,0,0,0,137,20120221
2012,IND,23,27,28,24,0,0,0,102,CHA,28,14,26,20,0,0,0,88,20120222
2012,MIL,23,30,22,16,0,0,0,91,CHI,30,34,29,17,0,0,0,110,20120222
2012,NOH,29,21,19,20,0,0,0,89,CLE,20,23,16,25,0,0,0,84,20120222
2012,LAL,25,23,24,24,0,0,0,96,DAL,21,27,24,19,0,0,0,91,20120222
2012,PHI,16,25,24,22,0,0,0,87,HOU,19,26,16,32,0,0,0,93,20120222
2012,DEN,27,27,25,16,0,0,0,95,LAC,27,25,28,23,0,0,0,103,20120222
2012,UTA,27,22,28,21,0,0,0,98,MIN,15,22,27,36,0,0,0,100,20120222
2012,ORL,34,24,29,21,0,0,0,108,NJN,17,24,29,21,0,0,0,91,20120222
2012,ATL,16,19,21,26,0,0,0,82,NYK,30,30,18,21,0,0,0,99,20120222
2012,BOS,25,24,31,24,0,0,0,104,OKC,35,37,22,25,0,0,0,119,20120222
2012,GSW,39,20,24,23,0,0,0,106,PHO,22,23,34,25,0,0,0,104,20120222
2012,DET,24,21,15,33,0,0,0,93,TOR,28,25,21,29,0,0,0,103,20120222
2012,SAC,29,31,28,27,0,0,0,115,WAS,34,34,21,18,0,0,0,107,20120222
2012,ORL,20,10,25,23,0,0,0,78,ATL,29,18,11,25,0,0,0,83,20120223
2012,SAS,31,34,27,22,0,0,0,114,DEN,15,24,33,27,0,0,0,99,20120223
2012,NYK,20,27,19,22,0,0,0,88,MIA,24,27,29,22,0,0,0,102,20120223
2012,LAL,23,20,19,23,0,0,0,85,OKC,19,27,27,27,0,0,0,100,20120223
2012,NOH,26,24,20,25,0,0,0,95,CHI,30,17,29,23,0,0,0,99,20120228
2012,BOS,28,15,21,22,0,0,0,86,CLE,15,23,28,17,0,0,0,83,20120228
2012,NJN,28,28,23,14,0,0,0,93,DAL,23,22,31,16,0,0,0,92,20120228
2012,PHI,22,28,25,22,0,0,0,97,DET,20,14,19,15,0,0,0,68,20120228
2012,TOR,15,21,28,21,0,0,0,85,HOU,27,18,24,19,0,0,0,88,20120228
2012,GSW,21,17,16,24,0,0,0,78,IND,24,28,33,17,0,0,0,102,20120228
2012,MIN,22,29,22,36,0,0,0,109,LAC,31,23,22,21,0,0,0,97,20120228
2012,WAS,24,29,36,29,0,0,0,118,MIL,33,34,25,27,0,0,0,119,20120228
2012,UTA,25,22,24,25,0,0,0,96,SAC,23,21,30,29,0,0,0,103,20120228
2012,GSW,20,28,16,21,0,0,0,85,ATL,21,17,23,21,0,0,0,82,20120229
2012,MIL,25,29,13,29,0,0,0,96,BOS,25,25,27,25,0,0,0,102,20120229
2012,POR,22,23,26,24,0,0,0,95,DEN,29,33,23,19,0,0,0,104,20120229
2012,CHA,23,20,26,25,0,0,0,94,DET,24,34,25,26,0,0,0,109,20120229
2012,MIN,18,26,15,26,0,0,0,85,LAL,26,24,33,21,0,0,0,104,20120229
2012,DAL,17,32,18,18,0,0,0,85,MEM,25,22,27,22,0,0,0,96,20120229
2012,TOR,29,22,11,33,0,0,0,95,NOH,25,21,23,15,0,0,0,84,20120229
2012,CLE,31,30,19,23,0,0,0,103,NYK,24,25,33,38,0,0,0,120,20120229
2012,OKC,26,27,10,29,0,0,0,92,PHI,24,24,19,21,0,0,0,88,20120229
2012,CHI,20,30,15,31,0,0,0,96,SAS,22,20,24,23,0,0,0,89,20120229
2012,HOU,26,18,19,20,0,0,0,83,UTA,18,31,27,28,0,0,0,104,20120229
2012,ORL,27,19,25,31,0,0,0,102,WAS,18,23,29,25,0,0,0,95,20120229
2012,OKC,20,30,20,35,0,0,0,105,ORL,23,30,28,21,0,0,0,102,20120301
2012,MIN,23,28,23,21,0,0,0,95,PHO,22,24,31,27,0,0,0,104,20120301
2012,MIA,32,28,27,20,0,0,0,107,POR,24,18,27,24,0,0,0,93,20120301
2012,LAC,28,29,28,23,0,0,0,108,SAC,25,32,22,21,0,0,0,100,20120301
2012,MIL,25,26,25,18,0,0,0,94,ATL,27,12,26,34,0,0,0,99,20120302
2012,NJN,20,20,31,23,0,0,0,94,BOS,29,29,29,20,0,0,0,107,20120302
2012,CHI,30,26,38,18,0,0,0,112,CLE,28,16,27,20,0,0,0,91,20120302
2012,DEN,26,25,31,35,0,0,0,117,HOU,25,29,24,27,0,0,0,105,20120302
2012,SAC,26,32,16,33,0,0,0,107,LAL,31,34,27,23,0,0,0,115,20120302
2012,DAL,19,27,23,23,0,0,0,92,NOH,25,27,22,23,0,0,0,97,20120302
2012,GSW,23,24,18,18,0,0,0,83,PHI,25,25,25,30,0,0,0,105,20120302
2012,LAC,21,14,17,26,0,0,0,78,PHO,17,15,31,18,0,0,0,81,20120302
2012,CHA,20,21,18,13,0,0,0,72,SAS,29,22,23,28,0,0,0,102,20120302
2012,MEM,23,22,32,25,0,0,0,102,TOR,21,31,23,24,0,0,0,99,20120302
2012,MIA,26,18,27,27,0,0,0,98,UTA,27,30,21,21,0,0,0,99,20120302
2012,OKC,24,23,28,15,0,0,0,90,ATL,27,26,23,21,0,0,0,97,20120303
2012,UTA,20,16,19,41,0,0,0,96,DAL,24,19,31,28,0,0,0,102,20120303
2012,DET,28,19,23,13,0,0,0,83,MEM,28,18,23,31,0,0,0,100,20120303
2012,IND,25,29,25,23,0,0,0,102,NOH,23,14,17,30,0,0,0,84,20120303
2012,MIL,21,39,20,18,0,0,0,98,ORL,36,25,24,29,0,0,0,114,20120303
2012,MIN,40,21,23,38,0,0,0,122,POR,28,32,22,28,0,0,0,110,20120303
2012,CLE,33,22,23,20,0,0,0,98,WAS,24,26,28,23,0,0,0,101,20120303
2012,NYK,29,27,16,31,8,0,0,111,BOS,27,24,29,23,12,0,0,115,20120304
2012,NJN,22,23,28,31,0,0,0,104,CHA,25,28,19,29,0,0,0,101,20120304
2012,LAC,25,20,32,20,8,0,0,105,HOU,30,17,27,23,6,0,0,103,20120304
2012,MIA,20,18,24,21,0,0,0,83,LAL,28,22,21,22,0,0,0,93,20120304
2012,CHI,26,14,24,32,0,0,0,96,PHI,24,22,18,27,0,0,0,91,20120304
2012,SAC,32,20,19,17,0,0,0,88,PHO,29,18,23,26,0,0,0,96,20120304
2012,DEN,25,24,26,24,0,0,0,99,SAS,17,28,26,23,0,0,0,94,20120304
2012,GSW,20,27,11,17,0,0,0,75,TOR,18,20,22,23,0,0,0,83,20120304
2012,IND,20,23,13,16,0,0,0,72,CHI,22,20,33,17,0,0,0,92,20120305
2012,UTA,28,28,29,24,0,0,0,109,CLE,26,15,31,28,0,0,0,100,20120305
2012,SAC,26,27,26,29,8,0,0,116,DEN,24,29,32,23,11,0,0,119,20120305
2012,PHI,33,22,16,22,0,0,0,93,MIL,28,23,23,23,0,0,0,97,20120305
2012,LAC,16,28,21,29,0,0,0,94,MIN,26,19,30,20,0,0,0,95,20120305
2012,DAL,23,29,13,26,0,0,0,91,OKC,26,19,23,27,0,0,0,95,20120305
2012,NOH,17,21,10,26,0,0,0,74,POR,27,19,24,16,0,0,0,86,20120305
2012,ORL,23,20,25,24,0,0,0,92,TOR,20,18,25,25,0,0,0,88,20120305
2012,GSW,41,24,24,31,0,0,0,120,WAS,24,27,20,29,0,0,0,100,20120305
2012,HOU,28,12,28,16,8,0,0,92,BOS,21,25,17,21,13,0,0,97,20120306
2012,ORL,25,23,23,13,0,0,0,84,CHA,15,28,29,28,0,0,0,100,20120306
2012,NYK,15,29,19,22,0,0,0,85,DAL,27,23,27,18,0,0,0,95,20120306
2012,LAL,24,17,20,17,7,0,0,85,DET,17,28,9,24,10,0,0,88,20120306
2012,ATL,29,29,18,25,0,0,0,101,IND,22,32,17,25,0,0,0,96,20120306
2012,NJN,17,20,19,22,0,0,0,78,MIA,30,34,24,20,0,0,0,108,20120306
2012,UTA,22,29,29,19,0,0,0,99,CHA,21,26,17,29,0,0,0,93,20120307
2012,CLE,26,31,19,24,0,0,0,100,DEN,27,28,17,27,0,0,0,99,20120307
2012,MEM,33,23,28,26,0,0,0,110,GSW,23,28,22,19,0,0,0,92,20120307
2012,ATL,22,23,23,18,0,0,0,86,MIA,25,18,25,21,0,0,0,89,20120307
2012,CHI,33,22,18,33,0,0,0,106,MIL,30,20,23,31,0,0,0,104,20120307
2012,POR,31,23,18,22,0,0,0,94,MIN,37,24,20,25,0,0,0,106,20120307
2012,LAC,22,23,26,29,0,0,0,100,NJN,27,30,23,21,0,0,0,101,20120307
2012,PHO,34,30,24,16,0,0,0,104,OKC,25,33,26,31,0,0,0,115,20120307
2012,BOS,17,16,20,18,0,0,0,71,PHI,33,22,25,23,0,0,0,103,20120307
2012,NOH,27,27,26,18,0,0,0,98,SAC,29,29,20,21,0,0,0,99,20120307
2012,NYK,23,18,32,32,0,0,0,105,SAS,28,30,35,25,0,0,0,118,20120307
2012,HOU,28,18,30,22,0,0,0,98,TOR,28,30,24,34,0,0,0,116,20120307
2012,LAL,29,35,19,18,0,0,0,101,WAS,21,28,32,25,0,0,0,106,20120307
2012,ORL,37,20,22,20,0,0,0,99,CHI,22,30,19,23,0,0,0,94,20120308
2012,DAL,24,29,23,18,0,0,0,94,PHO,23,21,34,18,0,0,0,96,20120308
2012,POR,17,13,24,32,0,0,0,86,BOS,27,38,23,16,0,0,0,104,20120309
2012,NJN,23,16,21,23,0,0,0,83,CHA,15,20,24,15,0,0,0,74,20120309
2012,NOH,26,20,25,26,0,0,0,97,DEN,32,18,29,31,0,0,0,110,20120309
2012,ATL,27,23,12,23,0,0,0,85,DET,24,17,26,19,0,0,0,86,20120309
2012,NYK,34,31,18,31,0,0,0,114,MIL,36,25,32,26,0,0,0,119,20120309
2012,LAL,21,28,29,27,0,0,0,105,MIN,33,25,20,24,0,0,0,102,20120309
2012,CLE,26,23,20,27,0,0,0,96,OKC,27,24,18,21,0,0,0,90,20120309
2012,UTA,27,20,21,23,0,0,0,91,PHI,25,24,29,26,0,0,0,104,20120309
2012,DAL,22,22,28,25,0,0,0,97,SAC,31,23,34,22,0,0,0,110,20120309
2012,LAC,33,31,30,26,0,0,0,120,SAS,34,22,34,18,0,0,0,108,20120309
2012,UTA,22,19,22,34,0,0,0,97,CHI,22,26,31,32,0,0,0,111,20120310
2012,TOR,14,23,21,28,0,0,0,86,DET,37,24,28,16,0,0,0,105,20120310
2012,DAL,15,27,24,21,0,0,0,87,GSW,26,26,31,28,0,0,0,111,20120310
2012,IND,26,17,18,24,6,0,0,91,MIA,17,22,21,25,8,0,0,93,20120310
2012,NOH,24,25,21,25,0,0,0,95,MIN,24,20,21,24,0,0,0,89,20120310
2012,HOU,29,30,25,28,0,0,0,112,NJN,21,28,34,23,0,0,0,106,20120310
2012,CHA,25,15,30,25,0,0,0,95,OKC,28,30,33,31,0,0,0,122,20120310
2012,MEM,29,22,23,17,0,0,0,91,PHO,26,27,27,18,0,0,0,98,20120310
2012,POR,27,28,27,28,0,0,0,110,WAS,27,25,24,23,0,0,0,99,20120310
2012,HOU,26,31,27,23,0,0,0,107,CLE,30,24,27,37,0,0,0,118,20120311
2012,MEM,23,27,23,21,0,0,0,94,DEN,25,28,17,21,0,0,0,91,20120311
2012,GSW,28,27,23,19,0,0,0,97,LAC,16,26,22,29,0,0,0,93,20120311
2012,BOS,14,28,28,24,0,0,0,94,LAL,24,20,28,25,0,0,0,97,20120311
2012,PHI,22,29,38,17,0,0,0,106,NYK,24,25,24,21,0,0,0,94,20120311
2012,IND,22,23,21,28,0,0,0,94,ORL,36,20,35,16,0,0,0,107,20120311
2012,ATL,23,28,29,26,0,0,0,106,SAC,24,28,22,25,0,0,0,99,20120311
2012,MIL,21,30,27,27,0,0,0,105,TOR,28,28,23,20,0,0,0,99,20120311
2012,NYK,25,25,28,21,0,0,0,99,CHI,23,25,31,25,0,0,0,104,20120312
2012,BOS,25,14,23,32,0,0,0,94,LAC,21,27,13,24,0,0,0,85,20120312
2012,MIL,27,20,26,32,0,0,0,105,NJN,32,22,19,26,0,0,0,99,20120312
2012,CHA,14,21,26,12,0,0,0,73,NOH,20,17,18,16,0,0,0,71,20120312
2012,MIN,28,35,29,35,0,0,0,127,PHO,34,22,34,34,0,0,0,124,20120312
2012,WAS,24,25,25,23,0,0,0,97,SAS,32,31,25,24,0,0,0,112,20120312
2012,DET,19,29,29,13,0,0,0,90,UTA,22,30,23,30,0,0,0,105,20120312
2012,TOR,21,33,21,21,0,0,0,96,CLE,22,24,19,23,0,0,0,88,20120313
2012,WAS,26,25,24,23,0,0,0,98,DAL,27,33,23,24,0,0,0,107,20120313
2012,ATL,26,29,25,25,12,0,0,117,DEN,30,34,18,23,13,0,0,118,20120313
2012,POR,15,23,14,23,0,0,0,75,IND,19,29,27,17,0,0,0,92,20120313
2012,LAL,21,30,20,26,6,13,0,116,MEM,29,23,28,17,6,8,0,111,20120313
2012,HOU,23,30,24,27,0,0,0,104,OKC,22,31,20,30,0,0,0,103,20120313
2012,MIA,27,29,17,21,4,0,0,98,ORL,30,15,27,22,10,0,0,104,20120313
2012,GSW,29,25,30,31,0,0,0,115,SAC,24,25,24,16,0,0,0,89,20120313
2012,MIA,23,19,28,32,0,0,0,102,CHI,19,34,28,25,0,0,0,106,20120314
2012,BOS,21,34,26,24,0,0,0,105,GSW,25,35,17,26,0,0,0,103,20120314
2012,CHA,18,22,17,30,0,0,0,87,HOU,30,20,36,21,0,0,0,107,20120314
2012,PHI,29,22,24,19,0,0,0,94,IND,24,30,29,28,0,0,0,111,20120314
2012,ATL,27,15,20,20,0,0,0,82,LAC,30,20,21,25,0,0,0,96,20120314
2012,CLE,28,27,23,27,0,0,0,105,MIL,23,34,27,31,0,0,0,115,20120314
2012,TOR,22,24,15,23,0,0,0,84,NJN,19,22,27,30,0,0,0,98,20120314
2012,LAL,20,20,30,23,14,0,0,107,NOH,28,26,16,23,8,0,0,101,20120314
2012,POR,12,17,27,23,0,0,0,79,NYK,25,30,23,43,0,0,0,121,20120314
2012,UTA,30,23,29,29,0,0,0,111,PHO,22,31,36,31,0,0,0,120,20120314
2012,DET,25,32,40,27,0,0,0,124,SAC,32,26,23,31,0,0,0,112,20120314
2012,ORL,35,23,26,27,0,0,0,111,SAS,36,23,30,33,0,0,0,122,20120314
2012,CHA,23,31,14,28,0,0,0,96,DAL,23,25,26,27,0,0,0,101,20120315
2012,OKC,29,21,28,25,0,0,0,103,DEN,25,26,14,25,0,0,0,90,20120315
2012,PHO,17,22,25,27,0,0,0,91,LAC,29,18,28,12,0,0,0,87,20120315
2012,WAS,28,28,19,24,0,0,0,99,NOH,28,21,24,16,0,0,0,89,20120315
2012,MIN,20,27,24,28,6,0,0,105,UTA,24,29,24,22,12,0,0,111,20120315
2012,WAS,26,28,10,24,0,0,0,88,ATL,30,20,21,31,0,0,0,102,20120316
2012,POR,29,21,28,22,0,0,0,100,CHI,32,21,26,10,0,0,0,89,20120316
2012,MIL,31,25,31,33,0,0,0,120,GSW,12,31,32,23,0,0,0,98,20120316
2012,MIN,19,22,20,31,0,0,0,92,LAL,23,27,24,23,0,0,0,97,20120316
2012,TOR,26,21,25,31,11,0,0,114,MEM,24,22,23,34,7,0,0,110,20120316
2012,IND,14,17,27,42,0,0,0,100,NYK,24,26,38,27,0,0,0,115,20120316
2012,SAS,30,35,27,22,0,0,0,114,OKC,19,29,31,26,0,0,0,105,20120316
2012,NJN,18,18,24,10,0,0,0,70,ORL,22,24,26,14,0,0,0,86,20120316
2012,MIA,31,26,12,15,0,0,0,84,PHI,18,12,26,22,0,0,0,78,20120316
2012,DET,27,32,21,21,0,0,0,101,PHO,31,23,25,30,0,0,0,109,20120316
2012,BOS,20,31,23,21,0,0,0,95,SAC,26,26,41,27,0,0,0,120,20120316
2012,TOR,29,24,14,36,0,0,0,103,CHA,20,23,38,26,0,0,0,107,20120317
2012,PHI,24,20,15,21,0,0,0,80,CHI,11,27,26,25,0,0,0,89,20120317
2012,SAS,19,25,24,31,0,0,0,99,DAL,28,18,32,28,0,0,0,106,20120317
2012,BOS,22,20,26,23,0,0,0,91,DEN,29,26,25,18,0,0,0,98,20120317
2012,NYK,33,27,17,25,0,0,0,102,IND,35,16,23,14,0,0,0,88,20120317
2012,HOU,23,24,19,25,0,0,0,91,LAC,19,20,30,26,0,0,0,95,20120317
2012,NOH,26,21,23,32,0,0,0,102,NJN,29,22,31,12,0,0,0,94,20120317
2012,GSW,25,26,14,22,5,0,0,92,UTA,18,28,23,18,12,0,0,99,20120317
2012,ATL,31,28,17,27,0,0,0,103,CLE,19,26,23,19,0,0,0,87,20120318
2012,DET,18,23,24,9,9,0,0,83,LAC,24,14,19,17,13,0,0,87,20120318
2012,UTA,23,22,30,28,0,0,0,103,LAL,20,24,25,30,0,0,0,99,20120318
2012,WAS,20,28,18,26,0,0,0,92,MEM,21,24,29,23,0,0,0,97,20120318
2012,ORL,22,25,16,18,0,0,0,81,MIA,31,19,17,24,0,0,0,91,20120318
2012,POR,15,27,28,25,0,0,0,95,OKC,31,26,27,27,0,0,0,111,20120318
2012,HOU,13,23,28,22,0,0,0,86,PHO,26,26,28,19,0,0,0,99,20120318
2012,MIN,31,26,25,17,0,0,0,99,SAC,28,29,33,25,0,0,0,115,20120318
2012,BOS,12,19,19,29,0,0,0,79,ATL,15,18,18,25,0,0,0,76,20120319
2012,PHI,25,21,30,29,0,0,0,105,CHA,19,25,19,17,0,0,0,80,20120319
2012,DAL,33,30,29,20,0,0,0,112,DEN,29,27,22,17,0,0,0,95,20120319
2012,MIN,21,28,22,26,0,0,0,97,GSW,14,21,32,26,0,0,0,93,20120319
2012,CLE,30,23,23,29,0,0,0,105,NJN,17,33,24,26,0,0,0,100,20120319
2012,CHI,22,26,12,25,0,0,0,85,ORL,14,19,15,11,0,0,0,59,20120319
2012,LAL,40,16,23,25,0,0,0,104,HOU,25,26,22,34,0,0,0,107,20120320
2012,LAC,31,15,20,23,0,0,0,89,IND,31,23,24,24,0,0,0,102,20120320
2012,PHO,22,31,22,20,0,0,0,95,MIA,28,21,23,27,0,0,0,99,20120320
2012,TOR,24,20,24,19,0,0,0,87,NYK,27,26,26,27,0,0,0,106,20120320
2012,MIL,25,29,28,34,0,0,0,116,POR,23,20,21,23,0,0,0,87,20120320
2012,MEM,28,28,30,24,0,0,0,110,SAC,37,29,27,26,0,0,0,119,20120320
2012,OKC,25,19,26,20,0,0,0,90,UTA,24,28,24,21,0,0,0,97,20120320
2012,CLE,36,17,20,18,11,0,0,102,ATL,21,33,18,19,12,0,0,103,20120321
2012,LAL,27,30,23,29,0,0,0,109,DAL,29,15,28,21,0,0,0,93,20120321
2012,DET,18,39,34,24,0,0,0,115,DEN,40,22,29,25,0,0,0,116,20120321
2012,WAS,33,23,28,24,0,0,0,108,NJN,25,28,19,17,0,0,0,89,20120321
2012,GSW,24,20,31,26,0,0,0,101,NOH,26,19,27,20,0,0,0,92,20120321
2012,LAC,30,20,21,20,0,0,0,91,OKC,33,33,22,26,0,0,0,114,20120321
2012,PHO,21,23,18,31,0,0,0,93,ORL,27,30,24,22,0,0,0,103,20120321
2012,NYK,19,24,16,23,0,0,0,82,PHI,11,24,23,21,0,0,0,79,20120321
2012,MIN,16,31,24,29,0,0,0,100,SAS,32,24,35,25,0,0,0,116,20120321
2012,CHI,27,16,19,32,0,0,0,94,TOR,23,28,18,13,0,0,0,82,20120321
2012,GSW,18,29,20,16,0,0,0,83,HOU,30,26,28,25,0,0,0,109,20120322
2012,BOS,35,21,18,26,0,0,0,100,MIL,29,29,13,20,0,0,0,91,20120322
2012,LAC,35,23,21,11,0,0,0,90,NOH,29,25,22,21,0,0,0,97,20120322
2012,MEM,20,24,25,24,0,0,0,93,POR,26,23,17,31,0,0,0,97,20120322
2012,UTA,30,28,29,16,0,0,0,103,SAC,26,22,29,25,0,0,0,102,20120322
2012,IND,18,13,26,28,0,0,0,85,WAS,34,17,15,17,0,0,0,83,20120322
2012,NJN,20,24,25,15,0,0,0,84,ATL,21,22,19,31,0,0,0,93,20120323
2012,MIL,21,31,31,29,0,0,0,112,CHA,20,20,28,24,0,0,0,92,20120323
2012,MIA,27,32,13,16,0,0,0,88,DET,20,16,21,16,0,0,0,73,20120323
2012,PHO,28,26,32,27,0,0,0,113,IND,31,30,18,32,0,0,0,111,20120323
2012,POR,19,29,22,26,0,0,0,96,LAL,30,23,18,32,0,0,0,103,20120323
2012,MIN,29,32,27,28,13,11,0,140,OKC,30,33,31,22,13,20,0,149,20120323
2012,CLE,20,20,23,17,0,0,0,80,ORL,31,24,17,21,0,0,0,93,20120323
2012,BOS,32,17,17,20,0,0,0,86,PHI,26,17,37,19,0,0,0,99,20120323
2012,DAL,21,24,18,24,0,0,0,87,SAS,24,28,18,34,0,0,0,104,20120323
2012,NYK,16,20,17,26,0,0,0,79,TOR,25,14,31,26,0,0,0,96,20120323
2012,DEN,32,23,21,26,0,0,0,102,UTA,30,33,31,27,0,0,0,121,20120323
2012,TOR,30,25,18,21,7,0,0,101,CHI,20,30,21,23,8,0,0,102,20120324
2012,SAC,24,27,37,20,0,0,0,108,GSW,34,28,27,22,0,0,0,111,20120324
2012,DAL,26,30,16,19,10,0,0,101,HOU,30,24,18,19,8,0,0,99,20120324
2012,MEM,17,25,19,24,0,0,0,85,LAC,33,23,25,20,0,0,0,101,20120324
2012,IND,29,28,35,33,0,0,0,125,MIL,26,22,28,28,0,0,0,104,20120324
2012,CHA,21,21,16,31,0,0,0,89,NJN,26,22,33,21,0,0,0,102,20120324
2012,SAS,23,24,26,16,0,0,0,89,NOH,22,26,24,14,0,0,0,86,20120324
2012,DET,17,20,24,18,0,0,0,79,NYK,21,28,27,25,0,0,0,101,20120324
2012,ATL,23,18,27,27,0,0,0,95,WAS,23,29,26,14,0,0,0,92,20120324
2012,UTA,22,18,34,24,2,13,10,133,ATL,29,26,20,23,2,13,13,139,20120325
2012,WAS,12,22,21,21,0,0,0,76,BOS,27,26,16,19,0,0,0,88,20120325
2012,PHO,29,30,26,23,0,0,0,108,CLE,21,17,24,21,0,0,0,83,20120325
2012,MEM,28,28,17,29,0,0,0,102,LAL,24,22,24,26,0,0,0,96,20120325
2012,DEN,20,23,32,25,0,0,0,100,MIN,33,35,25,24,0,0,0,117,20120325
2012,MIA,24,25,20,18,0,0,0,87,OKC,25,35,20,23,0,0,0,103,20120325
2012,GSW,27,20,16,24,0,0,0,87,POR,26,14,29,21,0,0,0,90,20120325
2012,PHI,22,27,16,11,0,0,0,76,SAS,29,23,24,17,0,0,0,93,20120325
2012,BOS,33,19,30,20,0,0,0,102,CHA,15,35,25,20,0,0,0,95,20120326
2012,DEN,25,29,27,27,0,0,0,108,CHI,27,25,16,23,0,0,0,91,20120326
2012,SAC,29,22,21,27,7,0,0,106,HOU,17,25,29,28,14,0,0,113,20120326
2012,MIA,24,22,19,25,0,0,0,90,IND,24,25,29,27,0,0,0,105,20120326
2012,NOH,20,18,17,30,0,0,0,85,LAC,27,22,25,23,0,0,0,97,20120326
2012,UTA,15,34,23,33,0,0,0,105,NJN,17,15,33,19,0,0,0,84,20120326
2012,MIL,26,26,12,16,0,0,0,80,NYK,30,17,21,21,0,0,0,89,20120326
2012,ORL,28,33,32,24,0,0,0,117,TOR,26,23,24,28,0,0,0,101,20120326
2012,DET,16,14,23,26,0,0,0,79,WAS,14,21,27,15,0,0,0,77,20120326
2012,HOU,30,19,12,20,0,0,0,81,DAL,19,27,23,21,0,0,0,90,20120327
2012,LAL,25,30,24,25,0,0,0,104,GSW,16,32,24,29,0,0,0,101,20120327
2012,MIN,22,19,26,19,0,0,0,86,MEM,24,20,24,25,0,0,0,93,20120327
2012,ATL,23,23,33,22,0,0,0,101,MIL,31,24,23,30,0,0,0,108,20120327
2012,CLE,21,22,25,17,0,0,0,85,PHI,29,28,25,21,0,0,0,103,20120327
2012,SAS,29,33,22,23,0,0,0,107,PHO,28,29,26,17,0,0,0,100,20120327
2012,OKC,32,33,19,25,0,0,0,109,POR,18,29,28,20,0,0,0,95,20120327
2012,CHI,21,33,22,22,0,0,0,98,ATL,23,19,18,17,0,0,0,77,20120328
2012,UTA,21,14,26,21,0,0,0,82,BOS,18,28,20,28,0,0,0,94,20120328
2012,MIN,24,21,23,20,0,0,0,88,CHA,21,26,18,18,0,0,0,83,20120328
2012,DET,21,28,19,19,0,0,0,87,CLE,23,21,17,14,0,0,0,75,20120328
2012,NOH,27,30,24,21,0,0,0,102,GSW,24,16,25,22,0,0,0,87,20120328
2012,PHO,27,14,23,22,0,0,0,86,LAC,24,19,31,29,0,0,0,103,20120328
2012,IND,22,21,24,17,0,0,0,84,NJN,25,24,20,31,0,0,0,100,20120328
2012,ORL,29,12,18,27,0,0,0,86,NYK,25,32,33,18,0,0,0,108,20120328
2012,SAS,27,26,28,36,0,0,0,117,SAC,22,27,29,34,0,0,0,112,20120328
2012,DEN,22,31,32,11,0,0,0,96,TOR,27,28,30,20,0,0,0,105,20120328
2012,WAS,26,23,20,20,0,0,0,89,IND,30,22,20,21,0,0,0,93,20120329
2012,OKC,18,26,34,24,0,0,0,102,LAL,30,19,19,25,0,0,0,93,20120329
2012,DAL,29,24,19,13,0,0,0,85,MIA,24,36,20,26,0,0,0,106,20120329
2012,NOH,27,27,16,23,0,0,0,93,POR,28,23,25,23,0,0,0,99,20120329
2012,NYK,20,20,29,21,0,0,0,90,ATL,28,24,22,26,0,0,0,100,20120330
2012,DEN,23,29,22,25,0,0,0,99,CHA,28,23,15,22,0,0,0,88,20120330
2012,DET,25,10,26,10,0,0,0,71,CHI,28,16,21,18,0,0,0,83,20120330
2012,MIL,35,36,28,22,0,0,0,121,CLE,26,18,30,10,0,0,0,84,20120330
2012,NJN,22,20,28,32,0,0,0,102,GSW,26,25,33,16,0,0,0,100,20120330
2012,MEM,19,29,21,20,0,0,0,89,HOU,30,19,25,24,0,0,0,98,20120330
2012,POR,18,25,27,27,0,0,0,97,LAC,23,23,27,25,0,0,0,98,20120330
2012,BOS,31,25,23,21,0,0,0,100,MIN,20,25,22,12,0,0,0,79,20120330
2012,DAL,17,29,25,29,0,0,0,100,ORL,27,28,23,20,0,0,0,98,20120330
2012,MIA,31,28,24,30,0,0,0,113,TOR,27,24,32,18,0,0,0,101,20120330
2012,SAC,32,24,24,24,0,0,0,104,UTA,29,30,25,19,0,0,0,103,20120330
2012,PHI,15,21,26,14,0,0,0,76,WAS,23,32,24,18,0,0,0,97,20120330
2012,CHA,17,32,28,20,10,0,0,107,DET,21,27,20,29,13,0,0,110,20120331
2012,UTA,22,23,21,30,0,0,0,96,LAC,38,19,22,26,0,0,0,105,20120331
2012,NOH,14,25,28,18,0,0,0,85,LAL,20,23,18,27,0,0,0,88,20120331
2012,MEM,11,36,31,21,0,0,0,99,MIL,19,32,20,24,0,0,0,95,20120331
2012,CLE,17,21,22,15,0,0,0,75,NYK,25,21,20,25,0,0,0,91,20120331
2012,ATL,23,18,25,24,0,0,0,90,PHI,17,26,19,33,0,0,0,95,20120331
2012,NJN,31,28,32,20,0,0,0,111,SAC,35,21,20,23,0,0,0,99,20120331
2012,IND,18,30,30,25,0,0,0,103,SAS,25,39,26,22,0,0,0,112,20120331
2012,MIA,19,25,12,16,0,0,0,72,BOS,29,20,31,11,0,0,0,91,20120401
2012,IND,27,17,19,30,11,0,0,104,HOU,23,19,31,20,9,0,0,102,20120401
2012,GSW,26,28,22,36,0,0,0,112,LAL,27,30,32,31,0,0,0,120,20120401
2012,CHI,20,19,12,27,0,0,0,78,OKC,27,22,31,12,0,0,0,92,20120401
2012,DEN,27,21,28,28,0,0,0,104,ORL,19,23,32,27,0,0,0,101,20120401
2012,NOH,21,20,17,17,0,0,0,75,PHO,26,24,25,17,0,0,0,92,20120401
2012,MIN,27,23,30,26,0,0,0,106,POR,27,30,31,31,0,0,0,119,20120401
2012,WAS,21,21,19,31,0,0,0,92,TOR,22,24,25,28,0,0,0,99,20120401
2012,HOU,26,14,31,28,0,0,0,99,CHI,22,29,19,23,0,0,0,93,20120402
2012,LAC,25,22,25,22,0,0,0,94,DAL,17,16,21,21,0,0,0,75,20120402
2012,MEM,21,21,26,26,0,0,0,94,OKC,22,22,20,24,0,0,0,88,20120402
2012,UTA,22,32,29,19,0,0,0,102,POR,35,22,21,19,0,0,0,97,20120402
2012,MIN,30,28,28,22,0,0,0,108,SAC,33,32,22,29,0,0,0,116,20120402
2012,MIL,28,27,28,29,0,0,0,112,WAS,19,28,22,29,0,0,0,98,20120402
2012,SAS,32,28,30,35,0,0,0,125,CLE,18,23,22,27,0,0,0,90,20120403
2012,ORL,25,22,27,21,0,0,0,95,DET,27,23,24,28,0,0,0,102,20120403
2012,NYK,31,28,28,17,0,0,0,104,IND,31,20,21,40,0,0,0,112,20120403
2012,NJN,23,22,21,21,0,0,0,87,LAL,32,26,20,13,0,0,0,91,20120403
2012,GSW,24,26,29,15,0,0,0,94,MEM,20,30,20,28,0,0,0,98,20120403
2012,PHI,27,27,16,23,0,0,0,93,MIA,29,22,25,23,0,0,0,99,20120403
2012,PHO,29,30,20,30,0,0,0,109,SAC,18,33,27,22,0,0,0,100,20120403
2012,CHA,22,24,18,23,0,0,0,87,TOR,24,29,18,21,0,0,0,92,20120403
2012,CHA,25,19,26,23,0,0,0,93,ATL,27,34,28,31,0,0,0,120,20120404
2012,SAS,27,32,9,19,0,0,0,87,BOS,20,28,16,22,0,0,0,86,20120404
2012,MEM,23,28,17,17,0,0,0,85,DAL,20,27,19,29,0,0,0,95,20120404
2012,LAL,34,29,29,21,0,0,0,113,LAC,29,26,26,27,0,0,0,108,20120404
2012,OKC,23,26,24,20,0,0,0,93,MIA,21,29,30,18,0,0,0,98,20120404
2012,CLE,14,25,29,30,0,0,0,98,MIL,29,24,26,28,0,0,0,107,20120404
2012,GSW,21,18,38,20,0,0,0,97,MIN,26,25,20,23,0,0,0,94,20120404
2012,DEN,18,28,21,25,0,0,0,92,NOH,20,25,30,19,0,0,0,94,20120404
2012,TOR,29,26,24,20,0,0,0,99,PHI,31,25,15,7,0,0,0,78,20120404
2012,NJN,17,27,20,24,0,0,0,88,POR,21,25,30,25,0,0,0,101,20120404
2012,PHO,31,27,25,24,0,0,0,107,UTA,31,25,24,25,0,0,0,105,20120404
2012,IND,37,15,34,23,0,0,0,109,WAS,28,23,23,22,0,0,0,96,20120404
2012,BOS,22,27,17,20,0,0,0,86,CHI,18,20,29,26,0,0,0,93,20120405
2012,WAS,21,19,24,30,0,0,0,94,DET,28,23,25,23,0,0,0,99,20120405
2012,NYK,23,33,20,20,0,0,0,96,ORL,21,23,17,19,0,0,0,80,20120405
2012,LAC,27,21,19,26,0,0,0,93,SAC,23,19,20,23,0,0,0,85,20120405
2012,DET,20,23,25,28,0,0,0,96,ATL,24,28,26,23,0,0,0,101,20120406
2012,POR,17,27,30,17,8,0,0,99,DAL,27,29,10,25,6,0,0,97,20120406
2012,PHO,29,23,23,24,0,0,0,99,DEN,21,31,26,27,0,0,0,105,20120406
2012,OKC,20,21,20,37,0,0,0,98,IND,32,24,19,28,0,0,0,103,20120406
2012,HOU,29,21,34,28,0,0,0,112,LAL,24,35,22,26,0,0,0,107,20120406
2012,MEM,25,23,25,24,0,0,0,97,MIA,12,20,29,21,0,0,0,82,20120406
2012,CHA,30,22,16,22,0,0,0,90,MIL,28,25,19,23,0,0,0,95,20120406
2012,WAS,19,24,23,32,0,0,0,98,NJN,33,24,26,27,0,0,0,110,20120406
2012,NOH,24,21,28,30,0,0,0,103,SAS,34,38,27,29,0,0,0,128,20120406
2012,CLE,20,19,12,33,0,0,0,84,TOR,22,20,21,17,0,0,0,80,20120406
2012,GSW,27,28,25,18,0,0,0,98,UTA,28,27,23,26,0,0,0,104,20120406
2012,ATL,19,29,38,30,0,0,0,116,CHA,23,13,32,28,0,0,0,96,20120407
2012,DEN,27,22,26,22,0,0,0,97,GSW,26,30,29,27,0,0,0,112,20120407
2012,BOS,24,19,16,27,0,0,0,86,IND,19,14,18,21,0,0,0,72,20120407
2012,SAC,22,29,23,20,0,0,0,94,LAC,29,27,26,27,0,0,0,109,20120407
2012,DAL,10,29,28,22,0,0,0,89,MEM,29,21,22,22,0,0,0,94,20120407
2012,POR,31,32,20,11,0,0,0,94,MIL,33,21,32,30,0,0,0,116,20120407
2012,MIN,21,20,26,23,0,0,0,90,NOH,20,26,33,20,0,0,0,99,20120407
2012,ORL,24,13,25,26,0,0,0,88,PHI,19,26,16,21,0,0,0,82,20120407
2012,LAL,32,25,26,22,0,0,0,105,PHO,24,38,37,26,0,0,0,125,20120407
2012,PHI,22,14,27,16,0,0,0,79,BOS,25,25,34,19,0,0,0,103,20120408
2012,DET,21,19,14,21,0,0,0,75,MIA,19,31,19,29,0,0,0,98,20120408
2012,CLE,30,18,23,38,8,0,0,117,NJN,26,30,20,33,13,0,0,122,20120408
2012,CHI,19,26,30,16,8,0,0,99,NYK,31,22,19,19,9,0,0,100,20120408
2012,TOR,20,23,12,20,0,0,0,75,OKC,25,25,20,21,0,0,0,91,20120408
2012,HOU,32,26,15,31,0,0,0,104,SAC,21,22,20,24,0,0,0,87,20120408
2012,UTA,19,21,36,28,0,0,0,104,SAS,31,26,28,29,0,0,0,114,20120408
2012,WAS,31,29,25,28,0,0,0,113,CHA,20,20,18,27,0,0,0,85,20120409
2012,GSW,13,25,20,26,0,0,0,84,DEN,37,28,25,33,0,0,0,123,20120409
2012,TOR,16,21,25,36,0,0,0,98,IND,21,30,26,26,0,0,0,103,20120409
2012,LAC,18,23,19,25,0,0,0,85,MEM,24,28,19,23,0,0,0,94,20120409
2012,OKC,35,26,26,22,0,0,0,109,MIL,18,29,21,21,0,0,0,89,20120409
2012,PHO,21,32,30,31,0,0,0,114,MIN,18,27,23,22,0,0,0,90,20120409
2012,LAL,21,23,21,28,0,0,0,93,NOH,19,24,29,19,0,0,0,91,20120409
2012,DET,22,21,28,18,0,0,0,89,ORL,29,35,30,25,0,0,0,119,20120409
2012,HOU,24,25,22,23,0,0,0,94,POR,17,23,25,24,0,0,0,89,20120409
2012,SAS,19,25,24,16,0,0,0,84,UTA,23,24,17,27,0,0,0,91,20120409
2012,NYK,25,10,27,24,0,0,0,86,CHI,22,25,25,26,0,0,0,98,20120410
2012,CHA,22,23,26,19,0,0,0,90,CLE,30,19,23,31,0,0,0,103,20120410
2012,SAC,27,23,27,23,0,0,0,100,DAL,25,32,26,27,0,0,0,110,20120410
2012,BOS,33,32,24,26,0,0,0,115,MIA,22,35,24,26,0,0,0,107,20120410
2012,PHI,20,32,32,23,0,0,0,107,NJN,20,23,25,20,0,0,0,88,20120410
2012,ORL,29,12,20,24,0,0,0,85,WAS,18,23,19,33,0,0,0,93,20120410
2012,ATL,25,23,20,16,2,0,0,86,BOS,26,14,27,17,4,0,0,88,20120411
2012,IND,28,18,27,21,10,0,0,104,CLE,25,21,20,28,4,0,0,98,20120411
2012,MIN,24,23,33,27,0,0,0,107,DEN,37,31,21,24,0,0,0,113,20120411
2012,UTA,30,26,24,23,0,0,0,103,HOU,26,20,21,24,0,0,0,91,20120411
2012,PHO,26,27,19,21,0,0,0,93,MEM,32,27,21,24,0,0,0,104,20120411
2012,NYK,36,26,22,27,0,0,0,111,MIL,27,35,26,19,0,0,0,107,20120411
2012,SAC,29,20,21,26,0,0,0,96,NOH,20,30,29,26,0,0,0,105,20120411
2012,LAC,21,27,28,24,0,0,0,100,OKC,24,31,25,18,0,0,0,98,20120411
2012,GSW,25,30,20,35,0,0,0,110,POR,30,32,23,33,0,0,0,118,20120411
2012,LAL,24,24,27,23,0,0,0,98,SAS,21,22,16,25,0,0,0,84,20120411
2012,PHI,20,22,21,30,0,0,0,93,TOR,20,17,20,18,0,0,0,75,20120411
2012,DET,22,30,40,17,0,0,0,109,CHA,18,22,22,23,0,0,0,85,20120412
2012,MIA,22,19,21,22,2,0,0,86,CHI,19,17,24,24,12,0,0,96,20120412
2012,DAL,27,36,26,23,0,0,0,112,GSW,20,29,30,24,0,0,0,103,20120412
2012,LAC,21,26,26,22,0,0,0,95,MIN,26,22,20,14,0,0,0,82,20120412
2012,MEM,21,28,25,23,0,0,0,97,SAS,27,18,37,25,0,0,0,107,20120412
2012,MIL,30,22,33,28,0,0,0,113,DET,25,22,26,24,0,0,0,97,20120413
2012,PHO,21,30,30,31,0,0,0,112,HOU,28,27,14,36,0,0,0,105,20120413
2012,CLE,19,24,13,27,0,0,0,83,IND,16,25,34,27,0,0,0,102,20120413
2012,DEN,19,29,23,26,0,0,0,97,LAL,30,24,25,24,0,0,0,103,20120413
2012,CHA,19,20,20,23,0,0,0,82,MIA,33,25,23,24,0,0,0,105,20120413
2012,UTA,28,19,23,15,0,0,0,85,NOH,24,23,26,23,0,0,0,96,20120413
2012,WAS,13,20,14,18,0,0,0,65,NYK,26,28,25,24,0,0,0,103,20120413
2012,SAC,21,18,24,26,0,0,0,89,OKC,23,35,28,29,0,0,0,115,20120413
2012,ATL,36,26,27,20,0,0,0,109,ORL,23,19,22,17,0,0,0,81,20120413
2012,NJN,24,17,22,32,0,0,0,95,PHI,18,26,22,23,0,0,0,89,20120413
2012,DAL,30,26,25,16,0,0,0,97,POR,16,25,20,33,0,0,0,94,20120413
2012,BOS,20,16,11,32,0,0,0,79,TOR,13,17,27,27,0,0,0,84,20120413
2012,GSW,23,35,24,22,0,0,0,104,LAC,35,24,27,26,0,0,0,112,20120414
2012,UTA,30,21,25,22,0,0,0,98,MEM,28,22,20,33,0,0,0,103,20120414
2012,IND,27,32,21,25,0,0,0,105,MIL,27,21,30,21,0,0,0,99,20120414
2012,OKC,34,25,27,29,0,0,0,115,MIN,31,27,22,30,0,0,0,110,20120414
2012,BOS,22,26,26,20,0,0,0,94,NJN,28,20,13,21,0,0,0,82,20120414
2012,PHO,13,25,27,26,0,0,0,91,SAS,35,27,22,21,0,0,0,105,20120414
2012,CLE,22,28,23,25,0,0,0,98,WAS,22,21,28,18,0,0,0,89,20120414
2012,TOR,25,28,20,29,0,0,0,102,ATL,23,16,25,22,0,0,0,86,20120415
2012,BOS,34,18,21,21,0,0,0,94,CHA,23,26,18,15,0,0,0,82,20120415
2012,ORL,23,20,31,26,0,0,0,100,CLE,15,15,30,24,0,0,0,84,20120415
2012,HOU,27,22,19,18,0,0,0,86,DEN,22,21,37,21,0,0,0,101,20120415
2012,CHI,26,23,15,22,14,0,0,100,DET,19,22,25,20,8,0,0,94,20120415
2012,DAL,27,27,21,23,10,0,0,108,LAL,22,26,28,22,14,0,0,112,20120415
2012,MEM,16,21,19,19,0,0,0,75,NOH,15,18,29,26,0,0,0,88,20120415
2012,MIA,29,17,25,22,0,0,0,93,NYK,22,22,24,17,0,0,0,85,20120415
2012,POR,28,26,27,22,0,0,0,103,SAC,22,24,33,25,0,0,0,104,20120415
2012,NOH,14,21,12,28,0,0,0,75,CHA,15,24,8,20,0,0,0,67,20120416
2012,WAS,19,24,14,30,0,0,0,87,CHI,23,17,23,21,0,0,0,84,20120416
2012,SAS,39,31,26,24,0,0,0,120,GSW,24,25,23,27,0,0,0,99,20120416
2012,DEN,21,23,31,30,0,0,0,105,HOU,32,19,23,28,0,0,0,102,20120416
2012,MIN,13,17,33,25,0,0,0,88,IND,32,32,29,18,0,0,0,111,20120416
2012,OKC,27,25,14,11,0,0,0,77,LAC,21,22,23,26,0,0,0,92,20120416
2012,MIA,29,23,18,31,0,0,0,101,NJN,34,21,24,19,0,0,0,98,20120416
2012,PHI,27,28,24,21,0,0,0,100,ORL,21,40,29,23,0,0,0,113,20120416
2012,POR,24,29,27,27,0,0,0,107,PHO,35,31,31,28,0,0,0,125,20120416
2012,ATL,30,24,25,30,0,0,0,109,TOR,32,19,17,19,0,0,0,87,20120416
2012,DAL,18,24,20,27,16,6,10,121,UTA,22,21,28,18,16,6,12,123,20120416
2012,CLE,16,22,12,27,0,0,0,77,DET,27,34,39,16,0,0,0,116,20120417
2012,SAS,27,36,28,21,0,0,0,112,LAL,28,19,23,21,0,0,0,91,20120417
2012,MEM,32,23,22,14,0,0,0,91,MIN,22,34,13,15,0,0,0,84,20120417
2012,BOS,26,27,31,26,0,0,0,110,NYK,32,40,24,22,0,0,0,118,20120417
2012,IND,23,24,23,32,0,0,0,102,PHI,21,21,28,27,0,0,0,97,20120417
2012,DET,20,22,19,23,0,0,0,84,ATL,39,33,24,20,0,0,0,116,20120418
2012,ORL,22,29,19,28,0,0,0,98,BOS,33,22,24,23,0,0,0,102,20120418
2012,CHI,34,18,25,23,0,0,0,100,CHA,20,17,22,9,0,0,0,68,20120418
2012,PHI,28,25,31,19,0,0,0,103,CLE,22,27,17,21,0,0,0,87,20120418
2012,HOU,27,28,29,26,0,0,0,110,DAL,27,28,23,39,0,0,0,117,20120418
2012,LAC,22,25,29,28,0,0,0,104,DEN,34,19,23,22,0,0,0,98,20120418
2012,LAL,32,24,28,15,0,0,0,99,GSW,26,22,19,20,0,0,0,87,20120418
2012,NOH,21,27,12,31,0,0,0,91,MEM,23,24,37,19,0,0,0,103,20120418
2012,TOR,24,25,11,12,0,0,0,72,MIA,25,26,23,22,0,0,0,96,20120418
2012,NYK,38,26,14,26,0,0,0,104,NJN,22,25,24,24,0,0,0,95,20120418
2012,OKC,29,23,30,27,0,0,0,109,PHO,25,20,32,20,0,0,0,97,20120418
2012,UTA,26,31,24,31,0,0,0,112,POR,23,16,21,31,0,0,0,91,20120418
2012,SAS,29,29,39,30,0,0,0,127,SAC,28,29,29,16,0,0,0,102,20120418
2012,MIL,31,31,19,31,0,0,0,112,WAS,28,32,28,33,0,0,0,121,20120418
2012,MIN,24,25,19,23,0,0,0,91,DET,16,15,17,32,0,0,0,80,20120419
2012,MIL,29,21,28,31,0,0,0,109,IND,34,22,33,29,0,0,0,118,20120419
2012,CHI,23,17,21,11,0,0,0,72,MIA,27,15,24,17,0,0,0,83,20120419
2012,HOU,29,22,13,23,12,0,0,99,NOH,22,21,26,18,18,0,0,105,20120419
2012,LAC,29,16,26,19,0,0,0,90,PHO,27,19,23,24,0,0,0,93,20120419
2012,BOS,27,22,22,21,0,0,0,92,ATL,34,24,16,23,0,0,0,97,20120420
2012,MEM,17,20,20,28,0,0,0,85,CHA,21,18,26,15,0,0,0,80,20120420
2012,NYK,20,14,22,34,0,0,0,90,CLE,25,20,27,26,0,0,0,98,20120420
2012,GSW,22,27,21,24,0,0,0,94,DAL,27,23,26,28,0,0,0,104,20120420
2012,OKC,32,25,24,22,0,0,0,103,SAC,25,24,21,22,0,0,0,92,20120420
2012,LAL,25,27,21,24,0,0,0,97,SAS,32,24,35,30,0,0,0,121,20120420
2012,DAL,8,30,18,27,0,0,0,83,CHI,21,23,22,27,0,0,0,93,20120421
2012,GSW,21,34,16,25,0,0,0,96,HOU,31,27,19,22,0,0,0,99,20120421
2012,PHI,34,19,28,17,11,0,0,109,IND,23,31,20,24,8,0,0,106,20120421
2012,POR,27,18,22,22,0,0,0,89,MEM,24,30,25,14,0,0,0,93,20120421
2012,WAS,23,22,18,23,0,0,0,86,MIA,15,22,25,22,0,0,0,84,20120421
2012,NJN,23,19,27,26,0,0,0,95,MIL,24,29,20,33,0,0,0,106,20120421
2012,DEN,30,30,33,25,0,0,0,118,PHO,34,24,22,27,0,0,0,107,20120421
2012,ORL,36,19,28,18,6,0,0,107,UTA,23,32,26,20,16,0,0,117,20120421
2012,NYK,31,29,34,19,0,0,0,113,ATL,31,34,28,19,0,0,0,112,20120422
2012,SAC,31,28,28,27,0,0,0,114,CHA,19,25,23,21,0,0,0,88,20120422
2012,ORL,19,25,18,12,0,0,0,74,DEN,24,20,29,28,0,0,0,101,20120422
2012,TOR,15,19,16,23,0,0,0,73,DET,14,15,24,23,0,0,0,76,20120422
2012,NOH,27,25,32,14,0,0,0,98,LAC,32,25,17,33,0,0,0,107,20120422
2012,OKC,26,26,25,14,6,9,0,106,LAL,20,27,14,30,6,17,0,114,20120422
2012,HOU,27,17,25,19,0,0,0,88,MIA,22,23,21,31,0,0,0,97,20120422
2012,GSW,17,22,30,24,0,0,0,93,MIN,32,23,20,13,0,0,0,88,20120422
2012,CLE,22,22,26,28,0,0,0,98,SAS,29,23,29,33,0,0,0,114,20120422
2012,DET,26,26,23,22,0,0,0,97,IND,26,28,22,27,0,0,0,103,20120423
2012,CLE,32,20,26,23,0,0,0,101,MEM,26,29,22,32,0,0,0,109,20120423
2012,TOR,25,23,19,19,0,0,0,86,MIL,17,26,19,30,0,0,0,92,20120423
2012,PHI,31,22,23,29,0,0,0,105,NJN,18,25,25,19,0,0,0,87,20120423
2012,POR,18,23,24,24,0,0,0,89,SAS,31,32,28,33,0,0,0,124,20120423
2012,CHA,22,17,23,11,0,0,0,73,WAS,31,32,20,18,0,0,0,101,20120423
2012,LAC,28,22,22,30,0,0,0,102,ATL,23,29,33,24,0,0,0,109,20120424
2012,MIA,17,17,16,16,0,0,0,66,BOS,10,18,22,28,0,0,0,78,20120424
2012,NOH,21,22,18,22,0,0,0,83,GSW,22,21,21,17,0,0,0,81,20120424
2012,SAC,40,19,27,24,0,0,0,110,OKC,35,22,25,36,0,0,0,118,20120424
2012,PHO,19,23,26,20,0,0,0,88,UTA,25,24,24,27,0,0,0,100,20120424
2012,WAS,21,28,28,19,0,0,0,96,CLE,27,18,18,22,0,0,0,85,20120425
2012,CHI,32,17,18,25,0,0,0,92,IND,24,12,23,28,0,0,0,87,20120425
2012,PHI,24,21,26,19,0,0,0,90,MIL,29,21,13,22,0,0,0,85,20120425
2012,LAC,19,20,27,27,0,0,0,93,NYK,24,24,26,25,0,0,0,99,20120425
2012,DEN,36,28,16,26,0,0,0,106,OKC,30,28,24,19,0,0,0,101,20120425
2012,CHA,24,23,26,22,0,0,0,95,ORL,37,20,26,19,0,0,0,102,20120425
2012,SAS,26,32,24,28,0,0,0,110,PHO,29,24,29,24,0,0,0,106,20120425
2012,DAL,21,23,28,17,0,0,0,89,ATL,38,22,26,20,0,0,0,106,20120426
2012,MIL,18,24,19,13,0,0,0,74,BOS,21,39,18,9,0,0,0,87,20120426
2012,NYK,23,23,30,28,0,0,0,104,CHA,20,24,19,21,0,0,0,84,20120426
2012,CLE,25,20,17,13,0,0,0,75,CHI,26,32,22,27,0,0,0,107,20120426
2012,PHI,15,28,23,20,0,0,0,86,DET,26,39,21,22,0,0,0,108,20120426
2012,SAS,27,26,31,23,0,0,0,107,GSW,29,25,28,19,0,0,0,101,20120426
2012,NOH,20,22,29,6,0,0,0,77,HOU,12,21,30,21,0,0,0,84,20120426
2012,ORL,9,21,24,22,0,0,0,76,MEM,27,27,13,21,0,0,0,88,20120426
2012,DEN,29,32,32,38,0,0,0,131,MIN,25,17,27,33,0,0,0,102,20120426
2012,LAL,24,19,31,22,0,0,0,96,SAC,35,21,34,23,0,0,0,113,20120426
2012,NJN,15,12,16,24,0,0,0,67,TOR,26,28,19,25,0,0,0,98,20120426
2012,POR,16,24,35,19,0,0,0,94,UTA,23,24,31,18,0,0,0,96,20120426
2012,MIA,18,14,18,20,0,0,0,70,WAS,28,29,23,24,0,0,0,104,20120426
2012,PHI,24,18,24,25,0,0,0,91,CHI,28,25,26,24,0,0,0,103,20120428
2012,ORL,21,30,13,17,0,0,0,81,IND,22,22,19,14,0,0,0,77,20120428
2012,NYK,18,13,16,20,0,0,0,67,MIA,24,30,27,19,0,0,0,100,20120428
2012,DAL,26,25,22,25,0,0,0,98,OKC,22,26,21,30,0,0,0,99,20120428
2012,BOS,18,17,18,21,0,0,0,74,ATL,31,18,16,18,0,0,0,83,20120429
2012,DEN,14,26,24,24,0,0,0,88,LAL,27,23,27,26,0,0,0,103,20120429
2012,LAC,16,23,25,35,0,0,0,99,MEM,34,24,27,13,0,0,0,98,20120429
2012,UTA,22,25,23,21,0,0,0,91,SAS,28,26,31,21,0,0,0,106,20120429
2012,ORL,21,23,13,21,0,0,0,78,IND,24,18,30,21,0,0,0,93,20120430
2012,NYK,24,23,22,25,0,0,0,94,MIA,27,26,25,26,0,0,0,104,20120430
2012,DAL,24,26,27,22,0,0,0,99,OKC,32,25,22,23,0,0,0,102,20120430
2012,BOS,24,17,20,26,0,0,0,87,ATL,24,20,22,14,0,0,0,80,20120501
2012,PHI,25,22,36,26,0,0,0,109,CHI,28,27,14,23,0,0,0,92,20120501
2012,DEN,25,23,26,26,0,0,0,100,LAL,32,23,26,23,0,0,0,104,20120501
2012,LAC,26,21,22,29,0,0,0,98,MEM,23,28,24,30,0,0,0,105,20120502
2012,IND,23,21,32,21,0,0,0,97,ORL,14,24,17,19,0,0,0,74,20120502
2012,UTA,17,11,25,30,0,0,0,83,SAS,28,25,34,27,0,0,0,114,20120502
2012,OKC,32,18,25,20,0,0,0,95,DAL,26,15,16,22,0,0,0,79,20120503
2012,MIA,19,17,22,29,0,0,0,87,NYK,19,21,16,14,0,0,0,70,20120503
2012,ATL,19,19,20,22,4,0,0,84,BOS,17,23,20,20,10,0,0,90,20120504
2012,LAL,14,25,26,19,0,0,0,84,DEN,30,25,17,27,0,0,0,99,20120504
2012,CHI,20,19,21,14,0,0,0,74,PHI,19,21,11,28,0,0,0,79,20120504
2012,OKC,26,21,21,35,0,0,0,103,DAL,24,23,34,16,0,0,0,97,20120505
2012,MEM,22,24,25,15,0,0,0,86,LAC,23,27,14,23,0,0,0,87,20120505
2012,IND,22,24,27,16,12,0,0,101,ORL,19,25,17,28,10,0,0,99,20120505
2012,SAS,30,22,23,27,0,0,0,102,UTA,28,22,18,22,0,0,0,90,20120505
2012,ATL,19,22,22,16,0,0,0,79,BOS,32,32,26,11,0,0,0,101,20120506
2012,LAL,26,19,25,22,0,0,0,92,DEN,28,23,20,17,0,0,0,88,20120506
2012,MIA,18,26,17,26,0,0,0,87,NYK,20,18,26,25,0,0,0,89,20120506
2012,CHI,15,27,21,19,0,0,0,82,PHI,24,20,20,25,0,0,0,89,20120506
2012,MEM,26,19,19,23,10,0,0,97,LAC,32,19,18,18,14,0,0,101,20120507
2012,SAS,22,28,18,19,0,0,0,87,UTA,19,23,16,23,0,0,0,81,20120507
2012,BOS,21,19,24,22,0,0,0,86,ATL,15,25,26,21,0,0,0,87,20120508
2012,PHI,16,10,22,21,0,0,0,69,CHI,17,18,22,20,0,0,0,77,20120508
2012,ORL,19,28,24,16,0,0,0,87,IND,28,22,19,36,0,0,0,105,20120508
2012,DEN,26,23,27,26,0,0,0,102,LAL,23,20,22,34,0,0,0,99,20120508
2012,LAC,22,20,23,15,0,0,0,80,MEM,36,21,20,15,0,0,0,92,20120509
2012,NYK,24,20,23,27,0,0,0,94,MIA,28,27,26,25,0,0,0,106,20120509
2012,ATL,23,18,22,17,0,0,0,80,BOS,20,27,20,16,0,0,0,83,20120510
2012,LAL,20,25,23,28,0,0,0,96,DEN,30,24,36,23,0,0,0,113,20120510
2012,CHI,22,18,23,15,0,0,0,78,PHI,24,24,15,16,0,0,0,79,20120510
2012,MEM,25,17,24,24,0,0,0,90,LAC,16,22,28,22,0,0,0,88,20120511
2012,PHI,28,19,24,20,0,0,0,91,BOS,18,24,25,25,0,0,0,92,20120512
2012,DEN,24,18,26,19,0,0,0,87,LAL,25,23,21,27,0,0,0,96,20120512
2012,LAC,16,23,16,27,0,0,0,82,MEM,13,25,18,16,0,0,0,72,20120513
2012,IND,23,25,22,16,0,0,0,86,MIA,20,22,28,25,0,0,0,95,20120513
2012,PHI,21,15,21,25,0,0,0,82,BOS,25,13,11,32,0,0,0,81,20120514
2012,LAL,23,21,24,22,0,0,0,90,OKC,30,29,39,21,0,0,0,119,20120514
2012,IND,17,16,28,17,0,0,0,78,MIA,21,17,14,23,0,0,0,75,20120515
2012,LAC,29,20,23,20,0,0,0,92,SAS,29,28,30,21,0,0,0,108,20120515
2012,LAL,22,23,18,12,0,0,0,75,OKC,21,27,12,17,0,0,0,77,20120516
2012,BOS,28,32,29,18,0,0,0,107,PHI,33,16,17,25,0,0,0,91,20120516
2012,MIA,26,17,12,20,0,0,0,75,IND,17,26,26,25,0,0,0,94,20120517
2012,LAC,21,21,25,21,0,0,0,88,SAS,29,17,32,27,0,0,0,105,20120517
2012,OKC,15,32,23,26,0,0,0,96,LAL,23,27,19,30,0,0,0,99,20120518
2012,BOS,24,22,17,20,0,0,0,83,PHI,12,19,28,33,0,0,0,92,20120518
2012,SAS,11,32,26,27,0,0,0,96,LAC,33,20,8,25,0,0,0,86,20120519
2012,OKC,24,22,25,32,0,0,0,103,LAL,29,27,24,20,0,0,0,100,20120519
2012,MIA,18,28,30,25,0,0,0,101,IND,25,29,16,23,0,0,0,93,20120520
2012,SAS,26,25,23,28,0,0,0,102,LAC,21,26,28,24,0,0,0,99,20120520
2012,PHI,27,23,16,19,0,0,0,85,BOS,23,24,28,26,0,0,0,101,20120521
2012,LAL,21,30,26,13,0,0,0,90,OKC,26,28,29,23,0,0,0,106,20120521
2012,IND,20,20,17,26,0,0,0,83,MIA,26,23,27,39,0,0,0,115,20120522
2012,BOS,19,17,20,19,0,0,0,75,PHI,22,11,27,22,0,0,0,82,20120523
2012,MIA,21,30,28,26,0,0,0,105,IND,28,25,16,24,0,0,0,93,20120524
2012,PHI,20,13,19,23,0,0,0,75,BOS,20,21,14,30,0,0,0,85,20120526
2012,OKC,18,29,24,27,0,0,0,98,SAS,24,22,16,39,0,0,0,101,20120527
2012,BOS,11,35,15,18,0,0,0,79,MIA,21,25,26,21,0,0,0,93,20120528
2012,OKC,22,22,32,35,0,0,0,111,SAS,28,27,37,28,0,0,0,120,20120529
2012,BOS,24,29,22,24,12,0,0,111,MIA,18,28,35,18,16,0,0,115,20120530
2012,SAS,24,17,19,22,0,0,0,82,OKC,22,32,24,24,0,0,0,102,20120531
2012,MIA,28,14,21,28,0,0,0,91,BOS,30,25,30,16,0,0,0,101,20120601
2012,SAS,26,17,28,32,0,0,0,103,OKC,26,29,20,34,0,0,0,109,20120602
2012,MIA,23,24,21,21,2,0,0,91,BOS,34,27,12,16,4,0,0,93,20120603
2012,OKC,26,26,29,27,0,0,0,108,SAS,21,23,28,31,0,0,0,103,20120604
2012,BOS,16,24,25,29,0,0,0,94,MIA,24,18,18,30,0,0,0,90,20120605
2012,SAS,34,29,18,18,0,0,0,99,OKC,20,28,32,27,0,0,0,107,20120606
2012,MIA,26,29,19,24,0,0,0,98,BOS,16,26,19,18,0,0,0,79,20120607
2012,BOS,27,26,20,15,0,0,0,88,MIA,23,23,27,28,0,0,0,101,20120609
2012,MIA,29,25,19,21,0,0,0,94,OKC,22,25,27,31,0,0,0,105,20120612
2012,MIA,27,28,23,22,0,0,0,100,OKC,15,28,24,29,0,0,0,96,20120614
2012,OKC,20,26,21,18,0,0,0,85,MIA,26,21,22,22,0,0,0,91,20120617
2012,OKC,33,16,26,23,0,0,0,98,MIA,19,27,33,25,0,0,0,104,20120619
2012,OKC,26,23,22,35,0,0,0,106,MIA,31,28,36,26,0,0,0,121,20120621
2013,WAS,24,15,23,22,0,0,0,84,CLE,31,19,24,20,0,0,0,94,20121030
2013,DAL,25,23,26,25,0,0,0,99,LAL,29,17,20,25,0,0,0,91,20121030
2013,BOS,25,29,22,31,0,0,0,107,MIA,31,31,31,27,0,0,0,120,20121030
2013,SAC,23,17,23,24,0,0,0,87,CHI,25,19,25,24,0,0,0,93,20121031
2013,HOU,27,28,17,33,0,0,0,105,DET,22,36,23,15,0,0,0,96,20121031
2013,MEM,24,29,24,15,0,0,0,92,LAC,26,23,24,28,0,0,0,101,20121031
2013,SAS,28,15,28,28,0,0,0,99,NOH,31,19,21,24,0,0,0,95,20121031
2013,DEN,22,16,14,23,0,0,0,75,PHI,25,21,19,19,0,0,0,84,20121031
2013,GSW,25,23,17,22,0,0,0,87,PHO,21,21,25,18,0,0,0,85,20121031
2013,LAL,26,31,19,30,0,0,0,106,POR,30,32,30,24,0,0,0,116,20121031
2013,IND,27,21,15,27,0,0,0,90,TOR,25,23,23,17,0,0,0,88,20121031
2013,DAL,26,37,13,18,0,0,0,94,UTA,25,30,37,21,0,0,0,113,20121031
2013,OKC,24,16,26,18,0,0,0,84,SAS,21,24,21,20,0,0,0,86,20121101
2013,HOU,28,25,28,28,0,0,0,109,ATL,21,23,30,28,0,0,0,102,20121102
2013,MIL,25,21,30,23,0,0,0,99,BOS,18,12,28,30,0,0,0,88,20121102
2013,IND,20,23,27,19,0,0,0,89,CHA,17,22,35,16,0,0,0,90,20121102
2013,CHI,32,28,23,32,0,0,0,115,CLE,16,19,21,30,0,0,0,86,20121102
2013,MEM,28,23,24,29,0,0,0,104,GSW,20,27,16,31,0,0,0,94,20121102
2013,LAC,28,24,30,23,0,0,0,105,LAL,23,24,20,28,0,0,0,95,20121102
2013,SAC,18,23,24,15,0,0,0,80,MIN,28,22,20,22,0,0,0,92,20121102
2013,UTA,19,22,22,23,0,0,0,86,NOH,19,21,27,21,0,0,0,88,20121102
2013,MIA,17,27,19,21,0,0,0,84,NYK,33,22,26,23,0,0,0,104,20121102
2013,POR,21,21,24,26,0,0,0,92,OKC,26,23,25,32,0,0,0,106,20121102
2013,DEN,18,19,31,21,0,0,0,89,ORL,29,29,20,24,0,0,0,102,20121102
2013,DET,28,18,17,26,0,0,0,89,PHO,24,30,17,21,0,0,0,92,20121102
2013,TOR,35,17,26,22,0,0,0,100,BRK,27,33,24,23,0,0,0,107,20121103
2013,NOH,21,25,20,23,0,0,0,89,CHI,18,26,16,22,0,0,0,82,20121103
2013,CHA,19,34,28,18,0,0,0,99,DAL,31,30,36,29,0,0,0,126,20121103
2013,POR,17,20,27,17,14,0,0,95,HOU,19,26,18,18,4,0,0,85,20121103
2013,SAC,24,18,24,25,5,2,0,98,IND,18,38,18,17,5,10,0,106,20121103
2013,GSW,33,24,28,29,0,0,0,114,LAC,24,29,26,31,0,0,0,110,20121103
2013,DEN,34,32,25,25,0,0,0,116,MIA,35,29,23,32,0,0,0,119,20121103
2013,CLE,27,22,30,23,0,0,0,102,MIL,23,32,21,29,0,0,0,105,20121103
2013,UTA,17,27,35,21,0,0,0,100,SAS,28,34,17,31,0,0,0,110,20121103
2013,BOS,26,23,22,18,0,0,0,89,WAS,12,30,25,19,0,0,0,86,20121103
2013,DET,13,21,21,24,0,0,0,79,LAL,34,28,24,22,0,0,0,108,20121104
2013,PHI,25,19,22,18,0,0,0,84,NYK,31,26,18,25,0,0,0,100,20121104
2013,ATL,30,17,28,29,0,0,0,104,OKC,22,29,23,21,0,0,0,95,20121104
2013,PHO,33,23,20,18,0,0,0,94,ORL,26,20,40,29,0,0,0,115,20121104
2013,MIN,24,23,26,13,0,0,0,86,TOR,25,31,23,26,0,0,0,105,20121104
2013,MIN,27,20,28,32,0,0,0,107,BRK,31,31,24,10,0,0,0,96,20121105
2013,POR,27,28,24,12,0,0,0,91,DAL,31,26,26,31,0,0,0,114,20121105
2013,CLE,31,26,27,24,0,0,0,108,LAC,28,22,28,23,0,0,0,101,20121105
2013,UTA,25,25,18,26,0,0,0,94,MEM,18,29,27,29,0,0,0,103,20121105
2013,PHO,25,28,21,25,0,0,0,99,MIA,34,31,33,26,0,0,0,124,20121105
2013,NYK,25,31,33,21,0,0,0,110,PHI,21,27,20,20,0,0,0,88,20121105
2013,GSW,22,22,20,28,0,0,0,92,SAC,21,31,23,19,0,0,0,94,20121105
2013,IND,18,20,22,19,0,0,0,79,SAS,26,21,26,28,0,0,0,101,20121105
2013,ORL,24,24,22,23,0,0,0,93,CHI,23,22,23,31,0,0,0,99,20121106
2013,DET,21,30,25,21,0,0,0,97,DEN,24,34,27,24,0,0,0,109,20121106
2013,TOR,17,21,25,25,0,0,0,88,OKC,30,27,28,23,0,0,0,108,20121106
2013,IND,25,25,27,9,0,0,0,86,ATL,22,29,14,24,0,0,0,89,20121107
2013,WAS,16,26,16,30,6,0,0,94,BOS,21,16,29,22,12,0,0,100,20121107
2013,PHO,31,29,25,32,0,0,0,117,CHA,22,24,35,29,0,0,0,110,20121107
2013,TOR,24,26,24,30,0,0,0,104,DAL,36,25,21,27,0,0,0,109,20121107
2013,CLE,21,30,23,22,0,0,0,96,GSW,37,22,26,21,0,0,0,106,20121107
2013,DEN,25,31,13,24,0,0,0,93,HOU,18,23,23,23,0,0,0,87,20121107
2013,SAS,16,25,21,22,0,0,0,84,LAC,22,25,35,24,0,0,0,106,20121107
2013,BRK,22,19,15,17,0,0,0,73,MIA,26,24,29,24,0,0,0,103,20121107
2013,MEM,23,33,25,27,0,0,0,108,MIL,22,21,25,22,0,0,0,90,20121107
2013,ORL,12,22,21,20,0,0,0,75,MIN,25,13,30,22,0,0,0,90,20121107
2013,PHI,16,20,21,20,0,0,0,77,NOH,19,18,10,15,0,0,0,62,20121107
2013,DET,27,19,25,32,0,0,0,103,SAC,26,29,24,26,0,0,0,105,20121107
2013,LAL,17,24,16,29,0,0,0,86,UTA,25,26,14,30,0,0,0,95,20121107
2013,OKC,24,24,18,31,0,0,0,97,CHI,24,23,25,19,0,0,0,91,20121108
2013,LAC,29,31,17,26,0,0,0,103,POR,22,17,32,19,0,0,0,90,20121108
2013,MIA,25,17,30,23,0,0,0,95,ATL,25,21,25,18,0,0,0,89,20121109
2013,PHI,23,34,26,23,0,0,0,106,BOS,20,25,29,26,0,0,0,100,20121109
2013,UTA,27,11,19,27,0,0,0,84,DEN,26,27,20,31,0,0,0,104,20121109
2013,GSW,22,16,17,22,0,0,0,77,LAL,23,24,25,29,0,0,0,101,20121109
2013,HOU,24,22,22,17,0,0,0,85,MEM,17,25,27,24,0,0,0,93,20121109
2013,IND,19,24,21,30,0,0,0,94,MIN,21,21,27,27,0,0,0,96,20121109
2013,CHA,21,28,20,30,0,0,0,99,NOH,24,35,19,29,0,0,0,107,20121109
2013,DAL,23,34,21,16,0,0,0,94,NYK,25,30,29,20,0,0,0,104,20121109
2013,DET,19,23,27,25,0,0,0,94,OKC,18,31,25,31,0,0,0,105,20121109
2013,BRK,19,31,25,32,0,0,0,107,ORL,17,19,15,17,0,0,0,68,20121109
2013,CLE,37,25,21,22,0,0,0,105,PHO,16,33,27,31,0,0,0,107,20121109
2013,SAS,24,23,22,28,0,0,0,97,SAC,27,12,29,18,0,0,0,86,20121109
2013,MIL,30,26,19,26,0,0,0,101,WAS,28,19,25,19,0,0,0,91,20121109
2013,DAL,21,34,18,18,6,0,0,97,CHA,24,20,24,23,10,0,0,101,20121110
2013,MIN,19,22,18,21,0,0,0,80,CHI,20,20,23,24,0,0,0,87,20121110
2013,DEN,24,16,22,24,8,13,0,107,GSW,13,26,20,27,8,7,0,101,20121110
2013,DET,15,26,16,25,0,0,0,82,HOU,20,27,25,24,0,0,0,96,20121110
2013,WAS,22,27,23,13,0,0,0,85,IND,23,26,21,19,0,0,0,89,20121110
2013,BOS,20,19,25,32,0,0,0,96,MIL,22,20,26,24,0,0,0,92,20121110
2013,SAS,26,17,30,39,0,0,0,112,POR,26,26,27,30,0,0,0,109,20121110
2013,PHI,20,32,17,24,0,0,0,93,TOR,26,7,29,21,0,0,0,83,20121110
2013,PHO,19,24,18,20,0,0,0,81,UTA,29,21,27,17,0,0,0,94,20121110
2013,ORL,17,18,18,21,0,0,0,74,BRK,35,15,13,19,0,0,0,82,20121111
2013,ATL,19,18,23,16,0,0,0,76,LAC,18,21,26,24,0,0,0,89,20121111
2013,SAC,22,26,18,24,0,0,0,90,LAL,29,28,22,24,0,0,0,103,20121111
2013,MIA,21,20,25,20,0,0,0,86,MEM,22,34,20,28,0,0,0,104,20121111
2013,CLE,21,25,27,18,0,0,0,91,OKC,27,30,22,27,0,0,0,106,20121111
2013,BOS,33,25,24,19,0,0,0,101,CHI,27,19,24,25,0,0,0,95,20121112
2013,MIN,25,20,21,24,0,0,0,90,DAL,17,22,19,24,0,0,0,82,20121112
2013,OKC,25,20,17,30,0,0,0,92,DET,23,28,22,17,0,0,0,90,20121112
2013,MIA,25,31,26,31,0,0,0,113,HOU,19,33,33,25,0,0,0,110,20121112
2013,MIL,34,28,21,22,0,0,0,105,PHI,26,24,33,13,0,0,0,96,20121112
2013,DEN,27,30,21,22,0,0,0,100,PHO,23,31,29,27,0,0,0,110,20121112
2013,ATL,28,28,19,20,0,0,0,95,POR,22,25,20,20,0,0,0,87,20121112
2013,UTA,26,26,30,22,11,10,15,140,TOR,28,29,30,17,11,10,8,133,20121112
2013,CLE,30,12,33,26,0,0,0,101,BRK,29,35,21,29,0,0,0,114,20121113
2013,WAS,27,12,22,15,0,0,0,76,CHA,23,29,18,22,0,0,0,92,20121113
2013,TOR,29,17,23,5,0,0,0,74,IND,21,15,22,14,0,0,0,72,20121113
2013,SAS,18,20,22,24,0,0,0,84,LAL,24,19,16,23,0,0,0,82,20121113
2013,NYK,27,22,28,22,0,0,0,99,ORL,23,30,23,13,0,0,0,89,20121113
2013,POR,25,21,28,29,0,0,0,103,SAC,18,24,16,28,0,0,0,86,20121113
2013,UTA,25,21,24,23,0,0,0,93,BOS,20,24,29,25,0,0,0,98,20121114
2013,WAS,19,26,22,34,0,0,0,101,DAL,23,40,22,22,0,0,0,107,20121114
2013,ATL,21,25,14,28,0,0,0,88,GSW,22,32,17,21,0,0,0,92,20121114
2013,NOH,27,18,31,20,0,0,0,96,HOU,25,39,21,15,0,0,0,100,20121114
2013,MIA,24,30,20,26,0,0,0,100,LAC,25,27,33,22,0,0,0,107,20121114
2013,IND,17,17,19,32,0,0,0,85,MIL,33,27,22,17,0,0,0,99,20121114
2013,CHA,28,23,18,20,0,0,0,89,MIN,24,14,15,34,0,0,0,87,20121114
2013,MEM,20,36,25,26,0,0,0,107,OKC,30,15,26,26,0,0,0,97,20121114
2013,DET,23,29,17,25,0,0,0,94,PHI,17,17,20,22,0,0,0,76,20121114
2013,CHI,29,28,26,17,12,0,0,112,PHO,27,24,18,31,6,0,0,106,20121114
2013,BOS,26,24,29,18,0,0,0,97,BRK,31,28,15,28,0,0,0,102,20121115
2013,MIA,28,26,25,19,0,0,0,98,DEN,20,22,24,27,0,0,0,93,20121115
2013,NYK,33,22,17,32,0,0,0,104,SAS,31,26,19,24,0,0,0,100,20121115
2013,ORL,22,22,27,39,0,0,0,110,DET,25,25,25,31,0,0,0,106,20121116
2013,DAL,24,25,18,16,0,0,0,83,IND,24,24,28,27,0,0,0,103,20121116
2013,PHO,30,27,27,18,0,0,0,102,LAL,35,27,30,22,0,0,0,114,20121116
2013,NYK,25,24,18,28,0,0,0,95,MEM,29,25,31,20,0,0,0,105,20121116
2013,GSW,22,31,29,24,0,0,0,106,MIN,27,23,19,29,0,0,0,98,20121116
2013,OKC,36,30,28,16,0,0,0,110,NOH,18,19,30,28,0,0,0,95,20121116
2013,UTA,20,23,21,29,0,0,0,93,PHI,30,22,19,28,0,0,0,99,20121116
2013,HOU,27,31,21,32,6,0,0,117,POR,22,29,27,33,8,0,0,119,20121116
2013,ATL,34,24,28,26,0,0,0,112,SAC,20,36,14,26,0,0,0,96,20121116
2013,TOR,17,25,22,25,0,0,0,89,BOS,30,17,32,28,0,0,0,107,20121117
2013,MEM,25,22,28,19,0,0,0,94,CHA,19,19,22,27,0,0,0,87,20121117
2013,DAL,24,27,24,28,0,0,0,103,CLE,24,28,21,22,0,0,0,95,20121117
2013,CHI,15,25,21,19,0,0,0,80,LAC,18,35,25,23,0,0,0,101,20121117
2013,NOH,27,31,33,22,0,0,0,113,MIL,25,35,31,26,0,0,0,117,20121117
2013,MIA,23,29,23,22,0,0,0,97,PHO,23,29,19,17,0,0,0,88,20121117
2013,DEN,15,25,28,32,0,0,0,100,SAS,33,27,30,36,0,0,0,126,20121117
2013,UTA,15,23,27,18,0,0,0,83,WAS,17,23,23,13,0,0,0,76,20121117
2013,BOS,25,18,14,26,0,0,0,83,DET,23,25,23,32,0,0,0,103,20121118
2013,HOU,29,31,27,21,0,0,0,108,LAL,40,28,30,21,0,0,0,119,20121118
2013,IND,18,12,26,20,0,0,0,76,NYK,21,20,27,20,0,0,0,88,20121118
2013,GSW,25,21,27,36,0,0,0,109,OKC,26,33,35,25,0,0,0,119,20121118
2013,CLE,21,21,15,22,0,0,0,79,PHI,19,24,19,24,0,0,0,86,20121118
2013,CHI,30,13,25,26,0,0,0,94,POR,23,28,22,29,0,0,0,102,20121118
2013,BRK,21,33,20,25,0,0,0,99,SAC,20,22,23,25,0,0,0,90,20121118
2013,ORL,22,19,28,17,0,0,0,86,TOR,32,17,18,30,0,0,0,97,20121118
2013,ORL,23,14,12,23,0,0,0,72,ATL,21,20,24,16,0,0,0,81,20121119
2013,MIL,23,31,27,17,0,0,0,98,CHA,30,25,22,25,0,0,0,102,20121119
2013,GSW,23,20,24,23,15,0,0,105,DAL,20,18,27,25,11,0,0,101,20121119
2013,DEN,27,25,17,28,0,0,0,97,MEM,26,23,21,22,0,0,0,92,20121119
2013,LAC,18,29,24,21,0,0,0,92,SAS,28,14,21,24,0,0,0,87,20121119
2013,HOU,26,18,26,21,0,0,0,91,UTA,29,32,24,17,0,0,0,102,20121119
2013,IND,28,22,21,25,0,0,0,96,WAS,13,28,26,22,0,0,0,89,20121119
2013,BRK,23,34,16,17,0,0,0,90,LAL,29,27,20,19,0,0,0,95,20121120
2013,NYK,29,24,30,19,0,0,0,102,NOH,17,31,16,16,0,0,0,80,20121120
2013,TOR,29,22,29,18,0,0,0,98,PHI,22,29,22,33,0,0,0,106,20121120
2013,WAS,24,23,19,24,10,0,0,100,ATL,26,24,18,22,11,0,0,101,20121121
2013,SAS,30,26,26,30,0,0,0,112,BOS,27,21,26,26,0,0,0,100,20121121
2013,TOR,25,28,21,23,0,0,0,97,CHA,22,31,22,23,0,0,0,98,20121121
2013,PHI,15,20,23,25,0,0,0,83,CLE,28,19,21,24,0,0,0,92,20121121
2013,NYK,28,26,26,31,0,0,0,111,DAL,24,25,35,30,0,0,0,114,20121121
2013,BRK,30,16,20,27,0,0,0,93,GSW,18,23,33,28,0,0,0,102,20121121
2013,CHI,22,24,19,24,0,0,0,89,HOU,20,22,24,27,0,0,0,93,20121121
2013,NOH,29,18,27,23,10,0,0,107,IND,21,22,32,22,18,0,0,115,20121121
2013,MIL,15,29,29,25,8,0,0,106,MIA,29,17,25,27,15,0,0,113,20121121
2013,DEN,15,29,25,32,0,0,0,101,MIN,26,32,15,21,0,0,0,94,20121121
2013,LAC,22,27,20,33,9,0,0,111,OKC,28,31,17,26,15,0,0,117,20121121
2013,DET,27,21,8,18,0,0,0,74,ORL,21,24,26,19,0,0,0,90,20121121
2013,POR,25,19,27,16,0,0,0,87,PHO,29,28,32,25,0,0,0,114,20121121
2013,LAL,21,20,28,28,0,0,0,97,SAC,15,27,31,40,0,0,0,113,20121121
2013,OKC,28,17,20,35,0,0,0,100,BOS,21,27,29,31,0,0,0,108,20121123
2013,LAC,25,22,16,13,0,0,0,76,BRK,25,15,23,23,0,0,0,86,20121123
2013,ATL,30,27,23,21,0,0,0,101,CHA,23,28,23,17,0,0,0,91,20121123
2013,GSW,21,32,17,21,0,0,0,91,DEN,23,24,31,24,0,0,0,102,20121123
2013,TOR,20,23,25,22,0,0,0,90,DET,21,26,25,19,0,0,0,91,20121123
2013,NYK,32,25,23,23,0,0,0,103,HOU,35,37,32,27,0,0,0,131,20121123
2013,SAS,28,20,25,31,0,0,0,104,IND,25,27,25,20,0,0,0,97,20121123
2013,LAL,18,31,21,28,0,0,0,98,MEM,34,22,26,24,0,0,0,106,20121123
2013,CLE,26,25,25,28,0,0,0,104,ORL,24,21,31,32,0,0,0,108,20121123
2013,NOH,31,22,28,22,5,0,0,108,PHO,23,24,30,26,8,0,0,111,20121123
2013,MIN,33,22,23,17,0,0,0,95,POR,28,22,31,22,0,0,0,103,20121123
2013,SAC,32,21,27,22,0,0,0,102,UTA,28,24,21,31,0,0,0,104,20121123
2013,LAC,24,17,19,33,0,0,0,93,ATL,21,30,34,19,0,0,0,104,20121124
2013,LAL,36,29,24,26,0,0,0,115,DAL,23,15,27,24,0,0,0,89,20121124
2013,MIN,18,33,23,11,0,0,0,85,GSW,16,31,23,26,0,0,0,96,20121124
2013,CLE,29,30,20,29,0,0,0,108,MIA,26,22,29,33,0,0,0,110,20121124
2013,CHI,28,24,20,21,0,0,0,93,MIL,30,22,17,17,0,0,0,86,20121124
2013,OKC,29,21,35,13,18,0,0,116,PHI,21,28,30,19,11,0,0,109,20121124
2013,UTA,29,27,19,22,0,0,0,97,SAC,23,28,32,25,0,0,0,108,20121124
2013,CHA,25,25,22,20,7,9,0,108,WAS,24,27,21,20,7,7,0,106,20121124
2013,POR,27,23,20,15,0,0,0,85,BRK,25,21,24,28,0,0,0,98,20121125
2013,NOH,23,18,20,23,0,0,0,84,DEN,26,25,32,19,0,0,0,102,20121125
2013,DET,22,22,28,28,0,0,0,100,NYK,32,32,22,35,0,0,0,121,20121125
2013,BOS,28,30,22,22,14,0,0,116,ORL,22,26,34,20,8,0,0,110,20121125
2013,PHO,20,21,34,26,0,0,0,101,PHI,23,23,34,24,0,0,0,104,20121125
2013,SAS,24,25,20,19,9,14,0,111,TOR,25,24,21,18,9,9,0,106,20121125
2013,NYK,23,24,20,17,5,0,0,89,BRK,26,19,23,16,12,0,0,96,20121126
2013,MIL,19,21,23,30,0,0,0,93,CHI,26,24,30,12,0,0,0,92,20121126
2013,POR,19,30,24,28,0,0,0,101,DET,28,26,28,26,0,0,0,108,20121126
2013,NOH,22,29,30,24,0,0,0,105,LAC,19,25,26,28,0,0,0,98,20121126
2013,CLE,27,20,22,9,0,0,0,78,MEM,24,18,20,22,0,0,0,84,20121126
2013,CHA,12,12,19,26,0,0,0,69,OKC,28,36,24,26,0,0,0,114,20121126
2013,DEN,35,30,19,19,0,0,0,103,UTA,24,30,30,21,0,0,0,105,20121126
2013,SAS,29,31,32,26,0,0,0,118,WAS,25,23,22,22,0,0,0,92,20121126
2013,PHO,19,18,34,20,0,0,0,91,CLE,13,19,27,19,0,0,0,78,20121127
2013,TOR,23,28,28,22,0,0,0,101,HOU,29,32,38,18,0,0,0,117,20121127
2013,IND,25,15,21,18,0,0,0,79,LAL,21,12,24,20,0,0,0,77,20121127
2013,DAL,31,25,17,25,0,0,0,98,PHI,28,25,22,25,0,0,0,100,20121127
2013,MIN,27,21,27,22,0,0,0,97,SAC,26,19,22,22,0,0,0,89,20121127
2013,CHA,18,27,20,26,0,0,0,91,ATL,20,23,28,23,0,0,0,94,20121128
2013,BRK,28,23,19,25,0,0,0,95,BOS,20,18,17,28,0,0,0,83,20121128
2013,DAL,23,19,16,20,0,0,0,78,CHI,24,34,19,24,0,0,0,101,20121128
2013,PHO,24,20,16,17,0,0,0,77,DET,24,31,26,36,0,0,0,117,20121128
2013,MIN,28,27,22,18,0,0,0,95,LAC,23,34,19,25,0,0,0,101,20121128
2013,TOR,27,20,14,21,0,0,0,82,MEM,24,24,33,22,0,0,0,103,20121128
2013,NYK,23,35,30,14,0,0,0,102,MIL,26,22,22,18,0,0,0,88,20121128
2013,UTA,20,21,31,24,0,0,0,96,NOH,20,19,17,28,0,0,0,84,20121128
2013,HOU,25,20,29,24,0,0,0,98,OKC,27,30,29,34,0,0,0,120,20121128
2013,SAS,29,26,26,29,0,0,0,110,ORL,18,23,23,25,0,0,0,89,20121128
2013,POR,27,16,16,23,0,0,0,82,WAS,23,20,25,16,0,0,0,84,20121128
2013,DEN,25,35,26,19,0,0,0,105,GSW,30,21,27,28,0,0,0,106,20121129
2013,SAS,27,17,32,24,0,0,0,100,MIA,22,25,26,32,0,0,0,105,20121129
2013,CLE,27,29,26,31,0,0,0,113,ATL,29,38,24,20,0,0,0,111,20121130
2013,POR,18,15,26,19,0,0,0,78,BOS,25,31,19,21,0,0,0,96,20121130
2013,PHI,27,27,22,28,0,0,0,104,CHA,25,25,23,25,0,0,0,98,20121130
2013,DEN,27,30,25,21,0,0,0,103,LAL,34,37,26,25,0,0,0,122,20121130
2013,DET,21,24,21,12,0,0,0,78,MEM,22,31,23,14,0,0,0,90,20121130
2013,MIL,30,17,16,22,0,0,0,85,MIN,29,28,11,27,0,0,0,95,20121130
2013,WAS,17,29,19,22,0,0,0,87,NYK,26,31,29,22,0,0,0,108,20121130
2013,UTA,20,22,25,27,0,0,0,94,OKC,22,32,29,23,0,0,0,106,20121130
2013,BRK,25,20,31,22,0,0,0,98,ORL,21,23,21,21,0,0,0,86,20121130
2013,IND,20,23,29,25,0,0,0,97,SAC,17,23,27,25,0,0,0,92,20121130
2013,PHO,25,27,24,21,0,0,0,97,TOR,19,32,29,21,0,0,0,101,20121130
2013,PHI,19,22,23,24,0,0,0,88,CHI,22,19,26,26,0,0,0,93,20121201
2013,POR,21,26,23,21,12,15,0,118,CLE,28,20,26,17,12,14,0,117,20121201
2013,DET,27,21,11,18,0,0,0,77,DAL,24,18,25,25,0,0,0,92,20121201
2013,IND,20,24,28,20,0,0,0,92,GSW,20,31,31,21,0,0,0,103,20121201
2013,UTA,28,21,37,30,0,0,0,116,HOU,28,30,27,39,0,0,0,124,20121201
2013,SAC,17,17,24,23,0,0,0,81,LAC,28,30,29,29,0,0,0,116,20121201
2013,BRK,24,35,19,11,0,0,0,89,MIA,16,34,32,20,0,0,0,102,20121201
2013,BOS,27,21,21,19,0,0,0,88,MIL,11,36,22,22,0,0,0,91,20121201
2013,OKC,30,24,30,16,0,0,0,100,NOH,21,23,13,22,0,0,0,79,20121201
2013,MEM,22,24,27,14,8,0,0,95,SAS,21,24,15,27,12,0,0,99,20121201
2013,ORL,23,29,21,40,0,0,0,113,LAL,27,25,25,26,0,0,0,103,20121202
2013,PHO,20,22,30,27,0,0,0,99,NYK,24,35,30,17,0,0,0,106,20121202
2013,POR,26,25,19,32,16,0,0,118,CHA,34,20,21,27,10,0,0,112,20121203
2013,TOR,24,20,31,35,0,0,0,110,DEN,29,32,28,24,0,0,0,113,20121203
2013,CLE,17,22,24,16,0,0,0,79,DET,30,26,19,14,0,0,0,89,20121203
2013,ORL,28,23,18,33,0,0,0,102,GSW,27,20,22,25,0,0,0,94,20121203
2013,MIL,28,22,17,14,0,0,0,81,NOH,30,23,24,25,0,0,0,102,20121203
2013,LAC,19,32,22,32,0,0,0,105,UTA,31,27,25,21,0,0,0,104,20121203
2013,OKC,31,30,29,27,0,0,0,117,BRK,28,20,38,25,0,0,0,111,20121204
2013,IND,20,15,25,20,0,0,0,80,CHI,18,19,18,21,0,0,0,76,20121204
2013,LAL,30,28,25,22,0,0,0,105,HOU,22,23,28,34,0,0,0,107,20121204
2013,PHO,25,27,20,22,4,0,0,98,MEM,18,27,23,26,14,0,0,108,20121204
2013,MIN,34,31,22,18,0,0,0,105,PHI,21,26,20,21,0,0,0,88,20121204
2013,MIA,25,29,24,23,0,0,0,101,WAS,30,30,22,23,0,0,0,105,20121204
2013,DEN,26,25,27,26,0,0,0,104,ATL,27,28,30,23,0,0,0,108,20121205
2013,MIN,30,21,21,22,0,0,0,94,BOS,27,20,32,25,0,0,0,104,20121205
2013,NYK,26,25,21,28,0,0,0,100,CHA,24,29,22,23,0,0,0,98,20121205
2013,CHI,27,18,27,23,0,0,0,95,CLE,11,24,28,22,0,0,0,85,20121205
2013,GSW,21,19,39,25,0,0,0,104,DET,20,18,23,36,0,0,0,97,20121205
2013,POR,21,29,14,28,0,0,0,92,IND,20,28,31,20,0,0,0,99,20121205
2013,DAL,18,24,26,22,0,0,0,90,LAC,29,31,23,29,0,0,0,112,20121205
2013,LAL,20,27,30,26,0,0,0,103,NOH,23,25,16,23,0,0,0,87,20121205
2013,TOR,29,18,29,24,0,0,0,100,SAC,29,26,23,29,0,0,0,107,20121205
2013,MIL,32,26,18,23,0,0,0,99,SAS,29,23,24,34,0,0,0,110,20121205
2013,ORL,15,19,23,24,0,0,0,81,UTA,24,21,23,19,0,0,0,87,20121205
2013,NYK,23,30,37,22,0,0,0,112,MIA,26,27,27,12,0,0,0,92,20121206
2013,DAL,23,17,29,28,0,0,0,97,PHO,23,21,18,32,0,0,0,94,20121206
2013,WAS,19,22,30,24,0,0,0,95,ATL,31,23,26,24,0,0,0,104,20121207
2013,GSW,24,31,29,25,0,0,0,109,BRK,31,32,19,20,0,0,0,102,20121207
2013,CHI,26,24,28,30,0,0,0,108,DET,30,25,19,30,0,0,0,104,20121207
2013,DEN,22,29,18,23,0,0,0,92,IND,28,22,18,21,0,0,0,89,20121207
2013,CHA,20,20,21,32,0,0,0,93,MIL,33,25,28,22,0,0,0,108,20121207
2013,CLE,16,21,20,16,0,0,0,73,MIN,25,19,22,25,0,0,0,91,20121207
2013,MEM,22,29,20,25,0,0,0,96,NOH,17,22,27,23,0,0,0,89,20121207
2013,LAL,27,26,22,33,0,0,0,108,OKC,26,41,22,25,0,0,0,114,20121207
2013,BOS,28,22,20,19,5,0,0,94,PHI,28,18,26,17,6,0,0,95,20121207
2013,ORL,16,18,30,18,0,0,0,82,SAC,25,21,16,29,0,0,0,91,20121207
2013,HOU,21,24,21,26,0,0,0,92,SAS,29,28,30,27,0,0,0,114,20121207
2013,TOR,29,23,24,23,0,0,0,99,UTA,25,38,32,36,0,0,0,131,20121207
2013,PHI,16,12,29,22,0,0,0,79,BOS,24,24,22,22,0,0,0,92,20121208
2013,SAS,32,27,38,35,0,0,0,132,CHA,23,21,23,35,0,0,0,102,20121208
2013,NYK,23,18,24,20,0,0,0,85,CHI,26,17,24,26,0,0,0,93,20121208
2013,DET,25,24,27,28,0,0,0,104,CLE,22,30,18,27,0,0,0,97,20121208
2013,DAL,39,24,21,32,0,0,0,116,HOU,24,42,23,20,0,0,0,109,20121208
2013,PHO,31,26,26,16,0,0,0,99,LAC,28,35,22,32,0,0,0,117,20121208
2013,ATL,21,20,32,20,0,0,0,93,MEM,22,25,13,23,0,0,0,83,20121208
2013,NOH,32,15,25,18,0,0,0,90,MIA,31,33,22,20,0,0,0,106,20121208
2013,SAC,30,13,34,22,0,0,0,99,POR,18,23,24,15,0,0,0,80,20121208
2013,GSW,28,22,21,30,0,0,0,101,WAS,21,26,23,27,0,0,0,97,20121208
2013,MIL,25,23,27,22,0,0,0,97,BRK,18,13,24,33,0,0,0,88,20121209
2013,TOR,21,26,26,10,0,0,0,83,LAC,25,19,33,25,0,0,0,102,20121209
2013,UTA,25,35,28,29,0,0,0,117,LAL,27,24,34,25,0,0,0,110,20121209
2013,DEN,25,33,26,22,0,0,0,106,NYK,23,38,19,32,0,0,0,112,20121209
2013,IND,22,34,18,19,0,0,0,93,OKC,25,32,27,20,0,0,0,104,20121209
2013,ORL,20,33,18,27,0,0,0,98,PHO,23,25,22,20,0,0,0,90,20121209
2013,GSW,38,20,35,11,0,0,0,104,CHA,23,17,34,22,0,0,0,96,20121210
2013,SAC,29,14,27,26,0,0,0,96,DAL,36,29,23,31,0,0,0,119,20121210
2013,SAS,23,41,27,29,14,0,0,134,HOU,27,36,30,27,6,0,0,126,20121210
2013,ATL,26,28,20,18,0,0,0,92,MIA,28,28,26,19,0,0,0,101,20121210
2013,DET,21,28,26,22,0,0,0,97,PHI,25,21,30,28,0,0,0,104,20121210
2013,TOR,19,21,19,15,0,0,0,74,POR,18,26,20,28,0,0,0,92,20121210
2013,NYK,16,33,25,26,0,0,0,100,BRK,30,23,26,18,0,0,0,97,20121211
2013,LAC,21,26,22,25,0,0,0,94,CHI,18,22,25,24,0,0,0,89,20121211
2013,LAL,23,16,23,32,0,0,0,94,CLE,29,25,14,32,0,0,0,100,20121211
2013,DEN,17,31,24,29,0,0,0,101,DET,25,17,24,28,0,0,0,94,20121211
2013,WAS,11,25,20,21,0,0,0,77,NOH,22,20,18,10,0,0,0,70,20121211
2013,DAL,25,18,27,26,9,10,0,115,BOS,27,21,28,20,9,12,0,117,20121212
2013,LAC,23,26,29,22,0,0,0,100,CHA,21,23,27,23,0,0,0,94,20121212
2013,WAS,17,25,22,29,0,0,0,93,HOU,27,18,23,31,0,0,0,99,20121212
2013,CLE,29,29,12,11,0,0,0,81,IND,25,27,28,16,0,0,0,96,20121212
2013,GSW,29,24,24,20,0,0,0,97,MIA,28,24,22,21,0,0,0,95,20121212
2013,SAC,19,20,23,23,0,0,0,85,MIL,29,20,19,30,0,0,0,98,20121212
2013,DEN,29,21,20,35,0,0,0,105,MIN,21,30,26,31,0,0,0,108,20121212
2013,NOH,19,25,18,26,0,0,0,88,OKC,17,19,22,34,0,0,0,92,20121212
2013,ATL,20,26,26,14,0,0,0,86,ORL,15,19,26,20,0,0,0,80,20121212
2013,CHI,21,20,28,27,0,0,0,96,PHI,24,20,22,23,0,0,0,89,20121212
2013,MEM,27,19,17,17,0,0,0,80,PHO,21,22,20,19,0,0,0,82,20121212
2013,BRK,20,17,31,26,0,0,0,94,TOR,27,18,19,24,0,0,0,88,20121212
2013,SAS,28,16,27,25,0,0,0,96,UTA,22,31,18,28,0,0,0,99,20121212
2013,CHA,19,24,31,16,0,0,0,90,ATL,30,30,31,22,0,0,0,113,20121213
2013,LAL,27,22,31,27,0,0,0,107,NYK,41,27,25,23,0,0,0,116,20121213
2013,SAS,21,24,24,21,0,0,0,90,POR,23,26,27,22,0,0,0,98,20121213
2013,DET,25,22,30,13,10,5,0,105,BRK,23,36,14,17,10,7,0,107,20121214
2013,MIL,25,27,20,18,0,0,0,90,CLE,17,26,24,19,0,0,0,86,20121214
2013,MEM,16,25,28,25,0,0,0,94,DEN,17,28,24,30,0,0,0,99,20121214
2013,BOS,19,26,25,19,0,0,0,89,HOU,27,16,32,26,0,0,0,101,20121214
2013,PHI,20,24,22,19,0,0,0,85,IND,25,17,29,24,0,0,0,95,20121214
2013,MIN,28,22,32,31,0,0,0,113,NOH,23,27,23,29,0,0,0,102,20121214
2013,SAC,26,16,26,35,0,0,0,103,OKC,29,32,21,31,0,0,0,113,20121214
2013,GSW,14,21,29,21,0,0,0,85,ORL,19,32,30,18,0,0,0,99,20121214
2013,UTA,22,20,23,19,0,0,0,84,PHO,34,22,21,22,0,0,0,99,20121214
2013,DAL,25,16,14,19,0,0,0,74,TOR,24,30,15,26,0,0,0,95,20121214
2013,LAL,27,31,25,19,0,0,0,102,WAS,25,30,14,27,0,0,0,96,20121214
2013,GSW,26,36,26,27,0,0,0,115,ATL,26,23,19,25,0,0,0,93,20121215
2013,ORL,29,27,25,26,0,0,0,107,CHA,21,27,29,21,0,0,0,98,20121215
2013,BRK,24,17,21,20,0,0,0,82,CHI,23,23,21,16,0,0,0,83,20121215
2013,IND,26,16,21,25,0,0,0,88,DET,22,16,22,17,0,0,0,77,20121215
2013,WAS,14,22,10,26,0,0,0,72,MIA,26,24,29,23,0,0,0,102,20121215
2013,LAC,28,27,24,32,0,0,0,111,MIL,15,20,27,23,0,0,0,85,20121215
2013,DAL,32,13,25,32,4,0,0,106,MIN,22,32,26,22,12,0,0,114,20121215
2013,CLE,28,17,28,29,0,0,0,102,NYK,27,21,30,25,0,0,0,103,20121215
2013,BOS,21,28,20,19,0,0,0,88,SAS,26,26,25,26,0,0,0,103,20121215
2013,MEM,19,25,28,27,0,0,0,99,UTA,21,33,10,22,0,0,0,86,20121215
2013,LAL,28,32,27,24,0,0,0,111,PHI,24,26,23,25,0,0,0,98,20121216
2013,NOH,19,24,20,31,0,0,0,94,POR,25,29,21,20,0,0,0,95,20121216
2013,DEN,32,32,33,25,0,0,0,122,SAC,23,23,21,30,0,0,0,97,20121216
2013,HOU,28,21,22,25,0,0,0,96,TOR,26,23,28,26,0,0,0,103,20121216
2013,LAC,21,21,21,25,0,0,0,88,DET,20,20,20,16,0,0,0,76,20121217
2013,CHI,20,14,19,18,0,0,0,71,MEM,11,28,22,19,0,0,0,80,20121217
2013,HOU,29,27,27,26,0,0,0,109,NYK,31,11,18,36,0,0,0,96,20121217
2013,SAS,26,22,16,29,0,0,0,93,OKC,30,23,29,25,0,0,0,107,20121217
2013,MIN,29,32,17,15,0,0,0,93,ORL,27,22,25,28,0,0,0,102,20121217
2013,SAC,22,32,14,22,0,0,0,90,PHO,16,27,31,27,0,0,0,101,20121217
2013,UTA,20,24,26,22,0,0,0,92,BRK,24,33,17,16,0,0,0,90,20121218
2013,BOS,23,25,22,19,0,0,0,89,CHI,28,27,24,21,0,0,0,100,20121218
2013,TOR,22,27,29,35,0,0,0,113,CLE,29,24,23,23,0,0,0,99,20121218
2013,PHI,23,29,22,26,0,0,0,100,DAL,28,29,19,31,0,0,0,107,20121218
2013,SAS,28,20,27,31,0,0,0,106,DEN,26,29,35,22,0,0,0,112,20121218
2013,NOH,21,29,22,24,0,0,0,96,GSW,31,28,23,21,0,0,0,103,20121218
2013,CHA,25,33,26,16,0,0,0,100,LAL,27,26,24,24,0,0,0,101,20121218
2013,MIN,27,22,23,20,0,0,0,92,MIA,21,31,28,23,0,0,0,103,20121218
2013,IND,25,23,18,27,0,0,0,93,MIL,21,24,27,26,0,0,0,98,20121218
2013,ATL,28,24,20,18,10,0,0,100,WAS,22,24,23,21,5,0,0,95,20121218
2013,OKC,23,32,18,27,0,0,0,100,ATL,20,21,25,26,0,0,0,92,20121219
2013,CLE,25,21,26,19,0,0,0,91,BOS,27,27,28,21,0,0,0,103,20121219
2013,PHI,24,27,28,24,0,0,0,103,HOU,33,23,33,36,0,0,0,125,20121219
2013,UTA,23,8,20,33,0,0,0,84,IND,31,22,23,28,0,0,0,104,20121219
2013,NOH,16,22,18,21,0,0,0,77,LAC,22,26,27,18,0,0,0,93,20121219
2013,MIL,22,12,17,29,0,0,0,80,MEM,21,22,23,24,0,0,0,90,20121219
2013,BRK,23,25,19,19,0,0,0,86,NYK,26,26,23,25,0,0,0,100,20121219
2013,WAS,26,24,13,20,0,0,0,83,ORL,27,25,24,14,0,0,0,90,20121219
2013,CHA,27,19,22,36,0,0,0,104,PHO,28,36,33,24,0,0,0,121,20121219
2013,GSW,24,31,33,39,0,0,0,127,SAC,33,30,36,32,0,0,0,131,20121219
2013,DET,23,26,22,20,0,0,0,91,TOR,27,22,24,24,0,0,0,97,20121219
2013,MIA,31,27,33,19,0,0,0,110,DAL,20,22,19,34,0,0,0,95,20121220
2013,OKC,18,26,25,24,0,0,0,93,MIN,30,23,23,23,0,0,0,99,20121220
2013,DEN,14,26,21,32,0,0,0,93,POR,25,25,19,32,0,0,0,101,20121220
2013,MIL,17,26,19,26,11,0,0,99,BOS,25,21,24,18,6,0,0,94,20121221
2013,IND,23,21,33,22,0,0,0,99,CLE,23,22,22,22,0,0,0,89,20121221
2013,WAS,14,20,17,17,0,0,0,68,DET,29,24,24,23,0,0,0,100,20121221
2013,CHA,23,26,27,24,0,0,0,100,GSW,31,27,31,26,0,0,0,115,20121221
2013,SAC,21,18,23,23,0,0,0,85,LAC,29,24,20,24,0,0,0,97,20121221
2013,DAL,16,23,18,25,0,0,0,82,MEM,25,15,29,23,0,0,0,92,20121221
2013,CHI,30,24,29,27,0,0,0,110,NYK,23,16,22,45,0,0,0,106,20121221
2013,ATL,23,22,19,16,0,0,0,80,PHI,30,21,21,27,0,0,0,99,20121221
2013,NOH,21,21,19,33,0,0,0,94,SAS,26,28,18,27,0,0,0,99,20121221
2013,ORL,15,24,23,28,0,0,0,90,TOR,20,22,29,22,0,0,0,93,20121221
2013,CHI,21,16,17,21,0,0,0,75,ATL,17,36,25,14,0,0,0,92,20121222
2013,CHA,23,23,19,23,0,0,0,88,DEN,29,35,24,22,0,0,0,110,20121222
2013,LAL,31,22,21,34,10,0,0,118,GSW,27,34,26,21,7,0,0,115,20121222
2013,MEM,32,22,24,18,0,0,0,96,HOU,33,31,30,27,0,0,0,121,20121222
2013,UTA,25,18,20,26,0,0,0,89,MIA,28,19,26,32,0,0,0,105,20121222
2013,CLE,19,27,25,23,0,0,0,94,MIL,19,18,26,19,0,0,0,82,20121222
2013,IND,11,18,24,28,0,0,0,81,NOH,18,28,7,22,0,0,0,75,20121222
2013,PHO,25,28,22,18,0,0,0,93,POR,23,21,31,21,0,0,0,96,20121222
2013,DET,22,32,20,22,0,0,0,96,WAS,13,22,29,23,0,0,0,87,20121222
2013,PHI,17,24,23,28,0,0,0,92,BRK,24,19,26,26,0,0,0,95,20121223
2013,MIN,29,26,18,18,0,0,0,91,NYK,22,24,25,23,0,0,0,94,20121223
2013,UTA,18,28,25,26,0,0,0,97,ORL,30,17,26,20,0,0,0,93,20121223
2013,LAC,28,30,33,12,0,0,0,103,PHO,24,19,17,17,0,0,0,77,20121223
2013,POR,27,15,29,25,0,0,0,96,SAC,21,28,31,28,0,0,0,108,20121223
2013,DAL,26,26,14,25,0,0,0,91,SAS,33,31,36,29,0,0,0,129,20121223
2013,BOS,22,34,17,20,0,0,0,93,BRK,24,18,16,18,0,0,0,76,20121225
2013,HOU,27,31,36,26,0,0,0,120,CHI,22,19,27,29,0,0,0,97,20121225
2013,DEN,26,22,28,24,0,0,0,100,LAC,25,42,26,19,0,0,0,112,20121225
2013,NYK,23,26,29,16,0,0,0,94,LAL,25,26,26,23,0,0,0,100,20121225
2013,OKC,24,24,24,25,0,0,0,97,MIA,27,27,20,29,0,0,0,103,20121225
2013,DET,13,32,17,39,7,11,0,119,ATL,28,22,31,20,7,18,0,126,20121226
2013,MIA,27,28,23,27,0,0,0,105,CHA,18,20,33,21,0,0,0,92,20121226
2013,LAL,26,28,33,27,0,0,0,114,DEN,29,28,39,30,0,0,0,126,20121226
2013,PHI,26,23,26,24,0,0,0,99,MEM,29,18,23,19,0,0,0,89,20121226
2013,BRK,24,18,25,26,0,0,0,93,MIL,22,33,23,30,0,0,0,108,20121226
2013,HOU,22,22,17,26,0,0,0,87,MIN,17,30,17,20,0,0,0,84,20121226
2013,NOH,26,23,29,19,0,0,0,97,ORL,24,29,23,18,0,0,0,94,20121226
2013,NYK,27,27,22,23,0,0,0,99,PHO,29,15,32,21,0,0,0,97,20121226
2013,SAC,26,18,23,24,0,0,0,91,POR,31,31,29,18,0,0,0,109,20121226
2013,TOR,18,19,20,23,0,0,0,80,SAS,22,22,26,30,0,0,0,100,20121226
2013,GSW,24,25,26,19,0,0,0,94,UTA,19,18,21,25,0,0,0,83,20121226
2013,CLE,22,23,23,19,0,0,0,87,WAS,26,17,25,16,0,0,0,84,20121226
2013,BOS,20,27,20,10,0,0,0,77,LAC,30,30,22,24,0,0,0,106,20121227
2013,DAL,29,16,36,17,7,0,0,105,OKC,21,22,30,25,13,0,0,111,20121227
2013,CHA,15,23,20,23,0,0,0,81,BRK,33,23,24,17,0,0,0,97,20121228
2013,ATL,25,30,20,27,0,0,0,102,CLE,26,28,26,14,0,0,0,94,20121228
2013,DEN,29,26,32,19,0,0,0,106,DAL,18,29,23,15,0,0,0,85,20121228
2013,MIA,32,20,19,28,0,0,0,99,DET,17,41,23,28,0,0,0,109,20121228
2013,PHI,24,18,29,18,0,0,0,89,GSW,25,32,23,16,0,0,0,96,20121228
2013,PHO,20,24,27,20,0,0,0,91,IND,27,31,17,22,0,0,0,97,20121228
2013,POR,25,23,18,21,0,0,0,87,LAL,34,28,26,16,0,0,0,104,20121228
2013,TOR,21,27,22,21,13,0,0,104,NOH,23,19,22,27,6,0,0,97,20121228
2013,NYK,23,27,31,24,0,0,0,105,SAC,32,39,16,19,0,0,0,106,20121228
2013,HOU,29,36,27,24,0,0,0,116,SAS,41,28,29,24,0,0,0,122,20121228
2013,LAC,29,19,36,32,0,0,0,116,UTA,22,36,30,26,0,0,0,114,20121228
2013,ORL,31,20,21,25,0,0,0,97,WAS,25,29,26,25,0,0,0,105,20121228
2013,IND,26,22,22,30,0,0,0,100,ATL,33,22,28,26,0,0,0,109,20121229
2013,CLE,24,29,21,26,0,0,0,100,BRK,34,27,18,24,0,0,0,103,20121229
2013,NOH,22,18,33,25,0,0,0,98,CHA,25,32,16,22,0,0,0,95,20121229
2013,WAS,26,13,24,14,0,0,0,77,CHI,22,23,25,17,0,0,0,87,20121229
2013,BOS,23,17,27,16,0,0,0,83,GSW,29,28,19,25,0,0,0,101,20121229
2013,OKC,31,37,28,28,0,0,0,124,HOU,26,24,24,20,0,0,0,94,20121229
2013,DEN,15,21,21,15,0,0,0,72,MEM,19,18,16,28,0,0,0,81,20121229
2013,MIA,20,24,27,14,0,0,0,85,MIL,25,31,13,35,0,0,0,104,20121229
2013,PHO,29,29,29,20,0,0,0,107,MIN,32,32,25,22,0,0,0,111,20121229
2013,TOR,36,31,20,36,0,0,0,123,ORL,21,26,24,17,0,0,0,88,20121229
2013,PHI,23,21,23,18,0,0,0,85,POR,30,19,21,19,0,0,0,89,20121229
2013,SAS,27,30,25,29,0,0,0,111,DAL,22,23,25,16,0,0,0,86,20121230
2013,MIL,23,22,26,23,0,0,0,94,DET,30,25,23,18,0,0,0,96,20121230
2013,UTA,24,21,31,20,0,0,0,96,LAC,29,25,25,28,0,0,0,107,20121230
2013,BOS,18,31,24,23,0,0,0,96,SAC,24,30,30,34,0,0,0,118,20121230
2013,CHA,28,19,18,26,0,0,0,91,CHI,18,24,23,16,0,0,0,81,20121231
2013,ATL,27,19,29,29,0,0,0,104,HOU,26,38,26,33,0,0,0,123,20121231
2013,MEM,19,22,26,16,0,0,0,83,IND,19,19,22,28,0,0,0,88,20121231
2013,PHO,28,25,25,18,0,0,0,96,OKC,32,22,30,30,0,0,0,114,20121231
2013,MIA,31,17,22,29,13,0,0,112,ORL,22,32,23,22,11,0,0,110,20121231
2013,BRK,22,25,5,21,0,0,0,73,SAS,31,24,30,19,0,0,0,104,20121231
2013,LAC,19,24,16,19,0,0,0,78,DEN,21,27,27,17,0,0,0,92,20130101
2013,SAC,28,20,19,30,0,0,0,97,DET,27,31,22,23,0,0,0,103,20130101
2013,PHI,28,26,27,22,0,0,0,103,LAL,25,25,23,26,0,0,0,99,20130101
2013,ATL,22,22,28,23,0,0,0,95,NOH,26,24,14,22,0,0,0,86,20130101
2013,POR,30,28,20,27,0,0,0,105,NYK,23,24,24,29,0,0,0,100,20130101
2013,DAL,23,25,35,20,0,0,0,103,WAS,29,23,19,23,0,0,0,94,20130101
2013,MEM,25,25,25,18,0,0,0,93,BOS,26,15,18,24,0,0,0,83,20130102
2013,SAC,28,24,22,23,0,0,0,97,CLE,25,28,18,23,0,0,0,94,20130102
2013,LAC,24,25,15,30,0,0,0,94,GSW,33,29,20,33,0,0,0,115,20130102
2013,NOH,23,21,22,26,0,0,0,92,HOU,21,28,25,30,0,0,0,104,20130102
2013,WAS,18,21,19,23,0,0,0,81,IND,31,16,20,22,0,0,0,89,20130102
2013,DAL,30,22,27,24,6,0,0,109,MIA,22,28,31,22,16,0,0,119,20130102
2013,SAS,33,36,24,24,0,0,0,117,MIL,22,30,29,29,0,0,0,110,20130102
2013,BRK,33,28,15,34,0,0,0,110,OKC,19,26,27,21,0,0,0,93,20130102
2013,CHI,29,25,28,14,0,0,0,96,ORL,28,18,25,23,0,0,0,94,20130102
2013,PHI,24,25,17,23,0,0,0,89,PHO,31,17,27,20,0,0,0,95,20130102
2013,POR,17,22,22,18,0,0,0,79,TOR,24,31,23,24,0,0,0,102,20130102
2013,MIN,24,21,21,18,0,0,0,84,UTA,23,30,26,27,0,0,0,106,20130102
2013,MIN,23,24,22,32,0,0,0,101,DEN,25,18,27,27,0,0,0,97,20130103
2013,SAS,19,21,20,23,0,0,0,83,NYK,22,20,25,33,0,0,0,100,20130103
2013,IND,16,19,16,24,0,0,0,75,BOS,15,32,22,25,0,0,0,94,20130104
2013,CLE,29,33,24,20,0,0,0,106,CHA,23,25,26,30,0,0,0,104,20130104
2013,ATL,20,16,26,22,0,0,0,84,DET,25,26,23,11,0,0,0,85,20130104
2013,LAL,22,29,20,31,0,0,0,102,LAC,29,32,26,20,0,0,0,107,20130104
2013,POR,24,23,25,14,0,0,0,86,MEM,25,25,22,12,0,0,0,84,20130104
2013,CHI,26,23,26,21,0,0,0,96,MIA,22,26,18,23,0,0,0,89,20130104
2013,HOU,23,24,30,38,0,0,0,115,MIL,21,37,14,29,0,0,0,101,20130104
2013,PHI,21,21,24,19,0,0,0,85,OKC,22,24,32,31,0,0,0,109,20130104
2013,UTA,25,17,29,16,0,0,0,87,PHO,31,9,22,18,0,0,0,80,20130104
2013,SAC,23,31,28,23,0,0,0,105,TOR,22,31,10,33,0,0,0,96,20130104
2013,BRK,20,32,26,15,11,11,0,115,WAS,30,25,24,14,11,9,0,113,20130104
2013,BOS,18,20,33,18,0,0,0,89,ATL,31,22,9,19,0,0,0,81,20130105
2013,SAC,31,16,25,21,0,0,0,93,BRK,36,29,23,25,0,0,0,113,20130105
2013,HOU,20,34,24,34,0,0,0,112,CLE,26,24,28,26,0,0,0,104,20130105
2013,NOH,25,15,23,26,10,0,0,99,DAL,23,24,20,22,7,0,0,96,20130105
2013,UTA,23,22,27,19,0,0,0,91,DEN,21,28,34,27,0,0,0,110,20130105
2013,MIL,21,26,17,16,0,0,0,80,IND,21,31,25,18,0,0,0,95,20130105
2013,GSW,12,31,23,23,0,0,0,89,LAC,35,32,36,12,0,0,0,115,20130105
2013,POR,23,30,26,23,0,0,0,102,MIN,21,22,18,36,0,0,0,97,20130105
2013,NYK,27,32,22,33,0,0,0,114,ORL,36,19,34,17,0,0,0,106,20130105
2013,PHI,21,21,21,23,0,0,0,86,SAS,31,23,27,28,0,0,0,109,20130105
2013,CHA,21,38,20,17,12,0,0,108,DET,30,30,22,14,5,0,0,101,20130106
2013,DEN,34,26,29,23,0,0,0,112,LAL,26,34,23,22,0,0,0,105,20130106
2013,WAS,19,25,16,11,0,0,0,71,MIA,27,25,17,30,0,0,0,99,20130106
2013,MEM,21,20,30,21,0,0,0,92,PHO,16,22,24,19,0,0,0,81,20130106
2013,OKC,23,29,26,26,0,0,0,104,TOR,18,32,17,25,0,0,0,92,20130106
2013,CLE,30,20,22,20,0,0,0,92,CHI,22,31,35,30,0,0,0,118,20130107
2013,SAS,19,22,24,23,0,0,0,88,NOH,24,25,21,25,0,0,0,95,20130107
2013,BOS,22,31,23,26,0,0,0,102,NYK,21,35,16,24,0,0,0,96,20130107
2013,ORL,24,33,28,23,11,0,0,119,POR,25,23,37,23,17,0,0,125,20130107
2013,MEM,22,29,36,26,0,0,0,113,SAC,23,22,20,16,0,0,0,81,20130107
2013,DAL,26,27,27,14,0,0,0,94,UTA,19,34,21,26,0,0,0,100,20130107
2013,OKC,20,33,20,26,0,0,0,99,WAS,30,21,25,25,0,0,0,101,20130107
2013,LAL,34,28,26,24,0,0,0,112,HOU,28,31,38,28,0,0,0,125,20130108
2013,MIA,19,23,15,20,0,0,0,77,IND,20,22,25,20,0,0,0,87,20130108
2013,PHO,33,23,20,23,0,0,0,99,MIL,26,24,30,28,0,0,0,108,20130108
2013,ATL,20,22,29,32,0,0,0,103,MIN,30,28,27,23,0,0,0,108,20130108
2013,BRK,26,22,35,26,0,0,0,109,PHI,24,23,14,28,0,0,0,89,20130108
2013,PHO,24,17,23,15,0,0,0,79,BOS,23,30,14,20,0,0,0,87,20130109
2013,UTA,27,36,27,22,0,0,0,112,CHA,20,24,29,29,0,0,0,102,20130109
2013,MIL,23,27,31,23,0,0,0,104,CHI,33,24,23,16,0,0,0,96,20130109
2013,ATL,28,12,23,20,0,0,0,83,CLE,29,20,28,22,0,0,0,99,20130109
2013,ORL,30,25,22,28,0,0,0,105,DEN,22,31,17,38,0,0,0,108,20130109
2013,MEM,27,28,13,26,0,0,0,94,GSW,26,20,17,24,0,0,0,87,20130109
2013,DAL,21,29,25,18,0,0,0,93,LAC,25,27,20,27,0,0,0,99,20130109
2013,HOU,22,14,33,10,0,0,0,79,NOH,18,16,25,29,0,0,0,88,20130109
2013,MIN,16,26,22,20,0,0,0,84,OKC,16,31,29,30,0,0,0,106,20130109
2013,LAL,17,28,30,30,0,0,0,105,SAS,24,30,31,23,0,0,0,108,20130109
2013,PHI,21,19,21,11,0,0,0,72,TOR,24,18,29,19,0,0,0,90,20130109
2013,NYK,14,20,26,16,0,0,0,76,IND,16,23,19,23,0,0,0,81,20130110
2013,MIA,21,31,16,22,0,0,0,90,POR,18,21,24,29,0,0,0,92,20130110
2013,DAL,23,19,26,33,16,0,0,117,SAC,25,24,29,23,11,0,0,112,20130110
2013,UTA,25,22,29,19,0,0,0,95,ATL,22,21,25,35,0,0,0,103,20130111
2013,HOU,21,24,21,25,0,0,0,91,BOS,24,29,25,25,0,0,0,103,20130111
2013,PHO,25,28,13,13,0,0,0,79,BRK,21,25,28,25,0,0,0,99,20130111
2013,CLE,30,26,20,15,0,0,0,91,DEN,23,22,27,26,0,0,0,98,20130111
2013,POR,19,16,28,34,0,0,0,97,GSW,28,22,28,25,0,0,0,103,20130111
2013,OKC,25,39,29,23,0,0,0,116,LAL,25,23,25,28,0,0,0,101,20130111
2013,SAS,25,18,28,24,3,0,0,98,MEM,22,29,17,27,6,0,0,101,20130111
2013,DET,25,16,33,29,0,0,0,103,MIL,20,29,11,27,0,0,0,87,20130111
2013,MIN,29,17,15,31,0,0,0,92,NOH,14,26,30,34,0,0,0,104,20130111
2013,CHI,29,28,25,26,0,0,0,108,NYK,18,18,24,41,0,0,0,101,20130111
2013,CHA,16,23,19,20,0,0,0,78,TOR,29,24,23,23,0,0,0,99,20130111
2013,PHO,20,29,28,20,0,0,0,97,CHI,21,21,21,18,0,0,0,81,20130112
2013,MEM,18,21,23,21,0,0,0,83,DAL,25,29,34,16,0,0,0,104,20130112
2013,UTA,13,26,25,26,0,0,0,90,DET,26,24,11,26,0,0,0,87,20130112
2013,CHA,24,21,20,23,0,0,0,88,IND,23,20,26,27,0,0,0,96,20130112
2013,ORL,26,23,26,29,0,0,0,104,LAC,31,26,26,18,0,0,0,101,20130112
2013,HOU,25,25,26,24,0,0,0,100,PHI,29,29,27,22,0,0,0,107,20130112
2013,MIA,28,38,37,25,0,0,0,128,SAC,17,27,28,27,0,0,0,99,20130112
2013,ATL,17,33,16,17,0,0,0,83,WAS,27,24,22,20,0,0,0,93,20130112
2013,IND,21,28,26,11,0,0,0,86,BRK,27,19,23,28,0,0,0,97,20130113
2013,GSW,25,29,33,18,0,0,0,105,DEN,27,25,27,37,0,0,0,116,20130113
2013,CLE,20,25,24,24,0,0,0,93,LAL,37,20,29,27,0,0,0,113,20130113
2013,NOH,29,12,25,21,0,0,0,87,NYK,22,27,22,29,0,0,0,100,20130113
2013,OKC,22,20,26,19,0,0,0,87,POR,19,24,16,24,0,0,0,83,20130113
2013,MIN,21,29,21,17,0,0,0,88,SAS,24,31,23,28,0,0,0,106,20130113
2013,MIL,16,31,27,33,0,0,0,107,TOR,34,15,29,18,0,0,0,96,20130113
2013,CHA,18,27,25,19,0,0,0,89,BOS,28,28,20,24,0,0,0,100,20130114
2013,ATL,15,5,17,21,0,0,0,58,CHI,26,22,23,26,0,0,0,97,20130114
2013,MIN,19,26,25,28,0,0,0,98,DAL,26,29,36,22,0,0,0,113,20130114
2013,LAC,25,28,20,26,0,0,0,99,MEM,19,15,18,21,0,0,0,73,20130114
2013,OKC,21,30,21,30,0,0,0,102,PHO,24,21,23,22,0,0,0,90,20130114
2013,CLE,24,33,30,31,0,0,0,118,SAC,31,38,24,31,0,0,0,124,20130114
2013,MIA,25,19,21,32,0,0,0,97,UTA,30,29,25,20,0,0,0,104,20130114
2013,ORL,22,31,24,14,0,0,0,91,WAS,28,31,37,24,0,0,0,120,20130114
2013,TOR,27,23,26,30,0,0,0,106,BRK,27,27,29,30,0,0,0,113,20130115
2013,IND,27,23,33,20,0,0,0,103,CHA,20,20,17,19,0,0,0,76,20130115
2013,POR,35,22,19,23,12,0,0,111,DEN,33,21,27,18,16,0,0,115,20130115
2013,LAC,28,30,32,27,0,0,0,117,HOU,29,30,18,32,0,0,0,109,20130115
2013,MIL,27,23,23,15,0,0,0,88,LAL,29,28,22,25,0,0,0,104,20130115
2013,NOH,35,18,33,25,0,0,0,111,PHI,28,19,21,31,0,0,0,99,20130115
2013,BRK,20,20,29,26,0,0,0,95,ATL,27,29,32,21,0,0,0,109,20130116
2013,NOH,20,24,24,22,0,0,0,90,BOS,25,18,20,15,0,0,0,78,20130116
2013,HOU,18,26,29,27,0,0,0,100,DAL,29,23,28,25,0,0,0,105,20130116
2013,MIA,28,24,28,12,0,0,0,92,GSW,21,17,12,25,0,0,0,75,20130116
2013,DEN,18,29,23,27,0,0,0,97,OKC,34,33,28,22,0,0,0,117,20130116
2013,IND,17,18,29,22,0,0,0,86,ORL,22,29,26,20,0,0,0,97,20130116
2013,CLE,26,27,21,19,0,0,0,93,POR,21,15,29,23,0,0,0,88,20130116
2013,WAS,31,25,21,17,0,0,0,94,SAC,32,16,24,23,0,0,0,95,20130116
2013,MEM,25,29,15,13,0,0,0,82,SAS,19,38,25,21,0,0,0,103,20130116
2013,CHI,29,23,27,21,7,0,0,107,TOR,22,22,29,27,5,0,0,105,20130116
2013,NYK,29,27,19,27,0,0,0,102,DET,17,24,22,24,0,0,0,87,20130117
2013,MIA,26,18,29,26,0,0,0,99,LAL,22,23,20,25,0,0,0,90,20130117
2013,LAC,27,20,21,22,0,0,0,90,MIN,22,21,20,14,0,0,0,77,20130117
2013,MIL,32,21,17,28,0,0,0,98,PHO,22,34,19,19,0,0,0,94,20130117
2013,CHI,23,22,23,20,12,0,0,100,BOS,19,20,23,26,11,0,0,99,20130118
2013,ATL,29,20,25,15,0,0,0,89,BRK,29,20,25,20,0,0,0,94,20130118
2013,OKC,30,23,28,24,12,0,0,117,DAL,22,24,26,33,9,0,0,114,20130118
2013,WAS,19,26,35,32,0,0,0,112,DEN,19,31,37,21,0,0,0,108,20130118
2013,HOU,18,34,17,26,0,0,0,95,IND,31,28,24,22,0,0,0,105,20130118
2013,SAC,14,16,17,22,0,0,0,69,MEM,18,24,18,25,0,0,0,85,20130118
2013,CHA,28,29,19,30,0,0,0,106,ORL,28,17,26,29,0,0,0,100,20130118
2013,TOR,28,32,13,23,5,0,0,101,PHI,20,23,29,24,12,0,0,108,20130118
2013,GSW,26,21,26,15,0,0,0,88,SAS,19,27,32,17,0,0,0,95,20130118
2013,SAS,25,27,20,26,0,0,0,98,ATL,16,26,28,23,0,0,0,93,20130119
2013,SAC,25,26,27,19,0,0,0,97,CHA,20,26,30,17,0,0,0,93,20130119
2013,MEM,18,26,16,16,9,0,0,85,CHI,22,12,13,29,6,0,0,82,20130119
2013,WAS,22,18,24,23,0,0,0,87,LAC,24,23,26,21,0,0,0,94,20130119
2013,HOU,16,22,21,20,0,0,0,79,MIN,21,23,19,29,0,0,0,92,20130119
2013,GSW,33,34,18,31,0,0,0,116,NOH,27,30,32,23,0,0,0,112,20130119
2013,MIL,30,32,22,26,0,0,0,110,POR,19,26,31,28,0,0,0,104,20130119
2013,CLE,23,25,20,30,0,0,0,98,UTA,26,27,31,25,0,0,0,109,20130119
2013,OKC,25,25,29,30,9,0,0,118,DEN,25,26,30,28,12,0,0,121,20130120
2013,BOS,18,30,23,17,0,0,0,88,DET,27,25,29,22,0,0,0,103,20130120
2013,DAL,26,31,28,26,0,0,0,111,ORL,24,24,27,30,0,0,0,105,20130120
2013,LAL,20,29,21,33,0,0,0,103,TOR,29,24,30,25,0,0,0,108,20130120
2013,MIN,31,27,19,19,0,0,0,96,ATL,18,26,26,34,0,0,0,104,20130121
2013,HOU,22,23,29,26,0,0,0,100,CHA,30,26,25,13,0,0,0,94,20130121
2013,LAL,20,20,29,14,0,0,0,83,CHI,27,20,22,26,0,0,0,95,20130121
2013,LAC,33,19,28,19,0,0,0,99,GSW,33,20,20,33,0,0,0,106,20130121
2013,IND,26,17,22,17,0,0,0,82,MEM,27,12,24,18,0,0,0,81,20130121
2013,SAC,18,21,37,29,0,0,0,105,NOH,30,34,23,27,0,0,0,114,20130121
2013,BRK,26,21,18,23,0,0,0,88,NYK,24,17,27,17,0,0,0,85,20130121
2013,SAS,25,24,22,19,0,0,0,90,PHI,17,18,29,21,0,0,0,85,20130121
2013,WAS,34,16,19,29,0,0,0,98,POR,31,20,13,31,0,0,0,95,20130121
2013,BOS,27,26,20,17,0,0,0,90,CLE,31,23,16,25,0,0,0,95,20130122
2013,ORL,25,27,14,24,0,0,0,90,DET,26,28,28,23,0,0,0,105,20130122
2013,OKC,22,27,33,27,0,0,0,109,LAC,22,23,23,29,0,0,0,97,20130122
2013,PHI,18,29,24,31,0,0,0,102,MIL,28,27,28,27,0,0,0,110,20130122
2013,ATL,28,25,26,25,0,0,0,104,CHA,20,26,21,25,0,0,0,92,20130123
2013,DET,23,24,21,14,0,0,0,82,CHI,14,24,19,28,0,0,0,85,20130123
2013,OKC,26,31,22,20,0,0,0,99,GSW,27,25,24,28,0,0,0,104,20130123
2013,DEN,27,19,36,23,0,0,0,105,HOU,21,23,22,29,0,0,0,95,20130123
2013,LAL,23,27,23,20,0,0,0,93,MEM,24,35,24,23,0,0,0,106,20130123
2013,TOR,28,29,27,25,7,0,0,116,MIA,22,28,38,21,14,0,0,123,20130123
2013,BRK,24,29,15,23,0,0,0,91,MIN,17,25,20,21,0,0,0,83,20130123
2013,IND,17,15,27,21,0,0,0,80,POR,20,24,26,30,0,0,0,100,20130123
2013,PHO,30,19,25,32,0,0,0,106,SAC,27,30,20,19,0,0,0,96,20130123
2013,NOH,35,29,15,23,0,0,0,102,SAS,32,28,18,28,0,0,0,106,20130123
2013,WAS,19,19,20,30,0,0,0,88,UTA,25,27,21,19,0,0,0,92,20130123
2013,NYK,20,30,22,17,0,0,0,89,BOS,24,24,18,20,0,0,0,86,20130124
2013,TOR,22,26,27,22,0,0,0,97,ORL,20,27,19,29,0,0,0,95,20130124
2013,LAC,20,26,20,22,0,0,0,88,PHO,24,26,18,25,0,0,0,93,20130124
2013,BOS,29,28,16,25,9,4,0,111,ATL,10,28,31,29,9,16,0,123,20130125
2013,GSW,13,37,16,21,0,0,0,87,CHI,31,32,21,19,0,0,0,103,20130125
2013,MIL,21,38,31,18,0,0,0,108,CLE,18,32,31,32,0,0,0,113,20130125
2013,SAS,27,26,35,25,0,0,0,113,DAL,20,23,25,39,0,0,0,107,20130125
2013,UTA,19,18,26,21,0,0,0,84,LAL,26,21,25,30,0,0,0,102,20130125
2013,BRK,22,22,23,10,0,0,0,77,MEM,32,35,18,16,0,0,0,101,20130125
2013,DET,31,20,17,20,0,0,0,88,MIA,30,30,24,26,0,0,0,110,20130125
2013,HOU,27,21,32,20,0,0,0,100,NOH,18,22,25,17,0,0,0,82,20130125
2013,OKC,27,31,28,19,0,0,0,105,SAC,30,21,16,28,0,0,0,95,20130125
2013,MIN,25,21,27,28,0,0,0,101,WAS,29,31,31,23,0,0,0,114,20130125
2013,MIN,34,24,19,24,0,0,0,101,CHA,22,25,26,29,0,0,0,102,20130126
2013,SAC,25,24,20,24,0,0,0,93,DEN,39,32,30,20,0,0,0,121,20130126
2013,BRK,29,20,31,26,0,0,0,106,HOU,28,34,27,30,0,0,0,119,20130126
2013,GSW,26,29,19,28,0,0,0,102,MIL,23,28,35,23,0,0,0,109,20130126
2013,NYK,19,22,17,22,0,0,0,80,PHI,24,29,31,13,0,0,0,97,20130126
2013,LAC,22,23,31,24,0,0,0,100,POR,25,26,31,19,0,0,0,101,20130126
2013,PHO,26,30,26,17,0,0,0,99,SAS,26,33,22,27,0,0,0,108,20130126
2013,CLE,19,27,20,33,0,0,0,99,TOR,25,25,25,23,0,0,0,98,20130126
2013,IND,24,24,20,30,12,0,0,110,UTA,27,18,31,22,16,0,0,114,20130126
2013,CHI,24,20,11,18,0,0,0,73,WAS,23,27,23,13,0,0,0,86,20130126
2013,MIA,26,19,23,19,6,5,0,98,BOS,22,23,19,23,6,7,0,100,20130127
2013,PHO,21,21,30,23,0,0,0,95,DAL,29,28,24,29,0,0,0,110,20130127
2013,POR,27,23,12,21,0,0,0,83,LAC,33,22,23,18,0,0,0,96,20130127
2013,OKC,23,30,22,21,0,0,0,96,LAL,27,25,23,30,0,0,0,105,20130127
2013,NOH,24,19,21,27,0,0,0,91,MEM,23,22,23,15,0,0,0,83,20130127
2013,ATL,25,27,22,30,0,0,0,104,NYK,27,25,30,24,0,0,0,106,20130127
2013,DET,29,25,24,26,0,0,0,104,ORL,25,19,33,25,0,0,0,102,20130127
2013,ORL,20,20,23,14,0,0,0,77,BRK,30,26,14,27,0,0,0,97,20130128
2013,CHA,18,22,15,30,0,0,0,85,CHI,21,28,14,30,0,0,0,93,20130128
2013,IND,29,24,21,27,0,0,0,101,DEN,24,31,27,20,0,0,0,102,20130128
2013,MEM,20,37,22,24,0,0,0,103,PHI,33,21,25,21,0,0,0,100,20130128
2013,GSW,25,27,32,30,0,0,0,114,TOR,28,24,30,20,0,0,0,102,20130128
2013,HOU,28,29,36,32,0,0,0,125,UTA,22,17,20,21,0,0,0,80,20130128
2013,SAC,27,26,19,24,0,0,0,96,WAS,32,25,19,18,0,0,0,94,20130128
2013,GSW,23,32,29,24,0,0,0,108,CLE,23,21,24,27,0,0,0,95,20130129
2013,MIL,19,33,39,26,0,0,0,117,DET,28,14,26,22,0,0,0,90,20130129
2013,NOH,24,18,31,33,0,0,0,106,LAL,25,29,29,28,0,0,0,111,20130129
2013,DAL,32,27,21,24,0,0,0,104,POR,28,14,32,32,0,0,0,106,20130129
2013,TOR,23,32,14,23,0,0,0,92,ATL,20,25,30,18,0,0,0,93,20130130
2013,SAC,24,14,22,21,0,0,0,81,BOS,22,37,21,19,0,0,0,99,20130130
2013,MIA,30,19,36,20,0,0,0,105,BRK,20,29,14,22,0,0,0,85,20130130
2013,HOU,29,28,29,24,0,0,0,110,DEN,29,27,27,35,0,0,0,118,20130130
2013,DET,23,13,20,23,0,0,0,79,IND,29,25,16,28,0,0,0,98,20130130
2013,CHI,23,32,24,25,0,0,0,104,MIL,19,18,31,20,0,0,0,88,20130130
2013,LAC,23,29,24,20,0,0,0,96,MIN,25,23,23,19,0,0,0,90,20130130
2013,ORL,31,20,22,24,0,0,0,97,NYK,31,20,28,34,0,0,0,113,20130130
2013,WAS,28,11,24,21,0,0,0,84,PHI,25,23,25,19,0,0,0,92,20130130
2013,LAL,22,19,32,13,0,0,0,86,PHO,26,15,22,29,0,0,0,92,20130130
2013,CHA,23,14,23,18,0,0,0,78,SAS,25,24,25,28,0,0,0,102,20130130
2013,NOH,29,18,28,24,0,0,0,99,UTA,19,32,27,26,0,0,0,104,20130130
2013,DAL,23,30,26,18,0,0,0,97,GSW,28,27,25,20,0,0,0,100,20130131
2013,MEM,22,12,33,22,0,0,0,89,OKC,32,26,21,27,0,0,0,106,20130131
2013,ORL,18,17,24,25,0,0,0,84,BOS,25,21,26,25,0,0,0,97,20130201
2013,CHI,14,28,25,22,0,0,0,89,BRK,24,17,22,30,0,0,0,93,20130201
2013,NOH,26,22,30,20,0,0,0,98,DEN,26,25,34,28,0,0,0,113,20130201
2013,CLE,16,31,21,31,0,0,0,99,DET,24,30,31,32,0,0,0,117,20130201
2013,MIA,23,22,20,24,0,0,0,89,IND,25,28,27,22,0,0,0,102,20130201
2013,WAS,30,10,16,20,0,0,0,76,MEM,23,16,22,24,0,0,0,85,20130201
2013,LAL,37,31,17,26,0,0,0,111,MIN,24,29,23,24,0,0,0,100,20130201
2013,MIL,28,25,20,13,0,0,0,86,NYK,25,22,27,22,0,0,0,96,20130201
2013,SAC,23,16,29,12,0,0,0,80,PHI,27,27,18,17,0,0,0,89,20130201
2013,DAL,29,25,20,35,0,0,0,109,PHO,31,23,21,24,0,0,0,99,20130201
2013,LAC,17,13,15,28,0,0,0,73,TOR,22,24,26,26,0,0,0,98,20130201
2013,POR,19,17,25,16,0,0,0,77,UTA,26,25,22,13,0,0,0,86,20130201
2013,CHI,24,19,26,24,0,0,0,93,ATL,17,27,16,16,0,0,0,76,20130202
2013,OKC,25,32,21,32,0,0,0,110,CLE,23,29,24,39,0,0,0,115,20130202
2013,PHO,29,23,22,19,0,0,0,93,GSW,26,22,33,32,0,0,0,113,20130202
2013,CHA,27,24,26,18,0,0,0,95,HOU,32,30,17,30,0,0,0,109,20130202
2013,ORL,22,26,19,31,0,0,0,98,MIL,31,21,27,28,0,0,0,107,20130202
2013,NOH,14,17,24,31,0,0,0,86,MIN,33,25,23,34,0,0,0,115,20130202
2013,SAC,22,11,19,29,0,0,0,81,NYK,25,31,41,23,0,0,0,120,20130202
2013,UTA,23,23,21,32,0,0,0,99,POR,24,19,29,33,0,0,0,105,20130202
2013,WAS,17,9,30,30,0,0,0,86,SAS,27,24,17,28,0,0,0,96,20130202
2013,LAC,30,10,37,27,0,0,0,104,BOS,33,26,33,14,0,0,0,106,20130203
2013,LAL,32,30,16,20,0,0,0,98,DET,27,24,21,25,0,0,0,97,20130203
2013,MIA,24,20,27,29,0,0,0,100,TOR,21,29,17,18,0,0,0,85,20130203
2013,CHI,29,25,22,25,0,0,0,101,IND,28,32,27,24,0,0,0,111,20130204
2013,CHA,21,22,20,31,0,0,0,94,MIA,22,25,19,33,0,0,0,99,20130204
2013,POR,25,24,28,23,0,0,0,100,MIN,18,20,20,40,0,0,0,98,20130204
2013,DET,13,23,22,27,0,0,0,85,NYK,28,29,19,23,0,0,0,99,20130204
2013,DAL,22,22,23,24,0,0,0,91,OKC,29,39,24,20,0,0,0,112,20130204
2013,ORL,16,19,11,15,0,0,0,61,PHI,28,14,18,18,0,0,0,78,20130204
2013,SAC,22,21,23,18,7,0,0,91,UTA,20,24,18,22,14,0,0,98,20130204
2013,LAC,16,30,20,24,0,0,0,90,WAS,24,27,21,26,0,0,0,98,20130204
2013,LAL,18,31,18,25,0,0,0,92,BRK,24,16,24,19,0,0,0,83,20130205
2013,MIL,29,37,20,18,0,0,0,104,DEN,27,24,28,33,0,0,0,112,20130205
2013,GSW,37,25,24,23,0,0,0,109,HOU,38,39,27,36,0,0,0,140,20130205
2013,ATL,21,28,21,33,0,0,0,103,IND,18,32,31,33,0,0,0,114,20130205
2013,PHO,27,23,15,31,0,0,0,96,MEM,27,25,19,19,0,0,0,90,20130205
2013,MEM,22,26,14,30,0,0,0,92,ATL,26,32,22,23,0,0,0,103,20130206
2013,CHA,21,20,26,28,0,0,0,95,CLE,32,33,35,22,0,0,0,122,20130206
2013,POR,33,28,21,17,0,0,0,99,DAL,27,30,23,25,0,0,0,105,20130206
2013,BRK,23,17,29,24,0,0,0,93,DET,24,22,27,17,0,0,0,90,20130206
2013,HOU,30,26,27,25,0,0,0,108,MIA,32,31,26,25,0,0,0,114,20130206
2013,SAS,21,26,21,36,0,0,0,104,MIN,23,18,23,30,0,0,0,94,20130206
2013,PHO,27,26,18,13,0,0,0,84,NOH,26,28,24,15,0,0,0,93,20130206
2013,GSW,22,27,30,19,0,0,0,98,OKC,34,33,23,29,0,0,0,119,20130206
2013,LAC,17,23,24,22,0,0,0,86,ORL,17,25,13,21,0,0,0,76,20130206
2013,IND,18,19,22,29,0,0,0,88,PHI,15,19,14,21,0,0,0,69,20130206
2013,BOS,20,30,19,30,0,0,0,99,TOR,23,22,34,16,0,0,0,95,20130206
2013,MIL,25,18,19,24,0,0,0,86,UTA,19,32,26,23,0,0,0,100,20130206
2013,NYK,29,19,25,23,0,0,0,96,WAS,28,23,19,36,0,0,0,106,20130206
2013,LAL,23,21,25,26,0,0,0,95,BOS,27,31,37,21,0,0,0,116,20130207
2013,CHI,25,33,16,22,0,0,0,96,DEN,33,30,37,28,0,0,0,128,20130207
2013,NOH,25,25,29,32,0,0,0,111,ATL,26,29,16,29,0,0,0,100,20130208
2013,LAL,20,21,28,31,0,0,0,100,CHA,30,23,25,15,0,0,0,93,20130208
2013,ORL,24,32,24,28,0,0,0,108,CLE,24,32,29,34,0,0,0,119,20130208
2013,SAS,23,29,26,31,0,0,0,109,DET,31,34,30,24,0,0,0,119,20130208
2013,POR,28,25,27,23,0,0,0,103,HOU,34,28,33,23,0,0,0,118,20130208
2013,TOR,25,19,20,26,10,0,0,100,IND,26,25,21,18,8,0,0,98,20130208
2013,GSW,24,32,20,17,0,0,0,93,MEM,32,31,14,22,0,0,0,99,20130208
2013,LAC,29,21,18,21,0,0,0,89,MIA,30,32,31,18,0,0,0,111,20130208
2013,NYK,25,27,18,30,0,0,0,100,MIN,23,22,31,18,0,0,0,94,20130208
2013,PHO,27,23,20,26,0,0,0,96,OKC,33,22,36,36,0,0,0,127,20130208
2013,CHI,31,27,11,24,0,0,0,93,UTA,27,23,19,20,0,0,0,89,20130208
2013,BRK,20,11,22,21,0,0,0,74,WAS,21,30,14,24,0,0,0,89,20130208
2013,DEN,30,28,26,27,0,0,0,111,CLE,32,20,21,30,0,0,0,103,20130209
2013,GSW,16,20,30,25,0,0,0,91,DAL,30,32,23,31,0,0,0,116,20130209
2013,DET,33,24,24,24,0,0,0,105,MIL,22,34,26,18,0,0,0,100,20130209
2013,CHA,17,20,17,22,0,0,0,76,PHI,23,15,25,24,0,0,0,87,20130209
2013,UTA,29,25,20,35,0,0,0,109,SAC,31,31,25,33,0,0,0,120,20130209
2013,DEN,19,27,24,22,7,8,7,114,BOS,29,21,28,14,7,8,11,118,20130210
2013,SAS,25,26,30,30,0,0,0,111,BRK,35,22,14,15,0,0,0,86,20130210
2013,MIN,20,17,19,32,0,0,0,88,MEM,21,26,29,29,0,0,0,105,20130210
2013,LAL,26,27,20,24,0,0,0,97,MIA,25,28,25,29,0,0,0,107,20130210
2013,LAC,22,30,19,31,0,0,0,102,NYK,17,27,26,18,0,0,0,88,20130210
2013,POR,26,23,23,32,0,0,0,104,ORL,22,33,24,31,0,0,0,110,20130210
2013,OKC,27,24,23,23,0,0,0,97,PHO,16,18,14,21,0,0,0,69,20130210
2013,HOU,25,28,33,25,0,0,0,111,SAC,28,29,27,33,0,0,0,117,20130210
2013,NOH,21,26,19,23,0,0,0,89,TOR,32,18,19,33,0,0,0,102,20130210
2013,BOS,26,22,24,19,0,0,0,91,CHA,24,18,33,19,0,0,0,94,20130211
2013,SAS,20,31,25,27,0,0,0,103,CHI,24,18,29,18,0,0,0,89,20130211
2013,MIN,25,24,23,28,0,0,0,100,CLE,27,19,19,27,0,0,0,92,20130211
2013,ATL,31,18,33,23,0,0,0,105,DAL,23,25,33,20,0,0,0,101,20130211
2013,NOH,27,28,22,28,0,0,0,105,DET,23,18,20,25,0,0,0,86,20130211
2013,BRK,20,15,23,18,13,0,0,89,IND,13,27,14,22,8,0,0,84,20130211
2013,WAS,29,26,19,28,0,0,0,102,MIL,32,15,24,19,0,0,0,90,20130211
2013,LAC,30,26,32,19,0,0,0,107,PHI,22,11,26,31,0,0,0,90,20130211
2013,HOU,30,27,31,28,0,0,0,116,GSW,34,22,23,28,0,0,0,107,20130212
2013,PHO,22,25,24,14,0,0,0,85,LAL,30,26,9,26,0,0,0,91,20130212
2013,SAC,25,30,18,28,0,0,0,101,MEM,26,32,26,24,0,0,0,108,20130212
2013,POR,33,26,23,22,0,0,0,104,MIA,29,29,28,31,0,0,0,117,20130212
2013,DEN,21,31,26,30,0,0,0,108,TOR,28,26,28,27,0,0,0,109,20130212
2013,OKC,26,26,27,15,0,0,0,94,UTA,28,30,28,23,0,0,0,109,20130212
2013,CHI,15,21,13,20,0,0,0,69,BOS,24,11,8,28,0,0,0,71,20130213
2013,DEN,26,31,24,27,0,0,0,108,BRK,23,39,33,24,0,0,0,119,20130213
2013,SAS,21,25,28,22,0,0,0,96,CLE,22,32,19,22,0,0,0,95,20130213
2013,SAC,27,17,33,23,0,0,0,100,DAL,30,29,33,31,0,0,0,123,20130213
2013,WAS,19,26,23,17,0,0,0,85,DET,21,23,21,31,0,0,0,96,20130213
2013,CHA,29,17,14,17,0,0,0,77,IND,30,19,21,31,0,0,0,101,20130213
2013,HOU,28,21,23,24,0,0,0,96,LAC,46,23,19,18,0,0,0,106,20130213
2013,PHI,28,22,25,17,0,0,0,92,MIL,18,25,29,22,0,0,0,94,20130213
2013,UTA,10,32,26,29,0,0,0,97,MIN,17,23,23,30,0,0,0,93,20130213
2013,POR,14,12,18,19,0,0,0,63,NOH,19,19,29,32,0,0,0,99,20130213
2013,TOR,14,23,28,27,0,0,0,92,NYK,18,24,18,28,0,0,0,88,20130213
2013,ATL,25,32,33,18,0,0,0,108,ORL,19,17,20,20,0,0,0,76,20130213
2013,LAC,31,33,37,24,0,0,0,125,LAL,17,35,28,21,0,0,0,101,20130214
2013,MIA,32,31,25,22,0,0,0,110,OKC,17,29,23,31,0,0,0,100,20130214
2013,MIL,24,27,30,24,6,0,0,111,BRK,31,30,19,25,8,0,0,113,20130219
2013,BOS,22,28,20,20,0,0,0,90,DEN,21,28,29,19,0,0,0,97,20130219
2013,MEM,22,31,31,21,0,0,0,105,DET,30,12,18,31,0,0,0,91,20130219
2013,CHI,26,21,27,22,0,0,0,96,NOH,21,22,25,19,0,0,0,87,20130219
2013,CHA,37,26,17,25,0,0,0,105,ORL,27,16,27,22,0,0,0,92,20130219
2013,PHO,36,27,21,18,0,0,0,102,POR,23,24,26,25,0,0,0,98,20130219
2013,SAS,28,22,33,25,0,0,0,108,SAC,19,22,33,28,0,0,0,102,20130219
2013,GSW,19,34,26,22,0,0,0,101,UTA,26,32,29,28,0,0,0,115,20130219
2013,TOR,27,28,18,23,0,0,0,96,WAS,19,27,19,23,0,0,0,88,20130219
2013,MIA,24,21,18,40,0,0,0,103,ATL,17,32,24,17,0,0,0,90,20130220
2013,DET,28,27,22,28,0,0,0,105,CHA,25,31,20,23,0,0,0,99,20130220
2013,NOH,20,21,28,31,0,0,0,100,CLE,20,23,25,37,0,0,0,105,20130220
2013,ORL,30,23,29,14,0,0,0,96,DAL,42,17,24,28,0,0,0,111,20130220
2013,PHO,26,23,27,22,0,0,0,98,GSW,33,24,28,23,0,0,0,108,20130220
2013,OKC,29,33,30,27,0,0,0,119,HOU,36,21,30,35,0,0,0,122,20130220
2013,NYK,18,26,22,25,0,0,0,91,IND,30,44,28,23,0,0,0,125,20130220
2013,BOS,27,28,21,23,0,0,0,99,LAL,36,28,26,23,0,0,0,113,20130220
2013,BRK,21,21,26,29,0,0,0,97,MIL,29,25,22,18,0,0,0,94,20130220
2013,PHI,25,16,26,20,0,0,0,87,MIN,35,21,20,18,0,0,0,94,20130220
2013,MEM,19,24,23,22,0,0,0,88,TOR,14,18,25,25,0,0,0,82,20130220
2013,MIA,22,23,20,21,0,0,0,86,CHI,22,13,19,13,0,0,0,67,20130221
2013,SAS,34,24,34,24,0,0,0,116,LAC,21,22,21,26,0,0,0,90,20130221
2013,SAC,33,30,25,20,0,0,0,108,ATL,25,36,32,29,0,0,0,122,20130222
2013,HOU,34,27,23,22,0,0,0,106,BRK,31,22,22,21,0,0,0,96,20130222
2013,CHI,24,27,27,27,0,0,0,105,CHA,15,22,20,18,0,0,0,75,20130222
2013,SAS,25,14,29,25,8,0,0,101,GSW,25,13,29,26,14,0,0,107,20130222
2013,DET,17,19,16,30,0,0,0,82,IND,34,26,30,24,0,0,0,114,20130222
2013,POR,28,27,27,25,0,0,0,107,LAL,30,23,27,31,0,0,0,111,20130222
2013,ORL,21,17,15,29,0,0,0,82,MEM,22,21,24,21,0,0,0,88,20130222
2013,DAL,35,18,30,21,0,0,0,104,NOH,29,29,21,21,0,0,0,100,20130222
2013,MIN,23,35,25,28,0,0,0,111,OKC,33,33,34,27,0,0,0,127,20130222
2013,BOS,28,25,28,32,0,0,0,113,PHO,20,21,26,21,0,0,0,88,20130222
2013,NYK,32,19,19,28,0,0,0,98,TOR,32,16,31,21,0,0,0,100,20130222
2013,DEN,28,36,14,35,0,0,0,113,WAS,33,31,30,25,0,0,0,119,20130222
2013,DEN,31,29,23,30,0,0,0,113,CHA,29,25,20,25,0,0,0,99,20130223
2013,IND,16,23,24,27,0,0,0,90,DET,9,19,20,24,0,0,0,72,20130223
2013,UTA,23,26,20,25,0,0,0,94,LAC,25,26,36,20,0,0,0,107,20130223
2013,ATL,19,35,22,27,0,0,0,103,MIL,27,26,27,22,0,0,0,102,20130223
2013,CLE,26,25,28,39,0,0,0,118,ORL,25,26,21,22,0,0,0,94,20130223
2013,MIA,27,29,31,27,0,0,0,114,PHI,24,23,24,19,0,0,0,90,20130223
2013,HOU,32,25,26,20,0,0,0,103,WAS,22,24,31,28,0,0,0,105,20130223
2013,MEM,16,27,12,21,0,0,0,76,BRK,19,19,13,21,0,0,0,72,20130224
2013,LAL,27,27,25,24,0,0,0,103,DAL,30,24,21,24,0,0,0,99,20130224
2013,CLE,20,26,36,23,0,0,0,105,MIA,33,31,17,28,0,0,0,109,20130224
2013,GSW,18,34,24,24,0,0,0,100,MIN,32,23,26,18,0,0,0,99,20130224
2013,SAC,27,20,26,22,0,0,0,95,NOH,30,23,26,31,0,0,0,110,20130224
2013,PHI,22,18,27,26,0,0,0,93,NYK,24,28,24,23,0,0,0,99,20130224
2013,CHI,16,20,18,18,0,0,0,72,OKC,24,25,31,22,0,0,0,102,20130224
2013,SAS,19,35,24,19,0,0,0,97,PHO,21,19,21,26,0,0,0,87,20130224
2013,BOS,21,21,25,19,0,0,0,86,POR,27,22,22,21,0,0,0,92,20130224
2013,LAL,29,25,29,25,0,0,0,108,DEN,35,32,28,24,0,0,0,119,20130225
2013,ATL,27,34,27,26,0,0,0,114,DET,24,27,19,33,0,0,0,103,20130225
2013,WAS,17,23,23,27,0,0,0,90,TOR,16,16,22,30,0,0,0,84,20130225
2013,BOS,28,20,32,17,13,0,0,110,UTA,26,27,19,25,10,0,0,107,20130225
2013,CLE,19,29,27,26,0,0,0,101,CHI,22,26,23,27,0,0,0,98,20130226
2013,MIL,17,27,22,29,0,0,0,95,DAL,21,28,21,20,0,0,0,90,20130226
2013,GSW,25,28,20,24,0,0,0,97,IND,31,23,31,23,0,0,0,108,20130226
2013,CHA,30,15,18,21,0,0,0,84,LAC,24,30,28,24,0,0,0,106,20130226
2013,SAC,22,31,32,27,12,5,0,129,MIA,27,24,33,28,12,17,0,141,20130226
2013,BRK,31,26,16,28,0,0,0,101,NOH,20,21,24,32,0,0,0,97,20130226
2013,ORL,18,29,21,30,0,0,0,98,PHI,20,22,19,23,0,0,0,84,20130226
2013,MIN,15,18,18,26,6,0,0,83,PHO,16,31,11,19,7,0,0,84,20130226
2013,TOR,25,23,23,21,0,0,0,92,CLE,20,37,23,23,0,0,0,103,20130227
2013,MIL,33,22,26,29,0,0,0,110,HOU,36,19,25,27,0,0,0,107,20130227
2013,DAL,38,17,5,24,0,0,0,84,MEM,19,23,24,24,0,0,0,90,20130227
2013,GSW,18,37,26,24,0,0,0,105,NYK,27,31,26,25,0,0,0,109,20130227
2013,NOH,21,24,15,14,0,0,0,74,OKC,30,32,34,23,0,0,0,119,20130227
2013,SAC,36,31,31,27,0,0,0,125,ORL,22,22,24,33,0,0,0,101,20130227
2013,DEN,31,27,21,32,0,0,0,111,POR,25,25,32,27,0,0,0,109,20130227
2013,PHO,25,20,22,33,5,0,0,105,SAS,27,25,25,23,1,0,0,101,20130227
2013,ATL,30,26,26,20,0,0,0,102,UTA,25,23,18,25,0,0,0,91,20130227
2013,DET,28,23,31,14,0,0,0,96,WAS,24,31,13,27,0,0,0,95,20130227
2013,PHI,22,17,23,20,0,0,0,82,CHI,23,22,23,25,0,0,0,93,20130228
2013,LAC,26,23,27,23,0,0,0,99,IND,25,22,22,22,0,0,0,91,20130228
2013,MIN,22,25,28,19,0,0,0,94,LAL,28,29,34,25,0,0,0,116,20130228
2013,GSW,20,26,16,24,0,0,0,86,BOS,31,19,19,25,0,0,0,94,20130301
2013,DAL,22,26,29,21,0,0,0,98,BRK,21,28,14,27,0,0,0,90,20130301
2013,LAC,31,23,23,28,0,0,0,105,CLE,23,22,23,21,0,0,0,89,20130301
2013,OKC,29,18,28,28,0,0,0,103,DEN,26,30,29,20,0,0,0,105,20130301
2013,MEM,20,21,25,25,0,0,0,91,MIA,16,26,25,31,0,0,0,98,20130301
2013,DET,27,22,20,26,0,0,0,95,NOH,23,24,27,26,0,0,0,100,20130301
2013,HOU,31,33,22,32,0,0,0,118,ORL,32,29,26,23,0,0,0,110,20130301
2013,ATL,19,20,22,26,0,0,0,87,PHO,21,23,28,20,0,0,0,92,20130301
2013,SAC,21,28,20,33,0,0,0,102,SAS,34,29,34,33,0,0,0,130,20130301
2013,IND,17,22,25,29,0,0,0,93,TOR,13,21,17,30,0,0,0,81,20130301
2013,CHA,9,15,24,20,0,0,0,68,UTA,21,26,21,30,0,0,0,98,20130301
2013,NYK,26,28,19,23,0,0,0,96,WAS,23,25,29,11,0,0,0,88,20130301
2013,BRK,27,12,20,26,0,0,0,85,CHI,27,26,24,19,0,0,0,96,20130302
2013,TOR,32,23,19,30,10,0,0,114,MIL,23,31,28,22,18,0,0,122,20130302
2013,GSW,31,23,27,16,0,0,0,97,PHI,20,31,31,22,0,0,0,104,20130302
2013,MIN,19,25,27,23,0,0,0,94,POR,31,20,32,26,0,0,0,109,20130302
2013,DAL,33,28,17,25,0,0,0,103,HOU,31,33,44,28,0,0,0,136,20130303
2013,CHI,21,19,26,26,0,0,0,92,IND,32,15,22,28,0,0,0,97,20130303
2013,OKC,27,27,28,26,0,0,0,108,LAC,20,21,32,31,0,0,0,104,20130303
2013,ATL,26,19,28,25,0,0,0,98,LAL,30,22,27,20,0,0,0,99,20130303
2013,MIA,23,22,28,26,0,0,0,99,NYK,22,37,18,16,0,0,0,93,20130303
2013,MEM,29,31,22,26,0,0,0,108,ORL,19,16,22,25,0,0,0,82,20130303
2013,CHA,27,13,19,24,0,0,0,83,SAC,27,27,43,22,0,0,0,119,20130303
2013,DET,19,21,16,19,0,0,0,75,SAS,32,28,29,25,0,0,0,114,20130303
2013,PHI,22,27,19,19,0,0,0,87,WAS,26,24,22,18,0,0,0,90,20130303
2013,NYK,24,25,21,32,0,0,0,102,CLE,34,27,13,23,0,0,0,97,20130304
2013,ATL,27,23,23,15,0,0,0,88,DEN,28,30,23,23,0,0,0,104,20130304
2013,TOR,28,26,36,28,0,0,0,118,GSW,31,31,21,42,0,0,0,125,20130304
2013,UTA,24,24,17,34,9,0,0,108,MIL,20,25,30,24,10,0,0,109,20130304
2013,MIA,22,28,19,28,0,0,0,97,MIN,16,27,20,18,0,0,0,81,20130304
2013,ORL,20,16,34,35,0,0,0,105,NOH,23,23,30,26,0,0,0,102,20130304
2013,CHA,25,30,24,26,0,0,0,105,POR,31,37,23,31,0,0,0,122,20130304
2013,LAL,28,27,34,16,0,0,0,105,OKC,37,34,26,25,0,0,0,122,20130305
2013,BOS,26,27,26,30,0,0,0,109,PHI,23,23,28,27,0,0,0,101,20130305
2013,DEN,24,26,36,34,0,0,0,120,SAC,22,28,29,34,0,0,0,113,20130305
2013,PHI,19,28,23,26,0,0,0,96,ATL,26,33,32,16,0,0,0,107,20130306
2013,BRK,26,17,28,28,0,0,0,99,CHA,29,24,9,16,0,0,0,78,20130306
2013,UTA,19,32,25,25,0,0,0,101,CLE,23,26,19,36,0,0,0,104,20130306
2013,HOU,25,31,27,25,0,0,0,108,DAL,34,26,27,25,0,0,0,112,20130306
2013,NYK,24,20,21,22,0,0,0,87,DET,19,19,27,12,0,0,0,77,20130306
2013,SAC,21,23,19,20,0,0,0,83,GSW,28,13,28,18,0,0,0,87,20130306
2013,BOS,19,23,16,25,0,0,0,83,IND,27,22,19,13,0,0,0,81,20130306
2013,MIL,32,26,24,19,0,0,0,101,LAC,34,32,23,28,0,0,0,117,20130306
2013,POR,26,24,17,18,0,0,0,85,MEM,18,20,27,26,0,0,0,91,20130306
2013,ORL,18,22,34,22,0,0,0,96,MIA,25,30,22,20,0,0,0,97,20130306
2013,WAS,29,14,20,19,0,0,0,82,MIN,24,24,17,22,0,0,0,87,20130306
2013,LAL,28,20,27,33,0,0,0,108,NOH,28,39,26,9,0,0,0,102,20130306
2013,TOR,28,26,18,26,0,0,0,98,PHO,24,16,15,16,0,0,0,71,20130306
2013,CHI,23,29,16,15,0,0,0,83,SAS,22,25,25,29,0,0,0,101,20130306
2013,LAC,25,24,26,17,0,0,0,92,DEN,27,22,36,22,0,0,0,107,20130307
2013,OKC,35,24,16,20,0,0,0,95,NYK,26,30,25,13,0,0,0,94,20130307
2013,ATL,26,21,21,26,8,0,0,102,BOS,28,24,20,22,13,0,0,107,20130308
2013,WAS,14,19,25,20,0,0,0,78,BRK,38,21,15,21,0,0,0,95,20130308
2013,OKC,28,36,26,26,0,0,0,116,CHA,29,21,16,28,0,0,0,94,20130308
2013,UTA,23,23,24,18,0,0,0,88,CHI,26,29,17,17,0,0,0,89,20130308
2013,MEM,23,25,32,23,0,0,0,103,CLE,19,32,18,23,0,0,0,92,20130308
2013,DAL,22,28,26,26,0,0,0,102,DET,17,25,29,28,0,0,0,99,20130308
2013,HOU,21,29,23,21,0,0,0,94,GSW,30,18,28,12,0,0,0,88,20130308
2013,TOR,37,22,30,20,7,0,0,116,LAL,25,28,26,30,9,0,0,118,20130308
2013,PHI,24,27,24,18,0,0,0,93,MIA,28,19,29,26,0,0,0,102,20130308
2013,IND,22,31,35,27,0,0,0,115,ORL,15,23,25,23,0,0,0,86,20130308
2013,PHO,30,27,25,30,0,0,0,112,SAC,32,27,30,32,0,0,0,121,20130308
2013,POR,27,30,33,46,0,0,0,136,SAS,29,28,25,24,0,0,0,106,20130308
2013,BRK,23,28,25,17,0,0,0,93,ATL,23,14,20,23,0,0,0,80,20130309
2013,MIN,24,25,21,18,0,0,0,88,DEN,27,23,33,28,0,0,0,111,20130309
2013,MIL,24,23,30,26,0,0,0,103,GSW,28,20,22,23,0,0,0,93,20130309
2013,NOH,19,22,19,25,0,0,0,85,MEM,25,22,31,18,0,0,0,96,20130309
2013,UTA,21,17,21,25,0,0,0,84,NYK,25,30,23,35,0,0,0,113,20130309
2013,HOU,28,18,30,29,0,0,0,105,PHO,24,26,27,30,0,0,0,107,20130309
2013,CHA,24,18,22,23,0,0,0,87,WAS,27,32,21,24,0,0,0,104,20130309
2013,DET,22,30,18,27,0,0,0,97,LAC,32,38,28,31,0,0,0,129,20130310
2013,CHI,16,24,21,20,0,0,0,81,LAL,20,24,29,17,0,0,0,90,20130310
2013,IND,20,26,19,26,0,0,0,91,MIA,29,27,23,26,0,0,0,105,20130310
2013,DAL,21,35,22,22,0,0,0,100,MIN,20,24,17,16,0,0,0,77,20130310
2013,POR,22,22,25,27,0,0,0,96,NOH,22,31,23,22,0,0,0,98,20130310
2013,BOS,22,23,20,14,0,0,0,79,OKC,23,27,18,23,0,0,0,91,20130310
2013,PHI,30,21,21,19,0,0,0,91,ORL,28,28,17,26,0,0,0,99,20130310
2013,MIL,26,35,24,30,0,0,0,115,SAC,29,21,30,33,0,0,0,113,20130310
2013,CLE,27,28,19,22,0,0,0,96,TOR,20,26,33,21,0,0,0,100,20130310
2013,NYK,23,12,19,9,0,0,0,63,GSW,26,24,25,17,0,0,0,92,20130311
2013,BRK,28,18,29,22,0,0,0,97,PHI,24,29,29,24,0,0,0,106,20130311
2013,DEN,25,28,27,28,0,0,0,108,PHO,26,24,24,19,0,0,0,93,20130311
2013,OKC,32,18,24,19,0,0,0,93,SAS,22,35,26,22,0,0,0,105,20130311
2013,DET,19,18,33,20,0,0,0,90,UTA,20,31,25,27,0,0,0,103,20130311
2013,NOH,19,29,30,20,0,0,0,98,BRK,28,29,23,28,0,0,0,108,20130312
2013,BOS,20,26,15,13,0,0,0,74,CHA,19,30,27,24,0,0,0,100,20130312
2013,WAS,33,16,16,25,0,0,0,90,CLE,20,30,26,19,0,0,0,95,20130312
2013,ATL,18,26,21,16,0,0,0,81,MIA,26,31,22,19,0,0,0,98,20130312
2013,DAL,28,35,27,25,0,0,0,115,MIL,35,20,24,29,0,0,0,108,20130312
2013,SAS,28,10,22,23,0,0,0,83,MIN,24,29,24,30,0,0,0,107,20130312
2013,LAL,22,28,26,30,0,0,0,106,ORL,23,23,22,29,0,0,0,97,20130312
2013,MEM,21,27,20,34,0,0,0,102,POR,21,19,18,39,0,0,0,97,20130312
2013,LAL,19,24,31,18,0,0,0,92,ATL,26,29,21,20,0,0,0,96,20130313
2013,TOR,22,18,22,26,0,0,0,88,BOS,21,28,32,31,0,0,0,112,20130313
2013,NYK,26,16,27,25,0,0,0,94,DEN,31,33,33,20,0,0,0,117,20130313
2013,DET,20,30,23,24,0,0,0,97,GSW,28,22,30,25,0,0,0,105,20130313
2013,PHO,25,20,17,19,0,0,0,81,HOU,30,28,32,21,0,0,0,111,20130313
2013,MIN,28,26,15,22,0,0,0,91,IND,35,27,20,25,0,0,0,107,20130313
2013,MEM,24,30,21,21,0,0,0,96,LAC,24,28,17,16,0,0,0,85,20130313
2013,UTA,19,9,28,31,0,0,0,87,OKC,29,21,29,31,0,0,0,110,20130313
2013,MIA,21,30,20,27,0,0,0,98,PHI,22,17,27,28,0,0,0,94,20130313
2013,CHI,20,16,24,19,0,0,0,79,SAC,34,31,28,28,0,0,0,121,20130313
2013,MIL,21,23,34,15,0,0,0,93,WAS,30,30,15,31,0,0,0,106,20130313
2013,NYK,30,18,14,28,0,0,0,90,POR,22,29,27,27,0,0,0,105,20130314
2013,DAL,17,24,25,25,0,0,0,91,SAS,22,28,23,19,0,0,0,92,20130314
2013,PHO,23,23,22,26,0,0,0,94,ATL,27,30,25,25,0,0,0,107,20130315
2013,CLE,24,22,22,18,0,0,0,86,DAL,16,22,29,29,0,0,0,96,20130315
2013,MEM,18,29,19,14,0,0,0,80,DEN,23,25,10,29,0,0,0,87,20130315
2013,CHI,28,28,38,19,0,0,0,113,GSW,27,19,17,32,0,0,0,95,20130315
2013,MIN,27,30,23,20,0,0,0,100,HOU,22,17,35,34,0,0,0,108,20130315
2013,LAL,16,30,22,31,0,0,0,99,IND,19,22,28,24,0,0,0,93,20130315
2013,MIA,26,25,33,23,0,0,0,107,MIL,27,15,26,26,0,0,0,94,20130315
2013,ORL,26,30,28,20,0,0,0,104,OKC,39,34,22,22,0,0,0,117,20130315
2013,CHA,17,25,26,10,0,0,0,78,TOR,22,26,21,23,0,0,0,92,20130315
2013,NOH,30,20,14,23,0,0,0,87,WAS,26,24,24,22,0,0,0,96,20130315
2013,CHA,24,19,23,22,0,0,0,88,BOS,24,26,33,22,0,0,0,105,20130316
2013,IND,24,25,23,19,0,0,0,91,PHI,23,25,23,27,0,0,0,98,20130316
2013,DET,30,27,18,26,0,0,0,101,POR,24,28,25,35,0,0,0,112,20130316
2013,CLE,30,31,29,23,0,0,0,113,SAS,34,32,25,28,0,0,0,119,20130316
2013,MEM,21,29,9,25,0,0,0,84,UTA,22,23,24,21,0,0,0,90,20130316
2013,PHO,29,30,24,22,0,0,0,105,WAS,27,39,36,25,0,0,0,127,20130316
2013,ATL,21,30,20,34,0,0,0,105,BRK,24,25,24,20,0,0,0,93,20130317
2013,OKC,24,26,23,34,0,0,0,107,DAL,26,23,23,29,0,0,0,101,20130317
2013,GSW,18,36,21,33,0,0,0,108,HOU,10,21,29,18,0,0,0,78,20130317
2013,NYK,18,19,23,20,0,0,0,80,LAC,21,23,28,21,0,0,0,93,20130317
2013,SAC,27,29,20,26,0,0,0,102,LAL,33,23,30,27,0,0,0,113,20130317
2013,ORL,25,29,27,28,0,0,0,109,MIL,18,26,26,45,0,0,0,115,20130317
2013,NOH,27,25,21,22,0,0,0,95,MIN,28,22,26,21,0,0,0,97,20130317
2013,MIA,27,28,21,32,0,0,0,108,TOR,19,24,30,18,0,0,0,91,20130317
2013,DAL,34,34,30,29,0,0,0,127,ATL,25,30,30,28,0,0,0,113,20130318
2013,MIA,19,34,25,27,0,0,0,105,BOS,31,28,23,21,0,0,0,103,20130318
2013,WAS,29,30,30,25,0,0,0,114,CHA,32,31,31,25,0,0,0,119,20130318
2013,DEN,21,32,26,26,14,0,0,119,CHI,20,25,28,32,13,0,0,118,20130318
2013,IND,27,33,27,24,0,0,0,111,CLE,24,21,17,28,0,0,0,90,20130318
2013,BRK,36,23,31,29,0,0,0,119,DET,23,22,14,23,0,0,0,82,20130318
2013,MIN,20,19,14,24,0,0,0,77,MEM,22,23,29,18,0,0,0,92,20130318
2013,GSW,19,26,24,24,0,0,0,93,NOH,22,14,25,11,0,0,0,72,20130318
2013,POR,28,22,22,28,0,0,0,100,PHI,32,26,20,23,0,0,0,101,20130318
2013,LAL,25,19,22,10,0,0,0,76,PHO,21,26,24,28,0,0,0,99,20130318
2013,NYK,23,19,24,24,0,0,0,90,UTA,21,23,19,20,0,0,0,83,20130318
2013,ORL,12,17,26,18,0,0,0,73,IND,19,23,27,26,0,0,0,95,20130319
2013,POR,23,8,26,38,0,0,0,95,MIL,27,31,19,25,0,0,0,102,20130319
2013,DEN,26,39,24,25,0,0,0,114,OKC,34,32,16,22,0,0,0,104,20130319
2013,LAC,23,31,29,18,0,0,0,101,SAC,23,33,22,38,0,0,0,116,20130319
2013,MIL,18,25,16,31,0,0,0,90,ATL,18,30,29,21,0,0,0,98,20130320
2013,TOR,26,22,23,30,0,0,0,101,CHA,22,31,21,33,0,0,0,107,20130320
2013,MIA,24,10,34,30,0,0,0,98,CLE,32,23,22,18,0,0,0,95,20130320
2013,BRK,22,29,34,28,0,0,0,113,DAL,32,19,26,19,0,0,0,96,20130320
2013,UTA,17,16,28,32,0,0,0,93,HOU,25,27,28,20,0,0,0,100,20130320
2013,PHI,20,16,22,14,0,0,0,72,LAC,20,26,28,27,0,0,0,101,20130320
2013,OKC,15,23,19,26,6,0,0,89,MEM,21,23,14,25,7,0,0,90,20130320
2013,BOS,31,24,12,19,0,0,0,86,NOH,22,23,22,20,0,0,0,87,20130320
2013,ORL,15,31,19,29,0,0,0,94,NYK,26,25,32,23,0,0,0,106,20130320
2013,WAS,25,34,15,14,0,0,0,88,PHO,26,19,20,14,0,0,0,79,20130320
2013,GSW,22,25,23,23,0,0,0,93,SAS,22,38,19,25,0,0,0,104,20130320
2013,POR,20,32,28,19,0,0,0,99,CHI,21,16,16,36,0,0,0,89,20130321
2013,PHI,22,22,27,29,0,0,0,100,DEN,17,34,24,26,0,0,0,101,20130321
2013,MIN,26,31,20,21,0,0,0,98,SAC,25,28,26,22,0,0,0,101,20130321
2013,POR,21,24,28,31,0,0,0,104,ATL,24,21,31,17,0,0,0,93,20130322
2013,BOS,21,23,24,26,0,0,0,94,DAL,30,25,24,25,0,0,0,104,20130322
2013,CLE,25,18,18,17,0,0,0,78,HOU,28,30,29,29,0,0,0,116,20130322
2013,MIL,23,20,11,24,0,0,0,78,IND,23,22,28,29,0,0,0,102,20130322
2013,WAS,19,22,31,31,0,0,0,103,LAL,35,22,17,26,0,0,0,100,20130322
2013,DET,28,26,14,21,0,0,0,89,MIA,22,29,22,30,0,0,0,103,20130322
2013,MEM,21,22,15,25,0,0,0,83,NOH,14,34,19,23,0,0,0,90,20130322
2013,OKC,22,25,23,27,0,0,0,97,ORL,14,20,32,23,0,0,0,89,20130322
2013,MIN,31,36,28,22,0,0,0,117,PHO,18,21,30,17,0,0,0,86,20130322
2013,UTA,21,20,24,25,7,0,0,97,SAS,18,20,25,27,14,0,0,104,20130322
2013,NYK,25,25,27,22,0,0,0,99,TOR,22,15,34,23,0,0,0,94,20130322
2013,DET,23,24,22,23,0,0,0,92,CHA,24,26,26,15,0,0,0,91,20130323
2013,IND,22,22,23,17,0,0,0,84,CHI,16,23,29,19,0,0,0,87,20130323
2013,SAC,17,23,31,24,0,0,0,95,DEN,27,23,20,31,0,0,0,101,20130323
2013,WAS,17,23,24,28,0,0,0,92,GSW,29,29,24,19,0,0,0,101,20130323
2013,BRK,24,25,26,20,0,0,0,95,LAC,25,22,23,31,0,0,0,101,20130323
2013,BOS,31,20,22,33,0,0,0,106,MEM,29,32,24,25,0,0,0,110,20130323
2013,TOR,17,30,20,17,0,0,0,84,NYK,21,38,23,28,0,0,0,110,20130323
2013,UTA,27,25,19,37,0,0,0,108,DAL,24,29,30,30,0,0,0,113,20130324
2013,SAS,20,26,21,28,0,0,0,95,HOU,22,21,31,22,0,0,0,96,20130324
2013,CHA,19,20,18,20,0,0,0,77,MIA,23,24,26,36,0,0,0,109,20130324
2013,ATL,24,26,24,30,0,0,0,104,MIL,24,25,25,25,0,0,0,99,20130324
2013,CHI,23,33,22,26,0,0,0,104,MIN,16,27,25,29,0,0,0,97,20130324
2013,POR,19,28,21,15,0,0,0,83,OKC,24,21,30,28,0,0,0,103,20130324
2013,BRK,25,30,20,27,0,0,0,102,PHO,25,18,33,24,0,0,0,100,20130324
2013,PHI,22,36,33,26,0,0,0,117,SAC,31,27,24,21,0,0,0,103,20130324
2013,LAL,16,24,36,27,0,0,0,103,GSW,28,35,31,15,0,0,0,109,20130325
2013,ATL,26,17,20,31,0,0,0,94,IND,26,32,27,15,0,0,0,100,20130325
2013,DEN,18,20,30,18,0,0,0,86,NOH,27,32,27,24,0,0,0,110,20130325
2013,MIA,28,27,23,30,0,0,0,108,ORL,28,18,22,26,0,0,0,94,20130325
2013,PHI,23,19,26,23,0,0,0,91,UTA,27,31,27,22,0,0,0,107,20130325
2013,MEM,24,31,19,20,0,0,0,94,WAS,26,29,21,31,0,0,0,107,20130325
2013,NYK,28,30,26,16,0,0,0,100,BOS,24,20,25,16,0,0,0,85,20130326
2013,LAC,27,21,25,24,5,0,0,102,DAL,22,28,24,23,12,0,0,109,20130326
2013,MIN,19,25,38,23,0,0,0,105,DET,16,22,16,28,0,0,0,82,20130326
2013,ORL,39,19,24,26,0,0,0,108,CHA,20,31,32,31,0,0,0,114,20130327
2013,MIA,22,24,22,29,0,0,0,97,CHI,32,23,14,32,0,0,0,101,20130327
2013,BOS,24,22,21,26,0,0,0,93,CLE,18,27,28,19,0,0,0,92,20130327
2013,SAC,24,23,30,28,0,0,0,105,GSW,27,17,22,32,0,0,0,98,20130327
2013,IND,35,23,24,18,0,0,0,100,HOU,19,30,22,20,0,0,0,91,20130327
2013,LAL,26,24,41,29,0,0,0,120,MIN,23,23,33,38,0,0,0,117,20130327
2013,LAC,27,29,23,26,0,0,0,105,NOH,26,22,29,14,0,0,0,91,20130327
2013,MEM,25,16,29,31,0,0,0,101,NYK,37,32,17,22,0,0,0,108,20130327
2013,WAS,23,22,21,14,0,0,0,80,OKC,29,24,30,20,0,0,0,103,20130327
2013,MIL,20,28,30,14,0,0,0,92,PHI,27,27,22,24,0,0,0,100,20130327
2013,BRK,37,27,31,16,0,0,0,111,POR,17,24,28,24,0,0,0,93,20130327
2013,DEN,20,34,21,24,0,0,0,99,SAS,22,29,32,17,0,0,0,100,20130327
2013,ATL,20,24,31,32,0,0,0,107,TOR,25,29,21,13,0,0,0,88,20130327
2013,PHO,23,21,27,17,0,0,0,88,UTA,34,19,22,28,0,0,0,103,20130327
2013,IND,23,18,34,28,0,0,0,103,DAL,18,23,17,20,0,0,0,78,20130328
2013,LAL,25,31,21,26,0,0,0,103,MIL,18,35,29,31,0,0,0,113,20130328
2013,SAC,38,26,24,29,0,0,0,117,PHO,32,18,28,25,0,0,0,103,20130328
2013,ATL,30,26,24,27,0,0,0,107,BOS,32,34,26,26,0,0,0,118,20130329
2013,PHI,19,26,32,20,0,0,0,97,CLE,24,21,21,21,0,0,0,87,20130329
2013,BRK,23,15,28,21,0,0,0,87,DEN,26,29,25,29,0,0,0,109,20130329
2013,TOR,19,27,36,17,0,0,0,99,DET,26,19,15,22,0,0,0,82,20130329
2013,HOU,29,24,16,25,0,0,0,94,MEM,31,30,23,19,0,0,0,103,20130329
2013,OKC,23,25,29,16,0,0,0,93,MIN,23,30,27,21,0,0,0,101,20130329
2013,MIA,32,28,21,27,0,0,0,108,NOH,22,21,17,29,0,0,0,89,20130329
2013,CHA,20,27,22,33,0,0,0,102,NYK,38,31,19,23,0,0,0,111,20130329
2013,WAS,23,23,25,21,0,0,0,92,ORL,24,34,20,19,0,0,0,97,20130329
2013,UTA,22,20,32,31,0,0,0,105,POR,30,22,23,20,0,0,0,95,20130329
2013,LAC,28,34,17,23,0,0,0,102,SAS,30,31,24,19,0,0,0,104,20130329
2013,ORL,27,17,16,28,0,0,0,88,ATL,23,22,22,30,0,0,0,97,20130330
2013,CHI,23,33,19,23,0,0,0,98,DAL,24,29,22,25,0,0,0,100,20130330
2013,POR,31,24,23,20,0,0,0,98,GSW,36,29,31,29,0,0,0,125,20130330
2013,LAC,29,21,13,18,0,0,0,81,HOU,28,27,30,13,0,0,0,98,20130330
2013,OKC,32,24,27,26,0,0,0,109,MIL,28,18,37,16,0,0,0,99,20130330
2013,MEM,23,22,20,34,0,0,0,99,MIN,30,20,17,19,0,0,0,86,20130330
2013,CHA,31,15,25,21,0,0,0,92,PHI,22,27,24,27,0,0,0,100,20130330
2013,IND,27,30,29,26,0,0,0,112,PHO,21,28,27,28,0,0,0,104,20130330
2013,LAL,25,28,29,21,0,0,0,103,SAC,37,20,18,23,0,0,0,98,20130330
2013,BRK,28,26,20,33,0,0,0,107,UTA,33,19,31,33,0,0,0,116,20130330
2013,DET,24,33,17,20,0,0,0,94,CHI,20,33,18,24,0,0,0,95,20130331
2013,CLE,21,28,24,19,0,0,0,92,NOH,23,25,36,28,0,0,0,112,20130331
2013,BOS,23,25,21,20,0,0,0,89,NYK,28,37,21,22,0,0,0,108,20130331
2013,MIA,22,18,31,17,0,0,0,88,SAS,24,21,19,22,0,0,0,86,20130331
2013,TOR,25,25,26,16,0,0,0,92,WAS,27,33,30,19,0,0,0,109,20130331
2013,CLE,19,25,24,26,0,0,0,94,ATL,25,27,27,23,0,0,0,102,20130401
2013,ORL,14,29,31,29,0,0,0,103,HOU,32,33,25,21,0,0,0,111,20130401
2013,IND,29,22,30,28,0,0,0,109,LAC,21,22,22,41,0,0,0,106,20130401
2013,SAS,21,23,24,22,0,0,0,90,MEM,21,16,25,30,0,0,0,92,20130401
2013,CHA,25,35,24,18,0,0,0,102,MIL,29,40,31,31,0,0,0,131,20130401
2013,BOS,25,27,26,22,0,0,0,100,MIN,27,30,27,26,0,0,0,110,20130401
2013,DET,25,29,21,33,0,0,0,108,TOR,24,31,24,19,0,0,0,98,20130401
2013,POR,19,30,25,28,0,0,0,102,UTA,29,27,31,25,0,0,0,112,20130401
2013,DAL,21,19,21,20,0,0,0,81,LAL,24,31,17,29,0,0,0,101,20130402
2013,NYK,27,23,28,24,0,0,0,102,MIA,25,33,18,14,0,0,0,90,20130402
2013,CHI,24,25,20,17,0,0,0,86,WAS,18,24,28,20,0,0,0,90,20130402
2013,NYK,23,24,21,27,0,0,0,95,ATL,18,22,28,14,0,0,0,82,20130403
2013,DET,30,14,23,26,0,0,0,93,BOS,25,29,20,24,0,0,0,98,20130403
2013,PHI,27,18,16,22,0,0,0,83,CHA,19,21,24,24,0,0,0,88,20130403
2013,BRK,28,38,29,18,0,0,0,113,CLE,20,16,32,27,0,0,0,95,20130403
2013,NOH,28,14,28,18,0,0,0,88,GSW,19,32,23,24,0,0,0,98,20130403
2013,PHO,19,31,20,31,0,0,0,101,LAC,29,28,38,31,0,0,0,126,20130403
2013,MIN,34,21,32,20,0,0,0,107,MIL,23,29,29,17,0,0,0,98,20130403
2013,MEM,32,25,20,17,0,0,0,94,POR,21,25,18,12,0,0,0,76,20130403
2013,HOU,27,32,29,24,0,0,0,112,SAC,26,29,28,19,0,0,0,102,20130403
2013,ORL,23,23,19,19,0,0,0,84,SAS,28,23,22,25,0,0,0,98,20130403
2013,WAS,24,26,12,16,0,0,0,78,TOR,23,16,29,20,0,0,0,88,20130403
2013,DEN,28,28,25,32,0,0,0,113,UTA,23,28,17,28,0,0,0,96,20130403
2013,CHI,13,23,29,27,0,0,0,92,BRK,26,21,20,23,0,0,0,90,20130404
2013,DAL,23,24,30,17,0,0,0,94,DEN,19,28,23,25,0,0,0,95,20130404
2013,SAS,18,26,27,17,0,0,0,88,OKC,29,23,25,23,0,0,0,100,20130404
2013,PHI,40,18,25,18,0,0,0,101,ATL,26,19,20,25,0,0,0,90,20130405
2013,CLE,26,26,22,23,0,0,0,97,BOS,28,24,16,23,0,0,0,91,20130405
2013,MIA,26,22,18,23,0,0,0,89,CHA,22,23,8,26,0,0,0,79,20130405
2013,ORL,19,24,27,16,0,0,0,86,CHI,14,26,26,21,0,0,0,87,20130405
2013,OKC,26,18,28,25,0,0,0,97,IND,23,20,24,8,0,0,0,75,20130405
2013,MEM,18,21,23,22,0,0,0,84,LAL,25,21,22,18,0,0,0,86,20130405
2013,TOR,18,28,25,24,0,0,0,95,MIN,24,24,25,20,0,0,0,93,20130405
2013,MIL,19,26,21,17,0,0,0,83,NYK,19,17,42,23,0,0,0,101,20130405
2013,GSW,23,32,32,24,0,0,0,111,PHO,37,27,14,29,0,0,0,107,20130405
2013,HOU,35,28,29,24,0,0,0,116,POR,31,25,21,21,0,0,0,98,20130405
2013,DAL,18,41,33,25,0,0,0,117,SAC,27,26,28,27,0,0,0,108,20130405
2013,NOH,24,19,24,16,0,0,0,83,UTA,17,28,26,24,0,0,0,95,20130405
2013,CHA,23,31,21,21,0,0,0,96,BRK,29,24,30,22,0,0,0,105,20130406
2013,HOU,35,21,27,31,0,0,0,114,DEN,25,39,38,30,0,0,0,132,20130406
2013,PHI,18,28,30,11,0,0,0,87,MIA,33,17,27,29,0,0,0,106,20130406
2013,TOR,16,26,13,28,0,0,0,83,MIL,26,35,19,20,0,0,0,100,20130406
2013,DET,25,30,23,23,0,0,0,101,MIN,33,28,20,26,0,0,0,107,20130406
2013,ATL,20,20,29,28,0,0,0,97,SAS,21,30,22,26,0,0,0,99,20130406
2013,IND,26,22,18,19,0,0,0,85,WAS,31,20,26,27,0,0,0,104,20130406
2013,WAS,27,25,19,25,0,0,0,96,BOS,28,28,31,20,0,0,0,107,20130407
2013,ORL,24,24,18,19,0,0,0,85,CLE,22,22,18,29,0,0,0,91,20130407
2013,CHI,26,20,21,18,0,0,0,85,DET,23,27,25,24,0,0,0,99,20130407
2013,UTA,24,32,21,20,0,0,0,97,GSW,27,21,21,21,0,0,0,90,20130407
2013,LAL,25,24,21,25,0,0,0,95,LAC,30,26,26,27,0,0,0,109,20130407
2013,NYK,30,35,31,29,0,0,0,125,OKC,31,25,33,31,0,0,0,120,20130407
2013,NOH,17,22,35,21,0,0,0,95,PHO,26,17,19,30,0,0,0,92,20130407
2013,DAL,29,27,25,15,0,0,0,96,POR,18,14,29,30,0,0,0,91,20130407
2013,MEM,25,18,25,21,0,0,0,89,SAC,16,28,20,23,0,0,0,87,20130407
2013,PHI,18,20,24,21,0,0,0,83,BRK,31,25,29,19,0,0,0,104,20130409
2013,TOR,31,23,27,20,0,0,0,101,CHI,22,28,18,30,0,0,0,98,20130409
2013,MIN,26,28,16,19,0,0,0,89,GSW,26,29,31,19,0,0,0,105,20130409
2013,PHO,21,32,21,24,0,0,0,98,HOU,29,22,27,23,0,0,0,101,20130409
2013,CLE,26,27,31,10,0,0,0,94,IND,29,19,16,35,0,0,0,99,20130409
2013,NOH,22,28,20,26,0,0,0,96,LAL,27,18,25,34,0,0,0,104,20130409
2013,CHA,19,21,17,18,0,0,0,75,MEM,28,21,14,31,0,0,0,94,20130409
2013,MIL,21,25,13,24,0,0,0,83,MIA,26,21,24,23,0,0,0,94,20130409
2013,WAS,23,20,28,28,0,0,0,99,NYK,36,22,37,25,0,0,0,120,20130409
2013,OKC,26,19,23,22,0,0,0,90,UTA,19,16,26,19,0,0,0,80,20130409
2013,BRK,22,31,26,22,0,0,0,101,BOS,21,22,26,24,0,0,0,93,20130410
2013,DET,28,25,21,37,0,0,0,111,CLE,24,25,26,29,0,0,0,104,20130410
2013,PHO,28,33,20,21,0,0,0,102,DAL,21,30,20,20,0,0,0,91,20130410
2013,SAS,18,19,26,23,0,0,0,86,DEN,11,27,31,27,0,0,0,96,20130410
2013,MIN,20,26,26,23,0,0,0,95,LAC,26,32,30,23,0,0,0,111,20130410
2013,MIL,16,29,21,29,8,0,0,103,ORL,30,18,22,25,18,0,0,113,20130410
2013,ATL,29,30,34,31,0,0,0,124,PHI,27,24,22,28,0,0,0,101,20130410
2013,LAL,33,28,27,25,0,0,0,113,POR,41,28,21,16,0,0,0,106,20130410
2013,NOH,28,20,25,37,0,0,0,110,SAC,35,30,30,26,0,0,0,121,20130410
2013,MIA,25,21,23,34,0,0,0,103,WAS,22,28,22,26,0,0,0,98,20130410
2013,NYK,30,29,23,23,6,0,0,111,CHI,23,31,26,25,13,0,0,118,20130411
2013,OKC,31,29,36,20,0,0,0,116,GSW,27,27,23,20,0,0,0,97,20130411
2013,MIL,30,24,28,22,0,0,0,104,ATL,24,16,35,34,0,0,0,109,20130412
2013,NYK,27,25,23,26,0,0,0,101,CLE,24,19,21,27,0,0,0,91,20130412
2013,DEN,26,29,22,22,6,0,0,105,DAL,21,27,30,21,9,0,0,108,20130412
2013,CHA,30,23,20,20,0,0,0,93,DET,23,36,28,26,0,0,0,113,20130412
2013,MEM,24,25,15,18,0,0,0,82,HOU,15,21,23,19,0,0,0,78,20130412
2013,BRK,34,35,23,25,0,0,0,117,IND,27,23,35,24,0,0,0,109,20130412
2013,GSW,32,25,33,26,0,0,0,116,LAL,26,31,28,33,0,0,0,118,20130412
2013,BOS,27,23,25,26,0,0,0,101,MIA,17,41,29,22,0,0,0,109,20130412
2013,LAC,24,19,14,39,0,0,0,96,NOH,25,15,23,30,0,0,0,93,20130412
2013,OKC,30,25,26,25,0,0,0,106,POR,26,28,7,29,0,0,0,90,20130412
2013,SAC,13,37,24,27,0,0,0,101,SAS,23,37,24,24,0,0,0,108,20130412
2013,CHI,22,21,22,23,0,0,0,88,TOR,20,27,26,24,0,0,0,97,20130412
2013,MIN,22,32,27,19,0,0,0,100,UTA,30,23,29,25,0,0,0,107,20130412
2013,PHI,24,24,26,23,0,0,0,97,WAS,31,18,16,21,0,0,0,86,20130412
2013,MIL,23,21,15,26,0,0,0,85,CHA,24,25,27,19,0,0,0,95,20130413
2013,LAC,24,27,17,23,0,0,0,91,MEM,23,28,22,14,0,0,0,87,20130413
2013,PHO,28,25,20,20,0,0,0,93,MIN,22,28,27,28,0,0,0,105,20130413
2013,BOS,23,34,28,35,0,0,0,120,ORL,17,20,27,24,0,0,0,88,20130413
2013,POR,21,29,28,31,0,0,0,109,DEN,37,30,22,29,0,0,0,118,20130414
2013,SAC,24,20,32,24,0,0,0,100,HOU,33,29,32,27,0,0,0,121,20130414
2013,SAS,23,20,18,25,0,0,0,86,LAL,22,21,18,30,0,0,0,91,20130414
2013,CHI,22,32,23,16,0,0,0,93,MIA,30,26,30,19,0,0,0,105,20130414
2013,DAL,33,29,19,26,0,0,0,107,NOH,19,21,27,22,0,0,0,89,20130414
2013,IND,15,25,20,20,0,0,0,80,NYK,23,24,22,21,0,0,0,90,20130414
2013,CLE,19,15,17,26,0,0,0,77,PHI,32,21,21,17,0,0,0,91,20130414
2013,BRK,20,12,27,28,0,0,0,87,TOR,24,27,19,23,0,0,0,93,20130414
2013,WAS,34,22,21,24,0,0,0,101,BRK,21,29,23,33,0,0,0,106,20130415
2013,NYK,17,28,22,28,0,0,0,95,CHA,30,24,30,22,0,0,0,106,20130415
2013,MIA,18,31,31,16,0,0,0,96,CLE,22,30,19,24,0,0,0,95,20130415
2013,MEM,21,17,30,35,0,0,0,103,DAL,29,17,21,30,0,0,0,97,20130415
2013,PHI,23,31,21,26,0,0,0,101,DET,30,21,33,25,0,0,0,109,20130415
2013,SAS,28,29,22,27,0,0,0,106,GSW,27,27,28,34,0,0,0,116,20130415
2013,DEN,32,24,25,31,0,0,0,112,MIL,26,27,24,34,0,0,0,111,20130415
2013,UTA,26,23,22,25,0,0,0,96,MIN,18,23,19,20,0,0,0,80,20130415
2013,SAC,19,24,24,28,0,0,0,95,OKC,25,29,29,21,0,0,0,104,20130415
2013,CHI,21,28,28,25,0,0,0,102,ORL,23,14,18,29,0,0,0,84,20130415
2013,HOU,28,33,22,29,0,0,0,112,PHO,39,28,23,29,0,0,0,119,20130415
2013,TOR,30,38,28,17,0,0,0,113,ATL,27,24,24,21,0,0,0,96,20130416
2013,POR,24,13,20,20,0,0,0,77,LAC,28,26,28,11,0,0,0,93,20130416
2013,DET,18,30,18,33,0,0,0,99,BRK,29,31,23,20,0,0,0,103,20130417
2013,CLE,16,31,22,29,0,0,0,98,CHA,34,19,23,29,0,0,0,105,20130417
2013,WAS,15,32,21,24,0,0,0,92,CHI,31,21,22,21,0,0,0,95,20130417
2013,NOH,18,21,25,23,0,0,0,87,DAL,19,28,28,24,0,0,0,99,20130417
2013,PHO,20,20,29,29,0,0,0,98,DEN,35,31,25,27,0,0,0,118,20130417
2013,PHI,25,34,26,20,0,0,0,105,IND,16,21,31,27,0,0,0,95,20130417
2013,HOU,24,26,21,19,5,0,0,95,LAL,21,23,22,24,9,0,0,99,20130417
2013,UTA,17,21,13,19,0,0,0,70,MEM,17,23,25,21,0,0,0,86,20130417
2013,ORL,20,27,27,19,0,0,0,93,MIA,29,26,30,20,0,0,0,105,20130417
2013,ATL,16,23,29,24,0,0,0,92,NYK,25,20,29,24,0,0,0,98,20130417
2013,MIL,21,24,23,27,0,0,0,95,OKC,30,21,19,19,0,0,0,89,20130417
2013,GSW,24,26,16,33,0,0,0,99,POR,17,19,27,25,0,0,0,88,20130417
2013,LAC,27,27,24,34,0,0,0,112,SAC,26,20,24,38,0,0,0,108,20130417
2013,MIN,30,26,24,28,0,0,0,108,SAS,24,37,15,19,0,0,0,95,20130417
2013,BOS,30,19,21,20,0,0,0,90,TOR,31,28,37,18,0,0,0,114,20130417
2013,CHI,14,21,27,27,0,0,0,89,BRK,25,35,29,17,0,0,0,106,20130420
2013,GSW,25,23,16,31,0,0,0,95,DEN,28,16,27,26,0,0,0,97,20130420
2013,MEM,21,30,18,22,0,0,0,91,LAC,29,28,18,37,0,0,0,112,20130420
2013,BOS,29,24,17,8,0,0,0,78,NYK,26,23,18,18,0,0,0,85,20130420
2013,ATL,26,24,19,21,0,0,0,90,IND,34,24,26,23,0,0,0,107,20130421
2013,MIL,24,21,20,22,0,0,0,87,MIA,26,26,28,30,0,0,0,110,20130421
2013,HOU,19,28,19,25,0,0,0,91,OKC,26,34,29,31,0,0,0,120,20130421
2013,LAL,15,22,20,22,0,0,0,79,SAS,24,21,25,21,0,0,0,91,20130421
2013,CHI,20,27,22,21,0,0,0,90,BRK,17,29,11,25,0,0,0,82,20130422
2013,MEM,26,18,27,20,0,0,0,91,LAC,26,24,25,18,0,0,0,93,20130422
2013,GSW,26,35,35,35,0,0,0,131,DEN,28,25,27,37,0,0,0,117,20130423
2013,MIL,23,20,22,21,0,0,0,86,MIA,25,22,21,30,0,0,0,98,20130423
2013,BOS,20,28,11,12,0,0,0,71,NYK,26,16,32,13,0,0,0,87,20130423
2013,ATL,19,31,26,22,0,0,0,98,IND,28,31,29,25,0,0,0,113,20130424
2013,HOU,28,27,17,30,0,0,0,102,OKC,29,28,21,27,0,0,0,105,20130424
2013,LAL,23,25,20,23,0,0,0,91,SAS,28,28,22,24,0,0,0,102,20130424
2013,BRK,17,17,18,24,0,0,0,76,CHI,19,22,24,14,0,0,0,79,20130425
2013,LAC,20,19,23,20,0,0,0,82,MEM,23,24,23,24,0,0,0,94,20130425
2013,MIA,21,27,30,26,0,0,0,104,MIL,30,20,18,23,0,0,0,91,20130425
2013,NYK,23,24,21,22,0,0,0,90,BOS,18,13,21,24,0,0,0,76,20130426
2013,DEN,32,34,18,24,0,0,0,108,GSW,32,22,33,23,0,0,0,110,20130426
2013,SAS,30,25,30,35,0,0,0,120,LAL,18,26,19,26,0,0,0,89,20130426
2013,IND,14,16,19,20,0,0,0,69,ATL,27,27,21,15,0,0,0,90,20130427
2013,BRK,26,29,29,27,10,6,7,134,CHI,25,33,18,35,10,6,15,142,20130427
2013,OKC,39,27,14,24,0,0,0,104,HOU,19,30,27,25,0,0,0,101,20130427
2013,LAC,25,22,20,16,0,0,0,83,MEM,33,13,25,33,0,0,0,104,20130427
2013,NYK,17,18,30,19,6,0,0,90,BOS,22,32,14,16,13,0,0,97,20130428
2013,DEN,21,23,28,29,0,0,0,101,GSW,25,31,35,24,0,0,0,115,20130428
2013,SAS,26,26,26,25,0,0,0,103,LAL,20,14,24,24,0,0,0,82,20130428
2013,MIA,24,21,22,21,0,0,0,88,MIL,17,24,21,15,0,0,0,77,20130428
2013,IND,21,19,22,29,0,0,0,91,ATL,22,35,12,33,0,0,0,102,20130429
2013,CHI,21,23,29,18,0,0,0,91,BRK,26,26,25,33,0,0,0,110,20130429
2013,OKC,24,36,24,19,0,0,0,103,HOU,29,24,38,14,0,0,0,105,20130429
2013,GSW,22,24,23,31,0,0,0,100,DEN,36,30,20,21,0,0,0,107,20130430
2013,MEM,26,28,19,30,0,0,0,103,LAC,28,20,17,28,0,0,0,93,20130430
2013,ATL,22,21,24,16,0,0,0,83,IND,21,29,31,25,0,0,0,106,20130501
2013,BOS,20,25,24,23,0,0,0,92,NYK,22,17,21,26,0,0,0,86,20130501
2013,HOU,30,20,37,20,0,0,0,107,OKC,26,17,32,25,0,0,0,100,20130501
2013,BRK,33,27,15,20,0,0,0,95,CHI,27,27,17,21,0,0,0,92,20130502
2013,DEN,25,17,20,26,0,0,0,88,GSW,21,19,33,19,0,0,0,92,20130502
2013,IND,21,16,28,16,0,0,0,81,ATL,20,9,21,23,0,0,0,73,20130503
2013,NYK,24,15,28,21,0,0,0,88,BOS,10,17,20,33,0,0,0,80,20130503
2013,OKC,26,32,20,25,0,0,0,103,HOU,29,25,23,17,0,0,0,94,20130503
2013,LAC,26,27,26,26,0,0,0,105,MEM,29,29,34,26,0,0,0,118,20130503
2013,CHI,29,32,21,17,0,0,0,99,BRK,25,19,31,18,0,0,0,93,20130504
2013,IND,22,30,29,21,0,0,0,102,NYK,27,19,19,30,0,0,0,95,20130505
2013,MEM,16,30,27,18,0,0,0,91,OKC,14,33,17,29,0,0,0,93,20130505
2013,CHI,21,16,21,35,0,0,0,93,MIA,15,22,25,24,0,0,0,86,20130506
2013,GSW,28,25,39,14,9,12,0,127,SAS,25,24,31,26,9,14,0,129,20130506
2013,IND,20,22,24,13,0,0,0,79,NYK,29,18,25,33,0,0,0,105,20130507
2013,MEM,23,31,15,30,0,0,0,99,OKC,21,30,23,19,0,0,0,93,20130507
2013,CHI,20,21,15,22,0,0,0,78,MIA,25,30,30,30,0,0,0,115,20130508
2013,GSW,28,34,21,17,0,0,0,100,SAS,23,20,29,19,0,0,0,91,20130508
2013,MIA,25,27,18,34,0,0,0,104,CHI,25,25,20,24,0,0,0,94,20130510
2013,SAS,32,25,22,23,0,0,0,102,GSW,23,25,21,23,0,0,0,92,20130510
2013,NYK,15,18,20,18,0,0,0,71,IND,18,18,26,20,0,0,0,82,20130511
2013,OKC,18,27,15,21,0,0,0,81,MEM,22,22,22,21,0,0,0,87,20130511
2013,SAS,26,19,17,22,3,0,0,87,GSW,19,18,23,24,13,0,0,97,20130512
2013,MIA,21,23,17,27,0,0,0,88,CHI,15,18,9,23,0,0,0,65,20130513
2013,OKC,29,27,20,18,3,0,0,97,MEM,18,30,28,18,9,0,0,103,20130513
2013,NYK,16,18,22,26,0,0,0,82,IND,23,25,19,26,0,0,0,93,20130514
2013,GSW,28,23,21,19,0,0,0,91,SAS,37,17,29,26,0,0,0,109,20130514
2013,CHI,21,32,24,14,0,0,0,91,MIA,30,17,22,25,0,0,0,94,20130515
2013,MEM,18,32,14,24,0,0,0,88,OKC,23,15,24,22,0,0,0,84,20130515
2013,SAS,21,26,19,28,0,0,0,94,GSW,19,21,19,23,0,0,0,82,20130516
2013,IND,15,19,23,18,0,0,0,75,NYK,19,21,27,18,0,0,0,85,20130516
2013,NYK,27,20,34,18,0,0,0,99,IND,29,26,26,25,0,0,0,106,20130518
2013,MEM,14,23,20,26,0,0,0,83,SAS,31,20,22,32,0,0,0,105,20130519
2013,MEM,13,18,33,21,4,0,0,89,SAS,15,31,30,9,8,0,0,93,20130521
2013,IND,21,21,23,27,10,0,0,102,MIA,22,15,27,28,11,0,0,103,20130522
2013,IND,28,25,23,21,0,0,0,97,MIA,22,25,27,19,0,0,0,93,20130524
2013,SAS,13,27,24,22,18,0,0,104,MEM,29,15,21,21,7,0,0,93,20130525
2013,MIA,34,36,21,23,0,0,0,114,IND,30,26,20,20,0,0,0,96,20130526
2013,SAS,24,20,28,21,0,0,0,93,MEM,14,24,28,20,0,0,0,86,20130527
2013,MIA,22,25,23,22,0,0,0,92,IND,26,22,29,22,0,0,0,99,20130528
2013,IND,23,21,13,22,0,0,0,79,MIA,19,21,30,20,0,0,0,90,20130530
2013,MIA,23,17,15,22,0,0,0,77,IND,21,18,29,23,0,0,0,91,20130601
2013,IND,21,16,18,21,0,0,0,76,MIA,19,33,24,23,0,0,0,99,20130603
2013,SAS,23,26,20,23,0,0,0,92,MIA,24,28,20,16,0,0,0,88,20130606
2013,SAS,22,23,20,19,0,0,0,84,MIA,22,28,25,28,0,0,0,103,20130609
2013,MIA,20,24,19,14,0,0,0,77,SAS,24,26,28,35,0,0,0,113,20130611
2013,MIA,29,20,32,28,0,0,0,109,SAS,26,23,27,17,0,0,0,93,20130613
2013,MIA,19,33,23,29,0,0,0,104,SAS,32,29,26,27,0,0,0,114,20130616
2013,SAS,25,25,25,20,5,0,0,100,MIA,27,17,21,30,8,0,0,103,20130618
2013,SAS,16,28,27,17,0,0,0,88,MIA,18,28,26,23,0,0,0,95,20130620
2014,ORL,18,26,20,23,0,0,0,87,IND,23,17,29,28,0,0,0,97,20131029
2014,LAC,30,27,22,24,0,0,0,103,LAL,28,27,20,41,0,0,0,116,20131029
2014,CHI,15,18,25,37,0,0,0,95,MIA,17,37,24,29,0,0,0,107,20131029
2014,BRK,26,22,22,24,0,0,0,94,CLE,27,22,30,19,0,0,0,98,20131030
2014,ATL,28,27,24,30,0,0,0,109,DAL,33,20,33,32,0,0,0,118,20131030
2014,WAS,22,21,30,29,0,0,0,102,DET,25,30,26,32,0,0,0,113,20131030
2014,LAL,16,24,23,31,0,0,0,94,GSW,26,33,37,29,0,0,0,125,20131030
2014,CHA,19,20,22,22,0,0,0,83,HOU,17,28,22,29,0,0,0,96,20131030
2014,ORL,27,25,28,23,12,0,0,115,MIN,38,22,27,16,17,0,0,120,20131030
2014,IND,14,22,23,36,0,0,0,95,NOP,24,26,16,24,0,0,0,90,20131030
2014,MIL,18,13,33,19,0,0,0,83,NYK,24,32,18,16,0,0,0,90,20131030
2014,MIA,14,35,45,16,0,0,0,110,PHI,33,18,34,29,0,0,0,114,20131030
2014,POR,16,30,23,22,0,0,0,91,PHO,30,20,31,23,0,0,0,104,20131030
2014,DEN,22,23,27,16,0,0,0,88,SAC,25,23,22,20,0,0,0,90,20131030
2014,MEM,20,7,31,36,0,0,0,94,SAS,18,30,24,29,0,0,0,101,20131030
2014,BOS,26,11,34,16,0,0,0,87,TOR,21,28,22,22,0,0,0,93,20131030
2014,OKC,29,28,24,20,0,0,0,101,UTA,29,19,25,25,0,0,0,98,20131030
2014,NYK,16,22,23,20,0,0,0,81,CHI,26,17,28,11,0,0,0,82,20131031
2014,GSW,26,29,25,35,0,0,0,115,LAC,36,32,25,33,0,0,0,126,20131031
2014,TOR,24,15,29,27,0,0,0,95,ATL,25,24,30,23,0,0,0,102,20131101
2014,MIL,16,31,24,34,0,0,0,105,BOS,29,34,20,15,0,0,0,98,20131101
2014,MIA,18,29,20,33,0,0,0,100,BRK,27,20,31,23,0,0,0,101,20131101
2014,CLE,23,26,17,18,0,0,0,84,CHA,30,24,21,15,0,0,0,90,20131101
2014,POR,24,40,27,22,0,0,0,113,DEN,23,27,21,27,0,0,0,98,20131101
2014,DAL,22,28,22,33,0,0,0,105,HOU,38,23,24,28,0,0,0,113,20131101
2014,SAS,16,25,22,28,0,0,0,91,LAL,23,19,19,24,0,0,0,85,20131101
2014,DET,21,20,28,26,13,0,0,108,MEM,17,30,20,28,16,0,0,111,20131101
2014,OKC,19,20,21,21,0,0,0,81,MIN,34,25,29,12,0,0,0,100,20131101
2014,NOP,20,15,25,30,0,0,0,90,ORL,22,31,32,25,0,0,0,110,20131101
2014,UTA,23,23,16,22,0,0,0,84,PHO,29,14,20,24,0,0,0,87,20131101
2014,LAC,24,30,25,31,0,0,0,110,SAC,22,23,32,24,0,0,0,101,20131101
2014,PHI,21,23,30,35,0,0,0,109,WAS,33,21,20,28,0,0,0,102,20131101
2014,MEM,16,27,20,36,0,0,0,99,DAL,32,17,24,38,0,0,0,111,20131102
2014,SAC,17,19,23,28,0,0,0,87,GSW,27,29,23,19,0,0,0,98,20131102
2014,CLE,16,21,18,19,0,0,0,74,IND,21,22,19,27,0,0,0,89,20131102
2014,TOR,25,26,26,20,0,0,0,97,MIL,19,27,19,25,0,0,0,90,20131102
2014,CHA,15,26,21,22,0,0,0,84,NOP,33,23,21,28,0,0,0,105,20131102
2014,CHI,34,30,19,21,0,0,0,104,PHI,22,27,33,25,0,0,0,107,20131102
2014,SAS,19,20,35,31,0,0,0,105,POR,21,29,32,33,0,0,0,115,20131102
2014,HOU,16,24,33,31,0,0,0,104,UTA,24,32,17,20,0,0,0,93,20131102
2014,BOS,21,14,23,19,0,0,0,77,DET,24,21,18,24,0,0,0,87,20131103
2014,ATL,22,27,27,27,0,0,0,103,LAL,33,29,26,17,0,0,0,105,20131103
2014,WAS,27,21,16,29,0,0,0,93,MIA,33,28,26,16,0,0,0,103,20131103
2014,MIN,40,24,29,16,0,0,0,109,NYK,19,30,29,22,0,0,0,100,20131103
2014,PHO,24,21,25,26,0,0,0,96,OKC,21,23,23,36,0,0,0,103,20131103
2014,BRK,22,16,21,27,0,0,0,86,ORL,22,19,33,33,0,0,0,107,20131103
2014,MIN,23,15,23,31,0,0,0,92,CLE,31,24,21,17,0,0,0,93,20131104
2014,HOU,25,41,23,29,0,0,0,118,LAC,42,36,26,33,0,0,0,137,20131104
2014,BOS,24,26,22,16,0,0,0,88,MEM,27,19,20,29,0,0,0,95,20131104
2014,GSW,36,30,32,12,0,0,0,110,PHI,22,20,23,25,0,0,0,90,20131104
2014,UTA,18,20,23,27,0,0,0,88,BRK,28,26,31,19,0,0,0,104,20131105
2014,LAL,22,26,29,27,0,0,0,104,DAL,35,32,27,29,0,0,0,123,20131105
2014,SAS,24,19,29,30,0,0,0,102,DEN,27,25,26,16,0,0,0,94,20131105
2014,IND,29,9,36,25,0,0,0,99,DET,14,27,22,28,0,0,0,91,20131105
2014,PHO,17,24,37,26,0,0,0,104,NOP,28,17,24,29,0,0,0,98,20131105
2014,CHA,31,33,18,20,0,0,0,102,NYK,28,26,22,21,0,0,0,97,20131105
2014,HOU,30,25,29,32,0,0,0,116,POR,31,19,23,28,0,0,0,101,20131105
2014,ATL,25,29,28,23,0,0,0,105,SAC,32,13,20,35,0,0,0,100,20131105
2014,MIA,23,29,26,26,0,0,0,104,TOR,25,25,24,21,0,0,0,95,20131105
2014,UTA,26,8,28,25,0,0,0,87,BOS,23,27,34,13,0,0,0,97,20131106
2014,TOR,18,35,17,20,0,0,0,90,CHA,32,21,23,16,0,0,0,92,20131106
2014,CHI,19,24,19,18,0,0,0,80,IND,25,12,26,34,0,0,0,97,20131106
2014,NOP,33,18,28,20,0,0,0,99,MEM,18,23,16,27,0,0,0,84,20131106
2014,CLE,23,30,26,25,0,0,0,104,MIL,30,25,28,26,0,0,0,109,20131106
2014,GSW,26,24,29,27,0,0,0,106,MIN,28,19,24,22,0,0,0,93,20131106
2014,DAL,31,20,24,18,0,0,0,93,OKC,33,24,28,22,0,0,0,107,20131106
2014,LAC,20,22,32,16,0,0,0,90,ORL,29,28,15,26,0,0,0,98,20131106
2014,WAS,39,21,29,27,0,0,0,116,PHI,27,24,25,26,0,0,0,102,20131106
2014,PHO,21,32,20,23,0,0,0,96,SAS,29,22,22,26,0,0,0,99,20131106
2014,ATL,26,25,32,24,0,0,0,107,DEN,26,28,29,26,0,0,0,109,20131107
2014,LAL,36,28,17,18,0,0,0,99,HOU,19,31,27,21,0,0,0,98,20131107
2014,LAC,31,25,17,24,0,0,0,97,MIA,28,24,24,26,0,0,0,102,20131107
2014,NYK,28,23,34,16,0,0,0,101,CHA,22,25,22,22,0,0,0,91,20131108
2014,UTA,18,22,16,17,0,0,0,73,CHI,30,21,27,19,0,0,0,97,20131108
2014,OKC,20,35,29,35,0,0,0,119,DET,22,29,25,34,0,0,0,110,20131108
2014,TOR,32,14,13,25,0,0,0,84,IND,22,22,28,19,0,0,0,91,20131108
2014,DAL,24,32,25,27,0,0,0,108,MIN,28,27,30,31,0,0,0,116,20131108
2014,LAL,27,21,18,19,0,0,0,85,NOP,28,27,14,27,0,0,0,96,20131108
2014,BOS,17,29,25,20,0,0,0,91,ORL,24,25,19,21,0,0,0,89,20131108
2014,CLE,28,14,19,18,0,0,0,79,PHI,14,30,33,17,0,0,0,94,20131108
2014,DEN,29,18,40,16,0,0,0,103,PHO,35,29,20,30,0,0,0,114,20131108
2014,SAC,22,27,17,25,0,0,0,91,POR,29,25,23,27,0,0,0,104,20131108
2014,GSW,20,13,22,19,0,0,0,74,SAS,27,13,24,12,0,0,0,76,20131108
2014,BRK,33,25,15,26,9,0,0,108,WAS,27,26,20,26,13,0,0,112,20131108
2014,ORL,22,23,26,23,0,0,0,94,ATL,28,18,26,32,0,0,0,104,20131109
2014,IND,23,21,28,24,0,0,0,96,BRK,21,25,21,24,0,0,0,91,20131109
2014,PHI,27,21,37,22,9,9,0,125,CLE,30,23,22,32,9,11,0,127,20131109
2014,LAC,22,24,27,34,0,0,0,107,HOU,26,29,16,23,0,0,0,94,20131109
2014,GSW,29,21,27,13,0,0,0,90,MEM,32,22,36,18,0,0,0,108,20131109
2014,BOS,25,35,20,31,0,0,0,111,MIA,31,28,23,28,0,0,0,110,20131109
2014,DAL,34,21,13,23,0,0,0,91,MIL,19,21,24,19,0,0,0,83,20131109
2014,POR,21,24,24,27,0,0,0,96,SAC,18,20,16,31,0,0,0,85,20131109
2014,UTA,16,20,24,31,0,0,0,91,TOR,30,32,29,24,0,0,0,115,20131109
2014,MIN,47,20,23,23,0,0,0,113,LAL,23,25,28,14,0,0,0,90,20131110
2014,SAS,35,26,29,30,0,0,0,120,NYK,17,28,15,29,0,0,0,89,20131110
2014,WAS,24,18,31,23,9,0,0,105,OKC,27,10,28,31,10,0,0,106,20131110
2014,NOP,16,22,27,29,0,0,0,94,PHO,19,23,29,30,0,0,0,101,20131110
2014,ORL,25,25,24,31,0,0,0,105,BOS,31,28,28,33,0,0,0,120,20131111
2014,ATL,26,20,34,23,0,0,0,103,CHA,29,25,16,24,0,0,0,94,20131111
2014,CLE,17,19,24,21,0,0,0,81,CHI,20,25,19,32,0,0,0,96,20131111
2014,TOR,20,13,29,25,8,9,0,104,HOU,24,23,24,16,8,15,0,110,20131111
2014,MEM,16,23,16,24,0,0,0,79,IND,23,23,26,23,0,0,0,95,20131111
2014,MIN,26,32,22,27,0,0,0,107,LAC,23,36,26,24,0,0,0,109,20131111
2014,SAS,31,26,26,26,0,0,0,109,PHI,13,25,26,21,0,0,0,85,20131111
2014,DET,30,25,23,25,0,0,0,103,POR,34,24,25,26,0,0,0,109,20131111
2014,DEN,20,26,24,30,0,0,0,100,UTA,26,19,23,13,0,0,0,81,20131111
2014,WAS,34,15,30,16,0,0,0,95,DAL,33,28,27,17,0,0,0,105,20131112
2014,DET,16,25,30,24,0,0,0,95,GSW,35,27,32,19,0,0,0,113,20131112
2014,NOP,19,20,23,33,0,0,0,95,LAL,22,33,31,30,0,0,0,116,20131112
2014,MIL,23,22,17,33,0,0,0,95,MIA,32,24,28,34,0,0,0,118,20131112
2014,NYK,29,26,10,30,0,0,0,95,ATL,24,21,23,23,0,0,0,91,20131113
2014,CHA,27,24,20,18,0,0,0,89,BOS,21,22,21,19,0,0,0,83,20131113
2014,LAL,28,26,25,20,0,0,0,99,DEN,33,27,23,28,0,0,0,111,20131113
2014,OKC,33,29,16,25,0,0,0,103,LAC,25,28,30,28,0,0,0,111,20131113
2014,TOR,26,29,23,25,0,0,0,103,MEM,20,24,27,16,0,0,0,87,20131113
2014,CLE,24,23,29,19,0,0,0,95,MIN,38,32,38,16,0,0,0,124,20131113
2014,MIL,36,18,20,17,0,0,0,91,ORL,23,22,27,22,0,0,0,94,20131113
2014,HOU,31,26,33,16,11,0,0,117,PHI,28,32,20,26,17,0,0,123,20131113
2014,PHO,22,21,25,21,0,0,0,89,POR,25,16,21,28,0,0,0,90,20131113
2014,BRK,19,21,19,27,0,0,0,86,SAC,23,29,28,27,0,0,0,107,20131113
2014,WAS,17,25,15,22,0,0,0,79,SAS,25,27,18,22,0,0,0,92,20131113
2014,NOP,29,26,22,28,0,0,0,105,UTA,22,23,28,38,0,0,0,111,20131113
2014,OKC,33,29,24,29,0,0,0,115,GSW,32,30,33,21,0,0,0,116,20131114
2014,HOU,28,25,22,34,0,0,0,109,NYK,23,29,20,34,0,0,0,106,20131114
2014,PHI,17,39,17,30,0,0,0,103,ATL,25,29,28,31,0,0,0,113,20131115
2014,POR,23,34,33,19,0,0,0,109,BOS,21,30,27,18,0,0,0,96,20131115
2014,CHA,12,21,24,29,0,0,0,86,CLE,18,19,21,22,0,0,0,80,20131115
2014,MIN,26,34,21,32,0,0,0,113,DEN,35,21,30,31,0,0,0,117,20131115
2014,MIL,21,16,24,16,0,0,0,77,IND,31,21,23,29,0,0,0,104,20131115
2014,MEM,24,16,23,26,0,0,0,89,LAL,17,23,26,20,0,0,0,86,20131115
2014,DAL,32,19,27,26,0,0,0,104,MIA,31,29,26,24,0,0,0,110,20131115
2014,BRK,18,28,27,19,8,0,0,100,PHO,29,21,17,25,6,0,0,98,20131115
2014,DET,27,27,26,17,0,0,0,97,SAC,21,30,19,20,0,0,0,90,20131115
2014,CHI,27,18,29,22,0,0,0,96,TOR,16,15,23,26,0,0,0,80,20131115
2014,SAS,16,25,19,31,0,0,0,91,UTA,29,17,21,15,0,0,0,82,20131115
2014,MIA,26,19,23,29,0,0,0,97,CHA,16,25,19,21,0,0,0,81,20131116
2014,IND,20,15,24,35,0,0,0,94,CHI,31,29,24,26,0,0,0,110,20131116
2014,UTA,13,21,29,25,0,0,0,88,GSW,27,24,23,28,0,0,0,102,20131116
2014,DEN,23,23,29,36,0,0,0,111,HOU,33,30,27,32,0,0,0,122,20131116
2014,BRK,26,29,20,28,0,0,0,103,LAC,29,25,22,34,0,0,0,110,20131116
2014,OKC,23,17,32,20,0,0,0,92,MIL,23,17,25,14,0,0,0,79,20131116
2014,BOS,24,26,20,18,0,0,0,88,MIN,33,22,34,17,0,0,0,106,20131116
2014,PHI,22,24,20,32,0,0,0,98,NOP,34,33,36,32,0,0,0,135,20131116
2014,ATL,24,30,26,30,0,0,0,110,NYK,26,21,22,21,0,0,0,90,20131116
2014,DAL,31,28,28,21,0,0,0,108,ORL,24,22,34,20,0,0,0,100,20131116
2014,CLE,18,26,20,26,13,0,0,103,WAS,25,24,20,21,6,0,0,96,20131116
2014,DET,29,27,15,28,0,0,0,99,LAL,27,23,29,35,0,0,0,114,20131117
2014,MEM,25,22,27,23,0,0,0,97,SAC,18,16,31,21,0,0,0,86,20131117
2014,POR,31,26,22,23,16,0,0,118,TOR,29,25,15,33,8,0,0,110,20131117
2014,POR,31,25,27,25,0,0,0,108,BRK,40,23,15,20,0,0,0,98,20131118
2014,CHA,21,23,15,22,0,0,0,81,CHI,26,14,22,24,0,0,0,86,20131118
2014,PHI,21,26,24,23,0,0,0,94,DAL,18,25,31,23,0,0,0,97,20131118
2014,MEM,29,23,29,25,0,0,0,106,LAC,20,31,30,21,0,0,0,102,20131118
2014,DEN,39,24,29,21,0,0,0,113,OKC,28,32,23,32,0,0,0,115,20131118
2014,GSW,22,37,19,20,0,0,0,98,UTA,19,17,29,22,0,0,0,87,20131118
2014,NYK,24,19,20,23,0,0,0,86,DET,26,17,28,21,0,0,0,92,20131119
2014,BOS,18,26,13,28,0,0,0,85,HOU,40,28,20,21,0,0,0,109,20131119
2014,ATL,25,20,23,20,0,0,0,88,MIA,24,24,30,26,0,0,0,104,20131119
2014,PHO,25,37,26,16,0,0,0,104,SAC,33,21,28,25,0,0,0,107,20131119
2014,MIN,34,29,18,19,0,0,0,100,WAS,27,24,30,23,0,0,0,104,20131119
2014,DET,13,33,18,21,0,0,0,85,ATL,15,28,23,27,0,0,0,93,20131120
2014,BRK,29,21,20,21,0,0,0,91,CHA,30,23,30,12,0,0,0,95,20131120
2014,WAS,30,26,24,18,0,0,0,98,CLE,19,19,21,32,0,0,0,91,20131120
2014,HOU,40,28,33,19,0,0,0,120,DAL,29,32,26,36,0,0,0,123,20131120
2014,MEM,16,18,25,16,13,0,0,88,GSW,26,18,13,18,6,0,0,81,20131120
2014,POR,23,30,17,21,0,0,0,91,MIL,24,27,13,18,0,0,0,82,20131120
2014,LAC,24,22,25,31,0,0,0,102,MIN,24,22,21,31,0,0,0,98,20131120
2014,UTA,17,24,28,29,0,0,0,98,NOP,20,25,28,32,0,0,0,105,20131120
2014,IND,14,23,21,31,14,0,0,103,NYK,19,23,20,27,7,0,0,96,20131120
2014,MIA,25,29,36,30,0,0,0,120,ORL,20,29,22,21,0,0,0,92,20131120
2014,TOR,25,30,38,15,0,0,0,108,PHI,25,23,29,21,0,0,0,98,20131120
2014,SAC,27,28,19,39,0,0,0,113,PHO,27,23,12,44,0,0,0,106,20131120
2014,BOS,25,23,22,23,0,0,0,93,SAS,22,26,32,24,0,0,0,104,20131120
2014,CHI,25,23,14,25,0,0,0,87,DEN,24,26,20,27,0,0,0,97,20131121
2014,LAC,22,21,29,19,0,0,0,91,OKC,28,23,30,24,0,0,0,105,20131121
2014,IND,22,20,25,30,0,0,0,97,BOS,25,25,8,24,0,0,0,82,20131122
2014,PHO,27,28,19,24,0,0,0,98,CHA,24,20,19,28,0,0,0,91,20131122
2014,UTA,18,16,30,29,0,0,0,93,DAL,31,27,22,23,0,0,0,103,20131122
2014,ATL,27,22,24,23,0,0,0,96,DET,22,22,24,21,0,0,0,89,20131122
2014,GSW,21,25,17,32,0,0,0,95,LAL,22,33,20,27,0,0,0,102,20131122
2014,SAS,26,25,20,31,0,0,0,102,MEM,21,16,28,21,0,0,0,86,20131122
2014,BRK,14,23,21,23,0,0,0,81,MIN,30,27,33,21,0,0,0,111,20131122
2014,CLE,20,31,20,29,0,0,0,100,NOP,21,21,28,34,0,0,0,104,20131122
2014,MIL,20,33,20,29,5,0,0,107,PHI,28,27,20,27,13,0,0,115,20131122
2014,CHI,32,27,12,24,0,0,0,95,POR,22,22,34,20,0,0,0,98,20131122
2014,WAS,27,11,32,18,0,0,0,88,TOR,32,19,15,30,0,0,0,96,20131122
2014,BOS,25,24,15,30,0,0,0,94,ATL,24,29,21,13,0,0,0,87,20131123
2014,DAL,22,31,27,20,0,0,0,100,DEN,35,30,21,16,0,0,0,102,20131123
2014,POR,23,26,32,32,0,0,0,113,GSW,24,30,30,17,0,0,0,101,20131123
2014,MIN,18,24,32,27,0,0,0,101,HOU,25,30,27,30,0,0,0,112,20131123
2014,PHI,22,30,14,32,0,0,0,98,IND,25,31,21,29,0,0,0,106,20131123
2014,SAC,13,35,21,33,0,0,0,102,LAC,29,28,18,28,0,0,0,103,20131123
2014,ORL,20,35,22,22,0,0,0,99,MIA,16,23,32,30,0,0,0,101,20131123
2014,CHA,25,21,28,22,0,0,0,96,MIL,21,18,12,21,0,0,0,72,20131123
2014,CLE,21,11,35,29,0,0,0,96,SAS,30,35,31,30,0,0,0,126,20131123
2014,NYK,27,25,17,20,0,0,0,89,WAS,26,23,27,22,0,0,0,98,20131123
2014,DET,23,21,34,31,0,0,0,109,BRK,19,32,15,31,0,0,0,97,20131124
2014,CHI,24,28,21,9,0,0,0,82,LAC,31,34,31,25,0,0,0,121,20131124
2014,SAC,24,24,13,25,0,0,0,86,LAL,29,26,18,27,0,0,0,100,20131124
2014,UTA,13,17,13,30,0,0,0,73,OKC,22,25,28,20,0,0,0,95,20131124
2014,PHO,31,22,27,24,0,0,0,104,ORL,21,23,28,24,0,0,0,96,20131124
2014,BOS,14,33,21,28,0,0,0,96,CHA,21,17,28,20,0,0,0,86,20131125
2014,DEN,32,24,29,25,0,0,0,110,DAL,27,24,26,19,0,0,0,96,20131125
2014,MIL,18,16,32,28,0,0,0,94,DET,38,27,27,21,0,0,0,113,20131125
2014,MIN,24,22,22,16,0,0,0,84,IND,28,20,25,25,0,0,0,98,20131125
2014,HOU,20,12,23,38,0,0,0,93,MEM,24,20,19,23,0,0,0,86,20131125
2014,PHO,21,26,24,21,0,0,0,92,MIA,24,26,29,28,0,0,0,107,20131125
2014,NYK,18,21,30,22,0,0,0,91,POR,34,22,25,21,0,0,0,102,20131125
2014,NOP,24,16,25,28,0,0,0,93,SAS,27,30,34,21,0,0,0,112,20131125
2014,CHI,18,14,24,22,5,0,0,83,UTA,23,17,24,14,11,0,0,89,20131125
2014,ORL,26,23,36,24,0,0,0,109,ATL,25,28,20,19,0,0,0,92,20131126
2014,GSW,28,29,19,26,0,0,0,102,NOP,18,31,28,24,0,0,0,101,20131126
2014,BRK,26,29,26,21,0,0,0,102,TOR,28,23,25,24,0,0,0,100,20131126
2014,LAL,29,26,22,34,0,0,0,111,WAS,31,28,23,34,0,0,0,116,20131126
2014,MEM,27,22,20,31,0,0,0,100,BOS,13,23,23,34,0,0,0,93,20131127
2014,LAL,34,20,23,22,0,0,0,99,BRK,18,22,28,26,0,0,0,94,20131127
2014,IND,22,21,17,39,0,0,0,99,CHA,11,27,14,22,0,0,0,74,20131127
2014,MIA,22,27,21,25,0,0,0,95,CLE,28,14,18,24,0,0,0,84,20131127
2014,GSW,22,24,25,28,0,0,0,99,DAL,28,27,27,21,0,0,0,103,20131127
2014,CHI,25,26,25,23,0,0,0,99,DET,29,24,15,11,0,0,0,79,20131127
2014,ATL,19,26,22,17,0,0,0,84,HOU,30,26,21,36,0,0,0,113,20131127
2014,NYK,27,18,23,12,0,0,0,80,LAC,29,20,25,19,0,0,0,93,20131127
2014,WAS,25,24,22,16,13,0,0,100,MIL,23,25,20,19,5,0,0,92,20131127
2014,DEN,28,36,26,27,0,0,0,117,MIN,27,28,28,27,0,0,0,110,20131127
2014,SAS,21,25,15,27,0,0,0,88,OKC,19,24,25,26,0,0,0,94,20131127
2014,PHI,27,23,23,21,0,0,0,94,ORL,33,22,22,28,0,0,0,105,20131127
2014,POR,32,26,18,30,0,0,0,106,PHO,21,40,29,30,0,0,0,120,20131127
2014,DAL,28,25,22,12,0,0,0,87,ATL,23,16,25,24,0,0,0,88,20131129
2014,CLE,10,29,19,28,0,0,0,86,BOS,28,27,24,24,0,0,0,103,20131129
2014,MIL,20,21,18,17,0,0,0,76,CHA,24,27,20,21,0,0,0,92,20131129
2014,NYK,20,25,22,28,0,0,0,95,DEN,30,21,24,22,0,0,0,97,20131129
2014,LAL,31,25,21,29,0,0,0,106,DET,32,23,32,15,0,0,0,102,20131129
2014,BRK,17,23,22,33,0,0,0,95,HOU,33,33,26,22,0,0,0,114,20131129
2014,WAS,14,22,20,17,0,0,0,73,IND,28,15,26,24,0,0,0,93,20131129
2014,GSW,28,23,31,22,8,0,0,112,OKC,32,22,22,28,9,0,0,113,20131129
2014,SAS,29,34,18,28,0,0,0,109,ORL,24,21,25,21,0,0,0,91,20131129
2014,NOP,35,26,26,34,0,0,0,121,PHI,30,25,22,28,0,0,0,105,20131129
2014,LAC,23,27,23,21,10,0,0,104,SAC,24,21,27,22,4,0,0,98,20131129
2014,MIA,27,30,21,12,0,0,0,90,TOR,22,21,27,13,0,0,0,83,20131129
2014,PHO,31,31,33,17,0,0,0,112,UTA,33,18,27,23,0,0,0,101,20131129
2014,CHI,25,26,15,27,0,0,0,93,CLE,27,29,21,20,0,0,0,97,20131130
2014,MIN,29,25,30,28,0,0,0,112,DAL,24,23,30,29,0,0,0,106,20131130
2014,BRK,24,24,25,24,0,0,0,97,MEM,19,18,28,23,0,0,0,88,20131130
2014,BOS,27,14,22,22,0,0,0,85,MIL,19,28,23,22,0,0,0,92,20131130
2014,UTA,28,21,29,34,0,0,0,112,PHO,23,30,24,27,0,0,0,104,20131130
2014,HOU,30,27,26,29,0,0,0,112,SAS,24,22,34,26,0,0,0,106,20131130
2014,ATL,20,24,26,31,0,0,0,101,WAS,28,26,25,29,0,0,0,108,20131130
2014,PHI,25,21,36,18,0,0,0,100,DET,40,30,24,21,0,0,0,115,20131201
2014,IND,29,24,31,21,0,0,0,105,LAC,22,25,27,26,0,0,0,100,20131201
2014,POR,32,21,41,20,0,0,0,114,LAL,24,26,24,34,0,0,0,108,20131201
2014,CHA,21,27,25,25,0,0,0,98,MIA,24,23,14,38,0,0,0,99,20131201
2014,NOP,16,28,32,27,0,0,0,103,NYK,20,29,25,25,0,0,0,99,20131201
2014,MIN,32,26,25,20,0,0,0,103,OKC,26,29,23,35,0,0,0,113,20131201
2014,GSW,24,32,34,25,0,0,0,115,SAC,26,27,27,33,0,0,0,113,20131201
2014,DEN,25,22,29,36,0,0,0,112,TOR,31,14,27,26,0,0,0,98,20131201
2014,NOP,24,26,27,26,6,13,9,131,CHI,21,35,24,23,6,13,6,128,20131202
2014,IND,23,23,26,30,0,0,0,102,POR,20,25,27,34,0,0,0,106,20131202
2014,ATL,23,26,22,29,0,0,0,100,SAS,25,25,23,29,0,0,0,102,20131202
2014,HOU,23,27,24,29,0,0,0,103,UTA,36,17,29,27,0,0,0,109,20131202
2014,ORL,22,19,20,19,0,0,0,80,WAS,22,30,23,23,0,0,0,98,20131202
2014,MIL,23,18,22,37,0,0,0,100,BOS,28,20,21,39,0,0,0,108,20131203
2014,DEN,27,31,31,22,0,0,0,111,BRK,29,21,15,22,0,0,0,87,20131203
2014,CHA,18,24,25,15,0,0,0,82,DAL,22,17,21,29,0,0,0,89,20131203
2014,TOR,36,29,23,15,0,0,0,103,GSW,19,29,22,42,0,0,0,112,20131203
2014,PHO,19,35,20,17,0,0,0,91,MEM,23,23,36,28,0,0,0,110,20131203
2014,DET,28,26,28,25,0,0,0,107,MIA,18,25,25,29,0,0,0,97,20131203
2014,ORL,34,23,23,24,14,7,0,125,PHI,29,29,27,19,14,8,0,126,20131203
2014,OKC,19,31,28,19,0,0,0,97,SAC,31,16,18,30,0,0,0,95,20131203
2014,LAC,21,23,26,27,0,0,0,97,ATL,29,26,24,28,0,0,0,107,20131204
2014,DEN,24,28,21,15,0,0,0,88,CLE,31,25,23,19,0,0,0,98,20131204
2014,PHO,25,26,22,24,0,0,0,97,HOU,20,20,21,27,0,0,0,88,20131204
2014,DET,26,19,35,25,0,0,0,105,MIL,19,31,17,31,0,0,0,98,20131204
2014,DAL,27,25,23,25,0,0,0,100,NOP,24,29,24,20,0,0,0,97,20131204
2014,OKC,27,32,21,24,0,0,0,104,POR,25,23,35,28,0,0,0,111,20131204
2014,IND,17,30,21,27,0,0,0,95,UTA,23,25,19,19,0,0,0,86,20131204
2014,NYK,29,21,34,29,0,0,0,113,BRK,23,20,16,24,0,0,0,83,20131205
2014,MIA,20,24,19,24,0,0,0,87,CHI,29,29,27,22,0,0,0,107,20131205
2014,LAC,18,22,24,37,0,0,0,101,MEM,20,22,11,28,0,0,0,81,20131205
2014,CLE,20,23,21,25,0,0,0,89,ATL,37,26,19,26,0,0,0,108,20131206
2014,DEN,15,29,33,21,0,0,0,98,BOS,39,25,23,19,0,0,0,106,20131206
2014,PHI,33,18,21,16,0,0,0,88,CHA,36,26,22,21,0,0,0,105,20131206
2014,GSW,12,25,29,17,0,0,0,83,HOU,31,30,26,18,0,0,0,105,20131206
2014,OKC,24,34,22,29,0,0,0,109,NOP,26,26,16,27,0,0,0,95,20131206
2014,ORL,31,23,15,14,0,0,0,83,NYK,28,31,30,32,0,0,0,121,20131206
2014,TOR,27,23,24,23,0,0,0,97,PHO,27,25,29,25,0,0,0,106,20131206
2014,UTA,22,34,13,29,0,0,0,98,POR,39,28,40,23,0,0,0,130,20131206
2014,LAL,28,24,29,25,0,0,0,106,SAC,30,25,32,13,0,0,0,100,20131206
2014,MIL,34,22,22,24,7,0,0,109,WAS,30,13,31,28,3,0,0,105,20131206
2014,DET,25,22,24,21,0,0,0,92,CHI,24,23,9,19,0,0,0,75,20131207
2014,LAC,23,26,17,16,0,0,0,82,CLE,29,21,17,21,0,0,0,88,20131207
2014,GSW,29,20,28,31,0,0,0,108,MEM,19,24,17,22,0,0,0,82,20131207
2014,BRK,20,19,26,25,0,0,0,90,MIL,18,22,19,23,0,0,0,82,20131207
2014,MIA,24,31,21,27,0,0,0,103,MIN,25,17,18,22,0,0,0,82,20131207
2014,DEN,25,24,28,26,0,0,0,103,PHI,27,26,24,15,0,0,0,92,20131207
2014,DAL,28,27,24,29,0,0,0,108,POR,30,23,23,30,0,0,0,106,20131207
2014,IND,20,32,35,24,0,0,0,111,SAS,28,20,17,35,0,0,0,100,20131207
2014,SAC,23,24,27,23,15,0,0,112,UTA,24,26,20,27,5,0,0,102,20131207
2014,MIA,29,30,32,19,0,0,0,110,DET,21,32,17,25,0,0,0,95,20131208
2014,ORL,18,20,23,27,0,0,0,88,HOU,28,24,31,15,0,0,0,98,20131208
2014,TOR,30,21,22,33,0,0,0,106,LAL,20,27,21,26,0,0,0,94,20131208
2014,BOS,34,24,34,22,0,0,0,114,NYK,11,20,25,17,0,0,0,73,20131208
2014,IND,18,19,32,25,0,0,0,94,OKC,28,28,34,28,0,0,0,118,20131208
2014,GSW,21,20,36,34,0,0,0,111,CHA,27,26,30,32,0,0,0,115,20131209
2014,ORL,16,14,30,25,0,0,0,85,MEM,23,28,22,21,0,0,0,94,20131209
2014,LAC,23,21,32,18,0,0,0,94,PHI,17,19,24,23,0,0,0,83,20131209
2014,DAL,23,24,26,24,0,0,0,97,SAC,34,23,35,20,0,0,0,112,20131209
2014,POR,22,29,26,28,0,0,0,105,UTA,22,23,19,30,0,0,0,94,20131209
2014,DEN,18,22,18,17,0,0,0,75,WAS,22,23,15,14,0,0,0,74,20131209
2014,OKC,21,27,28,25,0,0,0,101,ATL,21,18,29,24,0,0,0,92,20131210
2014,BOS,20,27,25,24,0,0,0,96,BRK,31,25,29,19,0,0,0,104,20131210
2014,MIL,20,15,20,23,0,0,0,78,CHI,14,28,15,17,0,0,0,74,20131210
2014,NYK,19,26,20,29,0,0,0,94,CLE,31,17,33,28,0,0,0,109,20131210
2014,MIN,33,31,32,25,0,0,0,121,DET,32,19,26,17,0,0,0,94,20131210
2014,MIA,30,17,17,20,0,0,0,84,IND,19,21,28,22,0,0,0,90,20131210
2014,PHO,26,30,23,35,0,0,0,114,LAL,21,30,23,34,0,0,0,108,20131210
2014,SAS,24,35,30,27,0,0,0,116,TOR,36,17,21,29,0,0,0,103,20131210
2014,LAC,20,19,27,30,0,0,0,96,BOS,23,22,19,24,0,0,0,88,20131211
2014,ORL,16,27,24,25,0,0,0,92,CHA,18,24,20,21,0,0,0,83,20131211
2014,DAL,23,32,17,21,0,0,0,93,GSW,16,28,22,29,0,0,0,95,20131211
2014,OKC,25,32,32,27,0,0,0,116,MEM,22,20,31,27,0,0,0,100,20131211
2014,SAS,32,31,29,17,0,0,0,109,MIL,16,24,14,23,0,0,0,77,20131211
2014,PHI,39,22,20,18,0,0,0,99,MIN,20,28,30,28,0,0,0,106,20131211
2014,DET,28,23,23,22,10,0,0,106,NOP,29,28,26,13,15,0,0,111,20131211
2014,CHI,17,15,22,24,0,0,0,78,NYK,15,31,22,15,0,0,0,83,20131211
2014,UTA,26,32,38,26,0,0,0,122,SAC,23,23,26,29,0,0,0,101,20131211
2014,LAC,25,19,18,31,0,0,0,93,BRK,20,36,27,19,0,0,0,102,20131212
2014,HOU,20,24,32,28,0,0,0,104,POR,21,22,33,35,0,0,0,111,20131212
2014,WAS,19,27,15,25,13,0,0,99,ATL,21,27,23,15,15,0,0,101,20131213
2014,NYK,26,22,25,13,0,0,0,86,BOS,29,25,14,22,0,0,0,90,20131213
2014,UTA,33,20,20,30,0,0,0,103,DEN,28,16,31,18,0,0,0,93,20131213
2014,BRK,24,20,24,31,0,0,0,99,DET,23,38,25,17,0,0,0,103,20131213
2014,HOU,30,28,24,34,0,0,0,116,GSW,29,22,22,39,0,0,0,112,20131213
2014,CHA,25,30,21,18,0,0,0,94,IND,27,29,23,20,0,0,0,99,20131213
2014,CHI,26,21,15,29,0,0,0,91,MIL,18,33,18,21,0,0,0,90,20131213
2014,MEM,34,20,11,33,0,0,0,98,NOP,26,29,27,22,0,0,0,104,20131213
2014,LAL,28,23,23,23,0,0,0,97,OKC,38,28,28,28,0,0,0,122,20131213
2014,CLE,19,31,23,36,0,0,0,109,ORL,28,23,25,24,0,0,0,100,20131213
2014,SAC,34,27,21,25,0,0,0,107,PHO,28,30,27,31,0,0,0,116,20131213
2014,MIN,30,24,35,21,0,0,0,110,SAS,27,35,18,37,0,0,0,117,20131213
2014,PHI,21,27,28,24,0,0,0,100,TOR,36,20,27,25,0,0,0,108,20131213
2014,LAL,22,22,20,24,0,0,0,88,CHA,23,20,25,17,0,0,0,85,20131214
2014,TOR,24,27,22,26,0,0,0,99,CHI,21,20,25,11,0,0,0,77,20131214
2014,MIL,26,15,20,32,0,0,0,93,DAL,38,21,34,13,0,0,0,106,20131214
2014,CLE,29,23,28,27,0,0,0,107,MIA,35,33,16,30,0,0,0,114,20131214
2014,ATL,22,26,29,29,0,0,0,106,NYK,26,31,24,30,0,0,0,111,20131214
2014,POR,32,39,40,28,0,0,0,139,PHI,34,30,15,26,0,0,0,105,20131214
2014,SAS,23,32,25,20,0,0,0,100,UTA,17,23,26,18,0,0,0,84,20131214
2014,LAC,34,25,30,24,0,0,0,113,WAS,28,18,31,20,0,0,0,97,20131214
2014,NOP,27,25,16,25,0,0,0,93,DEN,24,28,23,27,0,0,0,102,20131215
2014,POR,29,21,23,26,12,0,0,111,DET,22,29,33,15,10,0,0,109,20131215
2014,MIN,28,28,21,24,0,0,0,101,MEM,17,29,27,20,0,0,0,93,20131215
2014,ORL,22,27,22,27,0,0,0,98,OKC,28,28,27,18,0,0,0,101,20131215
2014,GSW,27,26,27,22,0,0,0,102,PHO,33,26,22,25,0,0,0,106,20131215
2014,HOU,28,21,22,20,0,0,0,91,SAC,28,29,24,25,0,0,0,106,20131215
2014,LAL,28,26,19,27,0,0,0,100,ATL,20,27,35,32,0,0,0,114,20131216
2014,MIN,21,29,19,28,0,0,0,97,BOS,29,22,23,27,0,0,0,101,20131216
2014,PHI,22,26,25,21,0,0,0,94,BRK,32,26,42,30,0,0,0,130,20131216
2014,ORL,21,22,24,16,0,0,0,83,CHI,14,21,24,23,0,0,0,82,20131216
2014,DET,31,25,23,22,0,0,0,101,IND,28,21,24,23,0,0,0,96,20131216
2014,SAS,28,21,21,22,0,0,0,92,LAC,21,34,23,37,0,0,0,115,20131216
2014,UTA,20,30,21,23,0,0,0,94,MIA,26,21,36,34,0,0,0,117,20131216
2014,WAS,26,27,22,27,0,0,0,102,NYK,21,21,35,24,0,0,0,101,20131216
2014,SAC,22,21,29,15,0,0,0,87,CHA,35,21,22,17,0,0,0,95,20131217
2014,POR,26,29,37,27,0,0,0,119,CLE,28,31,29,28,0,0,0,116,20131217
2014,OKC,29,23,23,30,0,0,0,105,DEN,24,20,21,28,0,0,0,93,20131217
2014,NOP,19,20,26,28,0,0,0,93,GSW,26,31,31,16,0,0,0,104,20131217
2014,LAL,34,18,15,29,0,0,0,96,MEM,24,23,20,25,0,0,0,92,20131217
2014,SAC,26,28,33,20,0,0,0,107,ATL,28,25,32,39,0,0,0,124,20131218
2014,DET,23,29,28,27,0,0,0,107,BOS,42,21,18,25,0,0,0,106,20131218
2014,WAS,30,29,26,28,0,0,0,113,BRK,28,25,24,30,0,0,0,107,20131218
2014,MEM,21,18,27,25,0,0,0,91,DAL,27,25,26,27,0,0,0,105,20131218
2014,CHI,16,30,20,28,0,0,0,94,HOU,24,33,26,26,0,0,0,109,20131218
2014,NOP,22,23,20,30,0,0,0,95,LAC,27,25,26,30,0,0,0,108,20131218
2014,IND,26,26,24,18,0,0,0,94,MIA,22,19,30,26,0,0,0,97,20131218
2014,NYK,24,21,23,19,7,13,0,107,MIL,22,22,22,21,7,7,0,101,20131218
2014,POR,22,21,35,31,0,0,0,109,MIN,31,38,29,22,0,0,0,120,20131218
2014,UTA,27,22,19,18,0,0,0,86,ORL,20,19,23,20,0,0,0,82,20131218
2014,SAS,29,30,28,21,0,0,0,108,PHO,34,24,23,20,0,0,0,101,20131218
2014,CHA,18,19,33,25,9,0,0,104,TOR,15,32,23,25,7,0,0,102,20131218
2014,SAS,18,35,29,22,0,0,0,104,GSW,23,28,23,28,0,0,0,102,20131219
2014,CHI,24,28,20,23,0,0,0,95,OKC,35,20,29,23,0,0,0,107,20131219
2014,UTA,16,18,24,27,0,0,0,85,ATL,30,25,30,33,0,0,0,118,20131220
2014,MIL,26,21,23,26,15,0,0,111,CLE,25,22,23,26,18,0,0,114,20131220
2014,TOR,22,27,29,23,8,0,0,109,DAL,33,19,29,20,7,0,0,108,20131220
2014,PHO,20,28,24,31,0,0,0,103,DEN,28,34,20,17,0,0,0,99,20131220
2014,CHA,22,22,31,41,0,0,0,116,DET,31,28,30,17,0,0,0,106,20131220
2014,HOU,20,25,20,16,0,0,0,81,IND,25,31,31,27,0,0,0,114,20131220
2014,MIN,26,27,23,15,0,0,0,91,LAL,35,16,30,23,0,0,0,104,20131220
2014,SAC,36,25,21,21,0,0,0,103,MIA,33,34,31,24,0,0,0,122,20131220
2014,BRK,31,26,26,25,12,0,0,120,PHI,29,31,22,26,13,0,0,121,20131220
2014,WAS,14,30,30,32,0,0,0,106,BOS,30,21,25,23,0,0,0,99,20131221
2014,UTA,17,25,28,18,0,0,0,88,CHA,21,25,20,19,0,0,0,85,20131221
2014,CLE,26,17,22,19,0,0,0,84,CHI,33,27,21,19,0,0,0,100,20131221
2014,HOU,33,28,25,28,0,0,0,114,DET,24,29,18,26,0,0,0,97,20131221
2014,LAL,26,16,15,26,0,0,0,83,GSW,27,19,26,30,0,0,0,102,20131221
2014,DEN,18,25,17,31,0,0,0,91,LAC,28,28,23,33,0,0,0,112,20131221
2014,PHI,23,26,23,34,0,0,0,106,MIL,29,30,26,31,0,0,0,116,20131221
2014,MEM,25,25,22,23,0,0,0,95,NYK,22,18,21,26,0,0,0,87,20131221
2014,SAC,25,31,19,30,0,0,0,105,ORL,31,27,19,23,0,0,0,100,20131221
2014,DAL,25,33,24,26,0,0,0,108,PHO,38,25,28,32,0,0,0,123,20131221
2014,NOP,26,27,25,29,0,0,0,107,POR,21,31,31,27,0,0,0,110,20131221
2014,OKC,21,40,24,28,0,0,0,113,SAS,21,29,26,24,0,0,0,100,20131221
2014,BOS,17,20,21,21,0,0,0,79,IND,20,32,28,26,0,0,0,106,20131222
2014,MIN,24,30,31,21,10,0,0,116,LAC,24,32,27,23,14,0,0,120,20131222
2014,TOR,25,37,13,29,0,0,0,104,OKC,21,35,28,14,0,0,0,98,20131222
2014,IND,19,26,30,28,0,0,0,103,BRK,17,22,19,28,0,0,0,86,20131223
2014,MIL,33,21,24,23,9,0,0,110,CHA,17,35,26,23,10,0,0,111,20131223
2014,DET,28,30,31,26,0,0,0,115,CLE,18,22,24,28,0,0,0,92,20131223
2014,GSW,30,17,17,25,0,0,0,89,DEN,22,21,23,15,0,0,0,81,20131223
2014,DAL,20,30,36,25,0,0,0,111,HOU,26,31,21,26,0,0,0,104,20131223
2014,UTA,21,27,23,23,0,0,0,94,MEM,27,26,24,27,0,0,0,104,20131223
2014,ATL,23,31,30,27,8,0,0,119,MIA,33,17,27,34,10,0,0,121,20131223
2014,NYK,29,36,19,19,0,0,0,103,ORL,27,14,35,22,0,0,0,98,20131223
2014,LAL,24,27,17,22,0,0,0,90,PHO,28,36,26,27,0,0,0,117,20131223
2014,NOP,28,24,25,36,0,0,0,113,SAC,27,25,25,23,0,0,0,100,20131223
2014,TOR,26,23,23,27,0,0,0,99,SAS,25,30,23,34,0,0,0,112,20131223
2014,CHI,21,20,36,18,0,0,0,95,BRK,23,15,20,20,0,0,0,78,20131225
2014,LAC,30,23,25,25,0,0,0,103,GSW,22,29,24,30,0,0,0,105,20131225
2014,MIA,21,30,25,25,0,0,0,101,LAL,27,19,28,21,0,0,0,95,20131225
2014,OKC,35,25,27,36,0,0,0,123,NYK,29,17,21,27,0,0,0,94,20131225
2014,HOU,40,20,23,28,0,0,0,111,SAS,25,26,24,23,0,0,0,98,20131225
2014,ATL,26,24,26,19,13,19,0,127,CLE,27,21,24,23,13,17,0,125,20131226
2014,SAS,27,31,26,32,0,0,0,116,DAL,20,31,26,30,0,0,0,107,20131226
2014,MEM,23,30,19,20,0,0,0,92,HOU,26,19,21,34,0,0,0,100,20131226
2014,LAC,14,32,27,28,11,0,0,112,POR,19,28,29,25,15,0,0,116,20131226
2014,MIL,18,19,23,33,0,0,0,93,BRK,31,17,28,28,0,0,0,104,20131227
2014,OKC,21,21,20,27,0,0,0,89,CHA,20,16,24,25,0,0,0,85,20131227
2014,PHO,22,18,24,22,0,0,0,86,GSW,28,31,26,30,0,0,0,115,20131227
2014,WAS,23,24,27,24,0,0,0,98,MIN,22,39,27,32,0,0,0,120,20131227
2014,DEN,25,20,21,23,0,0,0,89,NOP,34,24,23,24,0,0,0,105,20131227
2014,TOR,18,22,26,29,0,0,0,95,NYK,25,24,22,12,0,0,0,83,20131227
2014,DET,21,27,18,26,0,0,0,92,ORL,26,29,30,24,0,0,0,109,20131227
2014,MIA,32,23,18,16,14,0,0,103,SAC,19,26,29,15,19,0,0,108,20131227
2014,LAL,23,29,29,22,0,0,0,103,UTA,25,30,28,22,0,0,0,105,20131227
2014,CHA,22,28,27,24,15,0,0,116,ATL,25,20,26,30,17,0,0,118,20131228
2014,CLE,22,22,22,34,0,0,0,100,BOS,24,35,26,18,0,0,0,103,20131228
2014,DAL,30,31,25,19,0,0,0,105,CHI,19,15,22,27,0,0,0,83,20131228
2014,NOP,22,30,21,25,0,0,0,98,HOU,31,21,22,33,0,0,0,107,20131228
2014,BRK,27,29,20,15,0,0,0,91,IND,29,29,28,19,0,0,0,105,20131228
2014,UTA,20,23,22,25,0,0,0,90,LAC,17,25,26,30,0,0,0,98,20131228
2014,DEN,29,27,16,27,0,0,0,99,MEM,27,28,30,35,0,0,0,120,20131228
2014,MIN,34,30,39,14,0,0,0,117,MIL,28,27,21,19,0,0,0,95,20131228
2014,PHI,27,32,22,20,0,0,0,101,PHO,36,24,28,27,0,0,0,115,20131228
2014,MIA,30,28,25,25,0,0,0,108,POR,34,28,26,19,0,0,0,107,20131228
2014,NYK,22,22,27,29,0,0,0,100,TOR,26,31,28,30,0,0,0,115,20131228
2014,DET,23,18,21,20,0,0,0,82,WAS,31,31,24,20,0,0,0,106,20131228
2014,GSW,26,29,27,17,9,0,0,108,CLE,35,29,20,15,5,0,0,104,20131229
2014,PHI,20,32,34,25,0,0,0,111,LAL,22,30,25,27,0,0,0,104,20131229
2014,HOU,14,30,26,16,0,0,0,86,OKC,26,30,34,27,0,0,0,117,20131229
2014,ATL,20,29,27,26,0,0,0,102,ORL,26,30,23,30,0,0,0,109,20131229
2014,SAC,23,26,38,17,0,0,0,104,SAS,27,30,24,31,0,0,0,112,20131229
2014,MIA,29,17,26,25,0,0,0,97,DEN,30,25,22,17,0,0,0,94,20131230
2014,WAS,33,20,25,28,0,0,0,106,DET,32,31,24,12,0,0,0,99,20131230
2014,PHO,30,31,27,19,0,0,0,107,LAC,24,16,19,29,0,0,0,88,20131230
2014,CHI,17,29,25,24,0,0,0,95,MEM,22,22,20,27,0,0,0,91,20131230
2014,DAL,29,33,19,19,0,0,0,100,MIN,23,20,38,17,0,0,0,98,20131230
2014,POR,21,28,33,26,0,0,0,108,NOP,26,30,33,21,0,0,0,110,20131230
2014,CHA,21,13,19,27,0,0,0,80,UTA,21,21,21,20,0,0,0,83,20131230
2014,ATL,20,19,23,30,0,0,0,92,BOS,23,21,23,24,0,0,0,91,20131231
2014,TOR,21,15,21,28,0,0,0,85,CHI,16,26,20,17,0,0,0,79,20131231
2014,SAC,29,29,22,30,0,0,0,110,HOU,24,28,34,20,0,0,0,106,20131231
2014,CLE,25,19,22,10,0,0,0,76,IND,23,18,24,26,0,0,0,91,20131231
2014,MIL,23,19,32,20,0,0,0,94,LAL,12,21,27,19,0,0,0,79,20131231
2014,POR,24,18,29,27,0,0,0,98,OKC,30,24,24,16,0,0,0,94,20131231
2014,GSW,26,32,16,20,0,0,0,94,ORL,15,20,24,22,0,0,0,81,20131231
2014,BRK,20,16,32,24,0,0,0,92,SAS,30,29,39,15,0,0,0,113,20131231
2014,PHI,24,44,27,19,0,0,0,114,DEN,30,26,25,21,0,0,0,102,20140101
2014,CHA,27,29,13,16,0,0,0,85,LAC,25,31,25,31,0,0,0,112,20140101
2014,NOP,28,19,26,39,0,0,0,112,MIN,33,28,36,27,0,0,0,124,20140101
2014,IND,18,26,19,19,0,0,0,82,TOR,26,14,26,29,0,0,0,95,20140101
2014,DAL,25,14,20,28,0,0,0,87,WAS,20,22,19,17,0,0,0,78,20140101
2014,BOS,21,24,17,20,0,0,0,82,CHI,24,24,22,24,0,0,0,94,20140102
2014,ORL,23,16,23,17,2,0,0,81,CLE,19,22,16,22,8,0,0,87,20140102
2014,GSW,38,27,31,27,0,0,0,123,MIA,33,28,26,27,0,0,0,114,20140102
2014,BRK,29,15,22,29,0,0,0,95,OKC,26,33,18,16,0,0,0,93,20140102
2014,MEM,22,31,16,30,0,0,0,99,PHO,26,15,32,18,0,0,0,91,20140102
2014,CHA,21,28,28,27,0,0,0,104,POR,39,31,30,34,0,0,0,134,20140102
2014,PHI,30,31,31,21,0,0,0,113,SAC,25,26,26,27,0,0,0,104,20140102
2014,NYK,26,26,29,24,0,0,0,105,SAS,25,22,28,26,0,0,0,101,20140102
2014,MIL,20,22,19,26,0,0,0,87,UTA,20,31,23,22,0,0,0,96,20140102
2014,GSW,24,22,18,37,0,0,0,101,ATL,21,25,26,28,0,0,0,100,20140103
2014,NOP,22,27,24,22,0,0,0,95,BOS,17,26,29,20,0,0,0,92,20140103
2014,LAC,33,34,22,30,0,0,0,119,DAL,39,31,17,25,0,0,0,112,20140103
2014,MEM,23,25,27,33,0,0,0,108,DEN,28,30,19,34,0,0,0,111,20140103
2014,NYK,24,23,34,19,0,0,0,100,HOU,20,28,25,29,0,0,0,102,20140103
2014,UTA,12,28,27,32,0,0,0,99,LAL,30,22,31,27,0,0,0,110,20140103
2014,TOR,26,22,36,17,0,0,0,101,WAS,17,28,16,27,0,0,0,88,20140103
2014,CLE,17,21,27,17,0,0,0,82,BRK,22,29,16,22,0,0,0,89,20140104
2014,ATL,18,27,19,20,0,0,0,84,CHI,26,24,17,24,0,0,0,91,20140104
2014,NOP,27,22,12,21,0,0,0,82,IND,15,29,30,25,0,0,0,99,20140104
2014,OKC,26,23,28,38,0,0,0,115,MIN,30,25,32,24,0,0,0,111,20140104
2014,MIA,30,18,33,29,0,0,0,110,ORL,24,22,24,24,0,0,0,94,20140104
2014,MIL,26,23,29,22,0,0,0,100,PHO,28,32,27,29,0,0,0,116,20140104
2014,PHI,32,20,17,32,0,0,0,101,POR,19,31,26,23,0,0,0,99,20140104
2014,CHA,32,33,24,24,0,0,0,113,SAC,27,25,30,21,0,0,0,103,20140104
2014,LAC,17,18,35,22,0,0,0,92,SAS,37,33,18,28,0,0,0,116,20140104
2014,IND,22,22,23,15,0,0,0,82,CLE,18,17,23,20,0,0,0,78,20140105
2014,NYK,29,23,15,25,0,0,0,92,DAL,17,18,22,23,0,0,0,80,20140105
2014,MEM,28,23,28,33,0,0,0,112,DET,27,29,11,17,0,0,0,84,20140105
2014,DEN,26,34,33,44,0,0,0,137,LAL,29,32,22,32,0,0,0,115,20140105
2014,TOR,29,22,33,13,0,0,0,97,MIA,29,23,27,23,0,0,0,102,20140105
2014,BOS,26,30,22,18,0,0,0,96,OKC,34,32,26,27,0,0,0,119,20140105
2014,GSW,28,30,34,20,0,0,0,112,WAS,36,22,15,23,0,0,0,96,20140105
2014,ATL,21,31,15,19,0,0,0,86,BRK,27,19,26,19,0,0,0,91,20140106
2014,ORL,18,16,21,26,0,0,0,81,LAC,36,24,25,16,0,0,0,101,20140106
2014,MIN,32,38,35,21,0,0,0,126,PHI,29,25,20,21,0,0,0,95,20140106
2014,WAS,24,19,23,31,0,0,0,97,CHA,21,18,16,28,0,0,0,83,20140107
2014,PHO,25,21,17,24,0,0,0,87,CHI,27,22,21,22,0,0,0,92,20140107
2014,PHI,20,21,25,27,0,0,0,93,CLE,36,28,27,20,0,0,0,111,20140107
2014,LAL,31,22,24,20,0,0,0,97,DAL,33,27,25,25,0,0,0,110,20140107
2014,BOS,23,22,33,20,0,0,0,98,DEN,31,37,35,26,0,0,0,129,20140107
2014,TOR,15,21,22,21,0,0,0,79,IND,22,22,27,15,0,0,0,86,20140107
2014,SAS,25,28,21,24,12,0,0,110,MEM,22,19,23,34,10,0,0,108,20140107
2014,NOP,24,25,21,18,0,0,0,88,MIA,25,18,32,32,0,0,0,107,20140107
2014,GSW,28,22,29,22,0,0,0,101,MIL,30,18,20,12,0,0,0,80,20140107
2014,DET,21,20,17,27,0,0,0,85,NYK,24,17,32,16,0,0,0,89,20140107
2014,POR,35,25,13,46,0,0,0,119,SAC,24,31,25,43,0,0,0,123,20140107
2014,OKC,28,19,27,27,0,0,0,101,UTA,30,29,31,22,0,0,0,112,20140107
2014,IND,12,20,34,21,0,0,0,87,ATL,25,24,30,18,0,0,0,97,20140108
2014,GSW,32,20,24,22,0,0,0,98,BRK,22,37,16,27,0,0,0,102,20140108
2014,LAL,28,29,15,27,0,0,0,99,HOU,24,28,33,28,0,0,0,113,20140108
2014,BOS,23,32,27,23,0,0,0,105,LAC,32,27,29,23,0,0,0,111,20140108
2014,PHO,27,26,19,32,0,0,0,104,MIN,23,24,30,26,0,0,0,103,20140108
2014,WAS,28,33,26,15,0,0,0,102,NOP,28,16,22,30,0,0,0,96,20140108
2014,ORL,24,27,24,19,0,0,0,94,POR,24,21,26,39,0,0,0,110,20140108
2014,DAL,16,22,24,28,0,0,0,90,SAS,25,20,37,30,0,0,0,112,20140108
2014,DET,25,29,20,17,0,0,0,91,TOR,26,24,34,28,0,0,0,112,20140108
2014,OKC,26,25,15,22,0,0,0,88,DEN,27,33,29,12,0,0,0,101,20140109
2014,MIA,27,21,23,21,0,0,0,92,NYK,21,22,32,27,0,0,0,102,20140109
2014,HOU,18,23,19,20,0,0,0,80,ATL,10,29,26,18,0,0,0,83,20140110
2014,MIA,32,13,19,25,4,2,0,95,BRK,33,20,23,13,4,11,0,104,20140110
2014,BOS,21,28,18,30,0,0,0,97,GSW,24,23,25,27,0,0,0,99,20140110
2014,WAS,18,19,14,15,0,0,0,66,IND,18,27,20,28,0,0,0,93,20140110
2014,LAL,25,27,8,27,0,0,0,87,LAC,43,27,31,22,0,0,0,123,20140110
2014,PHO,29,26,19,25,0,0,0,99,MEM,25,23,26,30,0,0,0,104,20140110
2014,CHI,20,27,22,12,0,0,0,81,MIL,27,18,14,13,0,0,0,72,20140110
2014,CHA,28,20,22,22,0,0,0,92,MIN,29,39,27,24,0,0,0,119,20140110
2014,DAL,31,31,22,23,0,0,0,107,NOP,24,25,16,25,0,0,0,90,20140110
2014,DET,28,27,29,30,0,0,0,114,PHI,36,27,18,23,0,0,0,104,20140110
2014,ORL,24,16,24,19,0,0,0,83,SAC,18,28,30,27,0,0,0,103,20140110
2014,CLE,26,20,39,28,0,0,0,113,UTA,26,23,21,32,0,0,0,102,20140110
2014,CHA,17,25,28,27,0,0,0,97,CHI,24,28,18,33,0,0,0,103,20140111
2014,NOP,22,15,40,30,0,0,0,107,DAL,17,25,42,26,0,0,0,110,20140111
2014,ORL,25,22,19,28,0,0,0,94,DEN,34,35,23,28,0,0,0,120,20140111
2014,PHO,21,30,28,29,0,0,0,108,DET,35,29,25,21,0,0,0,110,20140111
2014,MIL,10,25,27,23,0,0,0,85,OKC,14,24,39,24,0,0,0,101,20140111
2014,NYK,20,32,32,18,0,0,0,102,PHI,28,12,28,24,0,0,0,92,20140111
2014,BOS,32,28,26,18,0,0,0,104,POR,27,31,32,22,0,0,0,112,20140111
2014,BRK,18,24,22,16,0,0,0,80,TOR,24,23,21,28,0,0,0,96,20140111
2014,HOU,29,34,31,20,0,0,0,114,WAS,29,17,33,28,0,0,0,107,20140111
2014,ATL,18,23,31,29,0,0,0,101,MEM,21,27,29,31,0,0,0,108,20140112
2014,CLE,32,18,11,19,0,0,0,80,SAC,30,29,30,35,0,0,0,124,20140112
2014,MIN,21,28,22,15,0,0,0,86,SAS,28,24,29,23,0,0,0,104,20140112
2014,HOU,19,33,32,20,0,0,0,104,BOS,27,16,22,27,0,0,0,92,20140113
2014,WAS,26,30,22,24,0,0,0,102,CHI,19,24,25,20,0,0,0,88,20140113
2014,ORL,20,21,25,22,0,0,0,88,DAL,28,31,25,23,0,0,0,107,20140113
2014,SAS,24,27,25,25,0,0,0,101,NOP,28,24,21,22,0,0,0,95,20140113
2014,PHO,21,22,25,24,4,0,0,96,NYK,28,24,23,17,6,0,0,98,20140113
2014,MIL,24,26,23,21,0,0,0,94,TOR,38,20,30,28,0,0,0,116,20140113
2014,DEN,31,22,24,26,0,0,0,103,UTA,35,32,26,25,0,0,0,118,20140113
2014,NYK,24,22,27,25,0,0,0,98,CHA,27,28,23,30,0,0,0,108,20140114
2014,SAC,20,25,29,18,0,0,0,92,IND,25,34,27,30,0,0,0,116,20140114
2014,CLE,28,29,31,32,0,0,0,120,LAL,23,40,22,33,0,0,0,118,20140114
2014,OKC,16,31,20,20,0,0,0,87,MEM,24,19,29,18,0,0,0,90,20140114
2014,TOR,25,16,15,27,0,0,0,83,BOS,23,22,28,15,0,0,0,88,20140115
2014,DEN,35,30,26,32,0,0,0,123,GSW,32,26,24,34,0,0,0,116,20140115
2014,DAL,32,30,36,29,0,0,0,127,LAC,30,42,28,29,0,0,0,129,20140115
2014,MEM,20,22,16,24,0,0,0,82,MIL,10,25,25,17,0,0,0,77,20140115
2014,SAC,24,34,25,28,0,0,0,111,MIN,23,24,26,35,0,0,0,108,20140115
2014,HOU,19,26,29,29,0,0,0,103,NOP,30,26,25,19,0,0,0,100,20140115
2014,CHI,26,20,27,28,10,8,9,128,ORL,20,29,31,21,10,8,6,125,20140115
2014,CHA,27,18,23,24,0,0,0,92,PHI,24,29,19,23,0,0,0,95,20140115
2014,LAL,27,31,24,32,0,0,0,114,PHO,26,28,34,33,0,0,0,121,20140115
2014,CLE,27,23,25,21,0,0,0,96,POR,26,28,23,31,0,0,0,108,20140115
2014,UTA,25,20,24,36,0,0,0,105,SAS,28,22,31,28,0,0,0,109,20140115
2014,MIA,18,30,29,20,0,0,0,97,WAS,43,26,17,28,0,0,0,114,20140115
2014,BRK,31,34,34,28,0,0,0,127,ATL,27,26,21,36,0,0,0,110,20140116
2014,OKC,36,23,24,21,0,0,0,104,HOU,32,41,10,9,0,0,0,92,20140116
2014,NYK,31,17,21,20,0,0,0,89,IND,30,33,24,30,0,0,0,117,20140116
2014,LAL,25,27,24,31,0,0,0,107,BOS,23,35,24,22,0,0,0,104,20140117
2014,CLE,26,42,19,30,0,0,0,117,DEN,29,28,23,29,0,0,0,109,20140117
2014,UTA,27,31,31,21,0,0,0,110,DET,25,20,20,24,0,0,0,89,20140117
2014,SAC,21,21,29,19,0,0,0,90,MEM,20,24,28,19,0,0,0,91,20140117
2014,LAC,23,27,26,33,0,0,0,109,NYK,27,23,17,28,0,0,0,95,20140117
2014,GSW,32,33,26,30,0,0,0,121,OKC,39,32,30,26,0,0,0,127,20140117
2014,CHA,30,22,26,33,0,0,0,111,ORL,18,35,21,27,0,0,0,101,20140117
2014,MIA,34,24,21,22,0,0,0,101,PHI,24,17,20,25,0,0,0,86,20140117
2014,DAL,36,22,26,26,0,0,0,110,PHO,30,26,19,32,0,0,0,107,20140117
2014,POR,27,27,23,32,0,0,0,109,SAS,27,22,29,22,0,0,0,100,20140117
2014,MIN,15,25,21,28,0,0,0,89,TOR,22,22,25,25,0,0,0,94,20140117
2014,CHI,27,23,24,19,0,0,0,93,WAS,30,24,20,22,0,0,0,96,20140117
2014,MIA,27,26,22,15,14,0,0,104,CHA,29,31,16,14,6,0,0,96,20140118
2014,PHI,19,12,20,27,0,0,0,78,CHI,24,27,27,25,0,0,0,103,20140118
2014,POR,35,36,33,23,0,0,0,127,DAL,23,29,18,41,0,0,0,111,20140118
2014,MIL,23,29,26,26,0,0,0,104,HOU,29,33,29,23,0,0,0,114,20140118
2014,LAC,18,23,27,24,0,0,0,92,IND,28,29,21,28,0,0,0,106,20140118
2014,UTA,14,9,22,27,0,0,0,72,MIN,23,28,28,19,0,0,0,98,20140118
2014,GSW,24,28,26,19,0,0,0,97,NOP,29,25,18,15,0,0,0,87,20140118
2014,DET,22,24,33,25,0,0,0,104,WAS,29,25,22,22,0,0,0,98,20140118
2014,SAC,30,22,22,19,0,0,0,93,OKC,28,29,32,19,0,0,0,108,20140119
2014,BOS,26,20,18,27,0,0,0,91,ORL,18,35,13,27,0,0,0,93,20140119
2014,DEN,25,31,23,24,0,0,0,103,PHO,34,28,22,33,0,0,0,117,20140119
2014,MIL,16,22,22,22,0,0,0,82,SAS,29,24,31,26,0,0,0,110,20140119
2014,LAL,29,25,28,30,0,0,0,112,TOR,36,22,23,25,0,0,0,106,20140119
2014,MIA,31,39,22,22,0,0,0,114,ATL,34,37,26,24,0,0,0,121,20140120
2014,TOR,11,25,24,35,0,0,0,95,CHA,26,29,23,22,0,0,0,100,20140120
2014,LAL,26,26,20,21,7,0,0,100,CHI,31,18,20,24,9,0,0,102,20140120
2014,DAL,30,29,20,23,0,0,0,102,CLE,23,14,29,31,0,0,0,97,20140120
2014,LAC,26,38,30,18,0,0,0,112,DET,28,25,25,25,0,0,0,103,20140120
2014,IND,35,18,24,25,0,0,0,102,GSW,21,19,29,25,0,0,0,94,20140120
2014,POR,28,28,35,22,0,0,0,113,HOU,37,34,35,20,0,0,0,126,20140120
2014,NOP,25,16,27,27,0,0,0,95,MEM,20,20,29,23,0,0,0,92,20140120
2014,BRK,27,25,19,32,0,0,0,103,NYK,16,22,17,25,0,0,0,80,20140120
2014,PHI,23,28,22,26,0,0,0,99,WAS,29,32,25,21,0,0,0,107,20140120
2014,ORL,21,21,14,34,0,0,0,90,BRK,27,19,27,28,0,0,0,101,20140121
2014,BOS,15,25,27,19,0,0,0,86,MIA,29,22,20,22,0,0,0,93,20140121
2014,SAC,38,26,27,23,0,0,0,114,NOP,20,36,14,27,0,0,0,97,20140121
2014,POR,27,25,23,22,0,0,0,97,OKC,21,30,26,28,0,0,0,105,20140121
2014,MIN,34,20,30,28,0,0,0,112,UTA,16,23,23,35,0,0,0,97,20140121
2014,LAC,25,24,21,21,0,0,0,91,CHA,26,22,24,23,0,0,0,95,20140122
2014,CHI,23,20,28,27,0,0,0,98,CLE,17,27,18,25,0,0,0,87,20140122
2014,SAC,22,22,29,25,0,0,0,98,HOU,29,26,33,31,0,0,0,119,20140122
2014,DET,28,28,29,16,0,0,0,101,MIL,25,25,31,23,0,0,0,104,20140122
2014,PHI,33,28,23,26,0,0,0,110,NYK,26,30,24,26,0,0,0,106,20140122
2014,ATL,29,31,28,24,0,0,0,112,ORL,21,35,24,29,0,0,0,109,20140122
2014,IND,29,20,30,21,0,0,0,100,PHO,30,32,34,28,0,0,0,124,20140122
2014,OKC,30,25,21,35,0,0,0,111,SAS,24,29,22,30,0,0,0,105,20140122
2014,DAL,34,17,22,12,0,0,0,85,TOR,15,31,22,25,0,0,0,93,20140122
2014,BOS,32,29,15,23,14,0,0,113,WAS,22,21,30,26,12,0,0,111,20140122
2014,LAL,27,19,29,27,0,0,0,102,MIA,30,27,28,24,0,0,0,109,20140123
2014,DEN,30,37,24,14,0,0,0,105,POR,27,32,27,24,0,0,0,110,20140123
2014,SAS,27,28,29,21,0,0,0,105,ATL,14,20,22,23,0,0,0,79,20140124
2014,OKC,27,23,27,24,0,0,0,101,BOS,28,18,13,24,0,0,0,83,20140124
2014,DAL,21,25,24,36,0,0,0,106,BRK,18,39,21,29,0,0,0,107,20140124
2014,LAC,41,27,24,20,0,0,0,112,CHI,26,29,25,15,0,0,0,95,20140124
2014,MIL,23,14,18,23,0,0,0,78,CLE,24,22,25,22,0,0,0,93,20140124
2014,NOP,25,29,17,32,0,0,0,103,DET,26,22,32,21,0,0,0,101,20140124
2014,MIN,36,27,28,30,0,0,0,121,GSW,36,27,35,22,0,0,0,120,20140124
2014,MEM,21,23,20,24,0,0,0,88,HOU,20,15,29,23,0,0,0,87,20140124
2014,CHA,21,25,20,30,0,0,0,96,NYK,30,37,34,24,0,0,0,125,20140124
2014,LAL,32,23,25,25,0,0,0,105,ORL,28,25,38,23,0,0,0,114,20140124
2014,TOR,27,25,28,24,0,0,0,104,PHI,28,25,25,17,0,0,0,95,20140124
2014,WAS,30,21,31,19,0,0,0,101,PHO,29,28,19,19,0,0,0,95,20140124
2014,IND,26,24,29,24,13,0,0,116,SAC,37,23,24,19,8,0,0,111,20140124
2014,CHI,22,17,18,32,0,0,0,89,CHA,24,15,16,32,0,0,0,87,20140125
2014,IND,18,18,40,20,0,0,0,96,DEN,22,33,31,23,0,0,0,109,20140125
2014,HOU,14,21,19,27,0,0,0,81,MEM,16,30,25,28,0,0,0,99,20140125
2014,ATL,31,29,36,16,0,0,0,112,MIL,25,20,19,23,0,0,0,87,20140125
2014,OKC,26,27,30,20,0,0,0,103,PHI,26,18,27,20,0,0,0,91,20140125
2014,MIN,29,28,24,23,0,0,0,104,POR,27,38,22,28,0,0,0,115,20140125
2014,LAC,36,35,22,33,0,0,0,126,TOR,37,28,28,25,0,0,0,118,20140125
2014,WAS,29,24,24,24,0,0,0,101,UTA,21,30,26,27,0,0,0,104,20140125
2014,BRK,11,24,24,26,0,0,0,85,BOS,17,17,19,26,0,0,0,79,20140126
2014,PHO,22,21,25,31,0,0,0,99,CLE,29,32,6,23,0,0,0,90,20140126
2014,DET,25,21,35,25,0,0,0,106,DAL,28,28,28,32,0,0,0,116,20140126
2014,POR,22,33,12,21,0,0,0,88,GSW,28,26,22,27,0,0,0,103,20140126
2014,SAS,28,22,21,30,0,0,0,101,MIA,34,24,33,22,0,0,0,113,20140126
2014,ORL,21,23,25,23,0,0,0,92,NOP,27,27,21,25,0,0,0,100,20140126
2014,LAL,25,22,34,22,0,0,0,103,NYK,22,29,32,27,0,0,0,110,20140126
2014,DEN,30,35,30,30,0,0,0,125,SAC,31,28,34,24,0,0,0,117,20140126
2014,TOR,25,32,25,22,0,0,0,104,BRK,26,30,25,22,0,0,0,103,20140127
2014,MIN,23,31,18,23,0,0,0,95,CHI,20,26,19,21,0,0,0,86,20140127
2014,LAC,32,32,20,30,0,0,0,114,MIL,25,16,20,25,0,0,0,86,20140127
2014,ATL,32,25,30,22,0,0,0,109,OKC,26,24,29,32,0,0,0,111,20140127
2014,PHO,40,22,33,29,0,0,0,124,PHI,26,28,28,31,0,0,0,113,20140127
2014,SAC,22,28,20,29,0,0,0,99,UTA,20,30,31,25,0,0,0,106,20140127
2014,NOP,26,30,27,17,0,0,0,100,CLE,29,15,21,24,0,0,0,89,20140128
2014,ORL,22,21,17,27,0,0,0,87,DET,20,33,25,25,0,0,0,103,20140128
2014,WAS,24,21,21,22,0,0,0,88,GSW,22,27,16,20,0,0,0,85,20140128
2014,SAS,28,18,18,26,0,0,0,90,HOU,20,19,33,25,0,0,0,97,20140128
2014,IND,22,27,30,25,0,0,0,104,LAL,19,30,20,23,0,0,0,92,20140128
2014,BOS,15,22,22,29,0,0,0,88,NYK,31,32,23,28,0,0,0,114,20140128
2014,MEM,31,30,20,17,0,0,0,98,POR,22,24,12,23,0,0,0,81,20140128
2014,PHI,23,30,21,21,0,0,0,95,BOS,26,21,24,23,0,0,0,94,20140129
2014,HOU,32,31,28,26,0,0,0,117,DAL,30,27,28,30,0,0,0,115,20140129
2014,CHA,32,21,22,26,0,0,0,101,DEN,21,31,23,23,0,0,0,98,20140129
2014,WAS,31,20,23,29,0,0,0,103,LAC,30,32,19,29,0,0,0,110,20140129
2014,OKC,21,34,36,21,0,0,0,112,MIA,30,20,25,20,0,0,0,95,20140129
2014,PHO,28,34,29,35,0,0,0,126,MIL,19,31,34,33,0,0,0,117,20140129
2014,NOP,16,19,27,15,0,0,0,77,MIN,23,24,20,21,0,0,0,88,20140129
2014,MEM,25,23,21,30,0,0,0,99,SAC,24,22,17,26,0,0,0,89,20140129
2014,CHI,21,19,28,28,0,0,0,96,SAS,15,21,25,25,0,0,0,86,20140129
2014,ORL,20,20,25,18,0,0,0,83,TOR,33,22,25,18,0,0,0,98,20140129
2014,LAC,21,35,11,25,0,0,0,92,GSW,32,32,26,21,0,0,0,111,20140130
2014,PHO,36,30,11,25,0,0,0,102,IND,19,30,25,20,0,0,0,94,20140130
2014,CLE,21,15,29,21,0,0,0,86,NYK,38,22,21,36,0,0,0,117,20140130
2014,OKC,30,33,26,31,0,0,0,120,BRK,16,19,24,36,0,0,0,95,20140131
2014,SAC,20,29,32,22,0,0,0,103,DAL,24,30,21,32,0,0,0,107,20140131
2014,TOR,29,31,26,14,0,0,0,100,DEN,25,28,17,20,0,0,0,90,20140131
2014,CHA,31,31,24,24,0,0,0,110,LAL,27,22,25,26,0,0,0,100,20140131
2014,MEM,30,20,16,28,0,0,0,94,MIN,22,15,30,23,0,0,0,90,20140131
2014,MIL,20,26,18,38,0,0,0,102,ORL,35,32,21,25,0,0,0,113,20140131
2014,ATL,27,37,38,23,0,0,0,125,PHI,21,31,23,24,0,0,0,99,20140131
2014,GSW,23,18,25,29,0,0,0,95,UTA,21,27,23,19,0,0,0,90,20140131
2014,MIN,24,30,21,38,0,0,0,113,ATL,25,23,38,34,0,0,0,120,20140201
2014,PHI,22,27,21,26,0,0,0,96,DET,32,25,36,20,0,0,0,113,20140201
2014,CLE,23,29,21,19,0,0,0,92,HOU,31,30,23,22,0,0,0,106,20140201
2014,BRK,24,21,25,26,0,0,0,96,IND,25,21,26,25,0,0,0,97,20140201
2014,UTA,21,21,23,22,0,0,0,87,LAC,19,23,34,26,0,0,0,102,20140201
2014,MIL,24,25,20,21,0,0,0,90,MEM,17,26,24,32,0,0,0,99,20140201
2014,CHI,21,18,18,22,0,0,0,79,NOP,23,27,21,17,0,0,0,88,20140201
2014,MIA,29,24,24,29,0,0,0,106,NYK,22,24,25,20,0,0,0,91,20140201
2014,CHA,27,14,22,32,0,0,0,95,PHO,32,27,31,15,0,0,0,105,20140201
2014,TOR,19,21,34,29,0,0,0,103,POR,31,26,26,23,0,0,0,106,20140201
2014,SAC,24,29,25,15,0,0,0,93,SAS,27,25,19,24,0,0,0,95,20140201
2014,OKC,13,25,26,17,0,0,0,81,WAS,25,17,36,18,0,0,0,96,20140201
2014,ORL,19,26,19,25,0,0,0,89,BOS,27,27,17,25,0,0,0,96,20140202
2014,PHI,16,33,20,33,0,0,0,102,BRK,24,30,30,24,0,0,0,108,20140203
2014,CLE,25,27,27,28,0,0,0,107,DAL,27,32,35,30,0,0,0,124,20140203
2014,LAC,29,31,21,34,0,0,0,115,DEN,25,35,22,34,0,0,0,116,20140203
2014,ORL,22,28,13,16,0,0,0,79,IND,29,30,16,23,0,0,0,98,20140203
2014,DET,29,28,23,16,0,0,0,96,MIA,32,31,21,18,0,0,0,102,20140203
2014,NYK,19,24,26,29,0,0,0,98,MIL,18,32,25,26,0,0,0,101,20140203
2014,SAS,25,17,22,38,0,0,0,102,NOP,27,27,22,19,0,0,0,95,20140203
2014,MEM,18,18,25,16,0,0,0,77,OKC,20,31,18,17,0,0,0,86,20140203
2014,CHI,12,21,24,13,0,0,0,70,SAC,24,20,27,28,0,0,0,99,20140203
2014,TOR,24,31,16,23,0,0,0,94,UTA,27,17,18,17,0,0,0,79,20140203
2014,POR,29,26,14,21,0,0,0,90,WAS,32,24,26,18,0,0,0,100,20140203
2014,IND,19,23,24,23,0,0,0,89,ATL,15,28,12,30,0,0,0,85,20140204
2014,CHA,26,25,21,19,0,0,0,91,GSW,13,26,18,18,0,0,0,75,20140204
2014,LAL,26,26,26,21,0,0,0,99,MIN,38,30,21,20,0,0,0,109,20140204
2014,CHI,21,23,25,32,0,0,0,101,PHO,13,20,30,29,0,0,0,92,20140204
2014,LAL,36,34,28,21,0,0,0,119,CLE,17,32,31,28,0,0,0,108,20140205
2014,MIL,24,28,20,28,0,0,0,100,DEN,30,21,33,26,0,0,0,110,20140205
2014,PHO,30,33,27,18,0,0,0,108,HOU,35,31,29,27,0,0,0,122,20140205
2014,MIA,36,26,27,27,0,0,0,116,LAC,24,31,20,37,0,0,0,112,20140205
2014,DAL,21,31,26,32,0,0,0,110,MEM,26,29,17,24,0,0,0,96,20140205
2014,ATL,24,27,24,25,0,0,0,100,NOP,28,19,24,34,0,0,0,105,20140205
2014,POR,26,21,30,17,0,0,0,94,NYK,23,23,22,22,0,0,0,90,20140205
2014,MIN,25,29,23,20,0,0,0,97,OKC,26,30,24,26,0,0,0,106,20140205
2014,DET,26,17,31,24,0,0,0,98,ORL,26,31,31,24,0,0,0,112,20140205
2014,BOS,34,22,32,26,0,0,0,114,PHI,23,24,35,26,0,0,0,108,20140205
2014,TOR,23,29,20,29,0,0,0,101,SAC,30,37,25,17,0,0,0,109,20140205
2014,SAS,25,23,34,17,16,10,0,125,WAS,33,29,21,16,16,3,0,118,20140205
2014,SAS,24,15,29,21,0,0,0,89,BRK,17,23,35,28,0,0,0,103,20140206
2014,CHI,29,17,22,19,0,0,0,87,GSW,16,34,26,26,0,0,0,102,20140206
2014,SAC,29,17,23,20,0,0,0,89,BOS,21,28,22,28,0,0,0,99,20140207
2014,UTA,23,20,24,14,0,0,0,81,DAL,28,26,28,21,0,0,0,103,20140207
2014,BRK,17,27,29,22,0,0,0,95,DET,30,37,29,15,0,0,0,111,20140207
2014,POR,28,22,27,26,10,0,0,113,IND,16,29,26,32,15,0,0,118,20140207
2014,TOR,22,29,32,22,0,0,0,105,LAC,29,38,25,26,0,0,0,118,20140207
2014,MIN,26,21,24,20,0,0,0,91,NOP,25,17,19,37,0,0,0,98,20140207
2014,DEN,26,18,24,22,0,0,0,90,NYK,20,30,33,34,0,0,0,117,20140207
2014,OKC,36,29,23,14,0,0,0,102,ORL,23,28,29,23,0,0,0,103,20140207
2014,LAL,26,35,26,25,0,0,0,112,PHI,35,29,21,13,0,0,0,98,20140207
2014,CLE,32,35,26,22,0,0,0,115,WAS,38,25,22,28,0,0,0,113,20140207
2014,MEM,27,10,24,18,0,0,0,79,ATL,29,14,11,22,0,0,0,76,20140208
2014,SAS,21,20,28,35,0,0,0,104,CHA,25,17,28,30,0,0,0,100,20140208
2014,DEN,29,32,25,23,0,0,0,109,DET,30,35,32,29,0,0,0,126,20140208
2014,HOU,29,27,25,20,0,0,0,101,MIL,26,19,24,26,0,0,0,95,20140208
2014,POR,28,27,28,34,0,0,0,117,MIN,23,31,29,27,0,0,0,110,20140208
2014,GSW,28,31,31,19,0,0,0,109,PHO,29,34,32,27,0,0,0,122,20140208
2014,MIA,20,30,16,23,0,0,0,89,UTA,32,20,16,26,0,0,0,94,20140208
2014,DAL,17,27,28,30,0,0,0,102,BOS,16,22,18,35,0,0,0,91,20140209
2014,NOP,14,14,32,21,0,0,0,81,BRK,29,22,20,22,0,0,0,93,20140209
2014,MEM,18,15,25,20,5,0,0,83,CLE,22,20,17,19,13,0,0,91,20140209
2014,PHI,15,15,21,27,0,0,0,78,LAC,46,23,31,23,0,0,0,123,20140209
2014,CHI,34,18,25,15,0,0,0,92,LAL,23,23,16,24,0,0,0,86,20140209
2014,NYK,28,25,25,22,0,0,0,100,OKC,29,29,28,26,0,0,0,112,20140209
2014,IND,31,21,22,18,0,0,0,92,ORL,28,15,21,29,0,0,0,93,20140209
2014,SAC,24,21,19,20,0,0,0,84,WAS,28,29,18,18,0,0,0,93,20140209
2014,SAS,24,24,24,28,0,0,0,100,DET,25,34,33,17,0,0,0,109,20140210
2014,PHI,21,12,19,28,0,0,0,80,GSW,29,37,32,25,0,0,0,123,20140210
2014,DEN,20,20,16,24,0,0,0,80,IND,31,30,24,34,0,0,0,119,20140210
2014,BOS,26,23,21,32,0,0,0,102,MIL,24,22,22,18,0,0,0,86,20140210
2014,HOU,34,33,15,25,0,0,0,107,MIN,28,30,20,11,0,0,0,89,20140210
2014,NOP,20,29,21,31,0,0,0,101,TOR,31,18,33,26,0,0,0,108,20140210
2014,DAL,26,18,21,24,0,0,0,89,CHA,28,30,31,25,0,0,0,114,20140211
2014,ATL,17,22,31,15,0,0,0,85,CHI,33,25,22,20,0,0,0,100,20140211
2014,SAC,23,20,25,31,0,0,0,99,CLE,30,25,25,29,0,0,0,109,20140211
2014,UTA,16,32,20,28,0,0,0,96,LAL,27,10,23,19,0,0,0,79,20140211
2014,WAS,23,16,31,19,0,0,0,89,MEM,24,28,27,13,0,0,0,92,20140211
2014,MIA,22,21,28,32,0,0,0,103,PHO,25,21,28,23,0,0,0,97,20140211
2014,OKC,19,26,35,18,0,0,0,98,POR,25,30,25,15,0,0,0,95,20140211
2014,SAS,25,23,23,33,0,0,0,104,BOS,19,25,22,26,0,0,0,92,20140212
2014,CHA,29,15,19,26,0,0,0,89,BRK,30,20,35,20,0,0,0,105,20140212
2014,CLE,22,18,19,34,0,0,0,93,DET,28,23,15,23,0,0,0,89,20140212
2014,MIA,28,29,27,27,0,0,0,111,GSW,20,26,36,28,0,0,0,110,20140212
2014,WAS,26,28,36,22,0,0,0,112,HOU,38,25,30,20,0,0,0,113,20140212
2014,DAL,19,25,16,21,0,0,0,81,IND,19,23,20,11,0,0,0,73,20140212
2014,POR,30,31,34,22,0,0,0,117,LAC,31,30,31,30,0,0,0,122,20140212
2014,NOP,25,21,37,19,0,0,0,102,MIL,19,30,27,22,0,0,0,98,20140212
2014,DEN,19,22,23,26,0,0,0,90,MIN,31,30,28,28,0,0,0,117,20140212
2014,SAC,22,26,24,21,13,0,0,106,NYK,33,21,20,19,8,0,0,101,20140212
2014,MEM,24,18,22,22,0,0,0,86,ORL,17,17,27,20,0,0,0,81,20140212
2014,ATL,24,20,21,18,0,0,0,83,TOR,19,26,33,26,0,0,0,104,20140212
2014,PHI,22,26,21,31,0,0,0,100,UTA,31,25,22,27,0,0,0,105,20140212
2014,BRK,19,22,20,15,0,0,0,76,CHI,29,20,20,23,0,0,0,92,20140213
2014,OKC,17,28,27,35,0,0,0,107,LAL,24,30,28,21,0,0,0,103,20140213
2014,MIA,30,30,24,33,0,0,0,117,DAL,28,26,31,21,0,0,0,106,20140218
2014,PHO,31,21,24,23,13,0,0,112,DEN,25,26,26,22,8,0,0,107,20140218
2014,CHA,32,22,25,29,0,0,0,108,DET,21,22,24,29,0,0,0,96,20140218
2014,ATL,23,26,26,23,0,0,0,98,IND,35,22,30,21,0,0,0,108,20140218
2014,SAS,24,32,26,31,0,0,0,113,LAC,26,25,25,27,0,0,0,103,20140218
2014,NYK,17,20,27,29,0,0,0,93,MEM,22,28,16,32,0,0,0,98,20140218
2014,ORL,22,25,32,21,0,0,0,100,MIL,25,28,28,23,0,0,0,104,20140218
2014,CLE,31,33,21,29,0,0,0,114,PHI,25,18,19,23,0,0,0,85,20140218
2014,TOR,27,28,29,19,0,0,0,103,WAS,27,22,21,23,0,0,0,93,20140218
2014,WAS,31,27,33,23,0,0,0,114,ATL,14,33,36,14,0,0,0,97,20140219
2014,DET,21,26,25,26,0,0,0,98,CHA,28,25,33,30,0,0,0,116,20140219
2014,ORL,11,25,32,25,0,0,0,93,CLE,26,29,17,29,0,0,0,101,20140219
2014,HOU,32,32,40,30,0,0,0,134,LAL,22,21,32,33,0,0,0,108,20140219
2014,IND,18,21,33,19,0,0,0,91,MIN,30,22,30,22,0,0,0,104,20140219
2014,NYK,23,30,25,20,0,0,0,98,NOP,24,23,23,21,0,0,0,91,20140219
2014,BOS,21,29,21,23,0,0,0,94,PHO,29,23,24,24,0,0,0,100,20140219
2014,SAS,18,33,28,32,0,0,0,111,POR,24,28,29,28,0,0,0,109,20140219
2014,GSW,30,29,16,26,0,0,0,101,SAC,26,24,26,16,0,0,0,92,20140219
2014,CHI,31,17,22,24,0,0,0,94,TOR,21,20,21,30,0,0,0,92,20140219
2014,BRK,21,27,27,30,0,0,0,105,UTA,28,28,18,25,0,0,0,99,20140219
2014,HOU,24,19,24,22,10,0,0,99,GSW,20,27,24,18,13,0,0,102,20140220
2014,DEN,31,19,28,23,0,0,0,101,MIL,22,20,25,23,0,0,0,90,20140220
2014,MIA,34,20,22,27,0,0,0,103,OKC,17,30,18,16,0,0,0,81,20140220
2014,NOP,17,15,27,28,0,0,0,87,CHA,25,18,25,22,0,0,0,90,20140221
2014,DEN,19,27,23,20,0,0,0,89,CHI,32,37,25,23,0,0,0,117,20140221
2014,ATL,22,41,20,24,0,0,0,107,DET,19,33,34,29,0,0,0,115,20140221
2014,BOS,28,18,28,18,0,0,0,92,LAL,19,25,19,38,0,0,0,101,20140221
2014,LAC,27,23,18,28,0,0,0,96,MEM,21,32,20,29,0,0,0,102,20140221
2014,NYK,30,30,26,20,7,8,0,121,ORL,31,22,26,27,7,16,0,129,20140221
2014,DAL,41,28,32,23,0,0,0,124,PHI,23,39,27,23,0,0,0,112,20140221
2014,SAS,23,12,22,28,0,0,0,85,PHO,19,28,27,32,0,0,0,106,20140221
2014,UTA,15,24,34,21,0,0,0,94,POR,16,27,21,38,0,0,0,102,20140221
2014,CLE,22,22,21,26,0,0,0,91,TOR,16,23,37,22,0,0,0,98,20140221
2014,NYK,23,29,21,25,0,0,0,98,ATL,24,15,29,39,0,0,0,107,20140222
2014,MEM,21,27,15,26,0,0,0,89,CHA,28,14,22,28,0,0,0,92,20140222
2014,DAL,29,35,24,25,0,0,0,113,DET,27,27,28,20,0,0,0,102,20140222
2014,BRK,23,23,18,22,0,0,0,86,GSW,28,21,19,25,0,0,0,93,20140222
2014,IND,27,24,24,35,0,0,0,110,MIL,18,21,29,32,0,0,0,100,20140222
2014,BOS,16,27,27,28,0,0,0,98,SAC,23,28,26,28,0,0,0,105,20140222
2014,MIN,26,33,35,27,0,0,0,121,UTA,21,28,32,23,0,0,0,104,20140222
2014,NOP,21,22,23,27,0,0,0,93,WAS,24,19,23,28,0,0,0,94,20140222
2014,WAS,30,28,20,18,0,0,0,96,CLE,27,25,20,11,0,0,0,83,20140223
2014,SAC,27,21,39,22,0,0,0,109,DEN,27,25,18,25,0,0,0,95,20140223
2014,BRK,33,30,23,22,0,0,0,108,LAL,21,26,27,28,0,0,0,102,20140223
2014,CHI,24,16,12,27,0,0,0,79,MIA,20,20,25,28,0,0,0,93,20140223
2014,LAC,28,44,27,26,0,0,0,125,OKC,32,34,27,24,0,0,0,117,20140223
2014,HOU,30,30,23,32,0,0,0,115,PHO,16,40,37,19,0,0,0,112,20140223
2014,MIN,34,26,20,17,0,0,0,97,POR,26,26,32,24,0,0,0,108,20140223
2014,ORL,14,27,24,25,0,0,0,90,TOR,19,25,36,25,0,0,0,105,20140223
2014,GSW,33,30,18,23,0,0,0,104,DET,37,25,21,13,0,0,0,96,20140224
2014,LAC,32,29,32,30,0,0,0,123,NOP,26,27,25,32,0,0,0,110,20140224
2014,DAL,31,29,24,26,0,0,0,110,NYK,21,38,23,26,0,0,0,108,20140224
2014,MIL,30,43,33,24,0,0,0,130,PHI,28,16,32,34,0,0,0,110,20140224
2014,BOS,18,28,22,30,0,0,0,98,UTA,27,32,24,27,0,0,0,110,20140224
2014,CHI,20,34,26,27,0,0,0,107,ATL,30,21,24,28,0,0,0,103,20140225
2014,TOR,23,24,21,31,0,0,0,99,CLE,17,24,28,24,0,0,0,93,20140225
2014,POR,32,20,30,18,0,0,0,100,DEN,21,24,24,26,0,0,0,95,20140225
2014,LAL,23,31,16,28,0,0,0,98,IND,30,27,34,27,0,0,0,118,20140225
2014,MIN,34,21,20,35,0,0,0,110,PHO,28,29,24,20,0,0,0,101,20140225
2014,HOU,42,27,35,25,0,0,0,129,SAC,17,34,26,26,0,0,0,103,20140225
2014,ORL,31,22,27,26,0,0,0,106,WAS,35,27,31,22,0,0,0,115,20140225
2014,ATL,27,29,23,25,0,0,0,104,BOS,25,33,23,34,0,0,0,115,20140226
2014,GSW,24,21,14,24,0,0,0,83,CHI,21,35,24,23,0,0,0,103,20140226
2014,NOP,27,16,24,22,0,0,0,89,DAL,20,29,29,30,0,0,0,108,20140226
2014,HOU,22,26,25,20,0,0,0,93,LAC,26,20,28,27,0,0,0,101,20140226
2014,LAL,23,23,27,30,0,0,0,103,MEM,31,34,17,26,0,0,0,108,20140226
2014,CLE,26,25,21,42,0,0,0,114,OKC,27,25,24,28,0,0,0,104,20140226
2014,ORL,19,21,27,34,0,0,0,101,PHI,22,22,23,23,0,0,0,90,20140226
2014,BRK,20,14,25,21,0,0,0,80,POR,29,29,24,42,0,0,0,124,20140226
2014,DET,26,27,28,29,0,0,0,110,SAS,28,29,33,30,0,0,0,120,20140226
2014,PHO,25,19,20,22,0,0,0,86,UTA,28,25,25,31,0,0,0,109,20140226
2014,BRK,29,30,30,23,0,0,0,112,DEN,8,28,20,33,0,0,0,89,20140227
2014,MIL,15,35,16,30,0,0,0,96,IND,30,20,23,28,0,0,0,101,20140227
2014,NYK,22,28,14,18,0,0,0,82,MIA,28,27,32,21,0,0,0,108,20140227
2014,WAS,21,36,26,23,8,4,16,134,TOR,27,27,24,28,8,4,11,129,20140227
2014,UTA,27,14,19,19,0,0,0,79,CLE,20,19,30,30,0,0,0,99,20140228
2014,CHI,20,31,22,27,0,0,0,100,DAL,32,22,22,15,0,0,0,91,20140228
2014,SAC,31,34,34,23,0,0,0,122,LAL,27,27,41,31,0,0,0,126,20140228
2014,GSW,38,35,26,27,0,0,0,126,NYK,27,25,28,23,0,0,0,103,20140228
2014,MEM,22,20,29,36,0,0,0,107,OKC,29,28,30,26,0,0,0,113,20140228
2014,NOP,28,26,27,23,0,0,0,104,PHO,30,26,25,35,0,0,0,116,20140228
2014,CHA,25,20,20,17,0,0,0,82,SAS,14,27,25,26,0,0,0,92,20140228
2014,IND,28,27,21,26,0,0,0,102,BOS,27,21,30,19,0,0,0,97,20140301
2014,DET,20,26,34,30,0,0,0,110,HOU,41,28,26,23,0,0,0,118,20140301
2014,NOP,17,19,20,20,0,0,0,76,LAC,30,21,28,29,0,0,0,108,20140301
2014,CLE,30,35,15,16,0,0,0,96,MEM,22,32,33,23,0,0,0,110,20140301
2014,ORL,30,23,20,25,0,0,0,98,MIA,32,29,28,23,0,0,0,112,20140301
2014,BRK,31,24,22,30,0,0,0,107,MIL,29,24,19,26,0,0,0,98,20140301
2014,WAS,41,33,23,25,0,0,0,122,PHI,28,34,21,20,0,0,0,103,20140301
2014,DEN,24,24,25,23,0,0,0,96,POR,32,24,28,18,0,0,0,102,20140301
2014,MIN,30,23,31,24,0,0,0,108,SAC,31,25,14,27,0,0,0,97,20140301
2014,NYK,16,32,20,22,0,0,0,90,CHI,37,22,21,29,0,0,0,109,20140302
2014,UTA,20,26,24,21,0,0,0,91,IND,21,24,30,19,0,0,0,94,20140302
2014,CHA,25,30,26,18,0,0,0,99,OKC,31,30,24,31,0,0,0,116,20140302
2014,PHI,27,19,23,12,0,0,0,81,ORL,28,15,23,26,0,0,0,92,20140302
2014,ATL,37,28,30,25,0,0,0,120,PHO,40,39,23,27,0,0,0,129,20140302
2014,DAL,22,25,23,36,0,0,0,106,SAS,25,23,30,34,0,0,0,112,20140302
2014,GSW,28,22,28,20,0,0,0,98,TOR,25,30,20,29,0,0,0,104,20140302
2014,CHI,18,24,17,21,0,0,0,80,BRK,27,23,26,20,0,0,0,96,20140303
2014,MIN,40,26,32,34,0,0,0,132,DEN,25,24,34,45,0,0,0,128,20140303
2014,NYK,28,16,20,21,0,0,0,85,DET,20,19,30,27,0,0,0,96,20140303
2014,CHA,26,28,25,28,0,0,0,107,MIA,29,31,38,26,0,0,0,124,20140303
2014,UTA,21,27,19,21,0,0,0,88,MIL,30,25,40,19,0,0,0,114,20140303
2014,LAL,33,30,24,20,0,0,0,107,POR,20,36,28,22,0,0,0,106,20140303
2014,NOP,18,20,21,30,0,0,0,89,SAC,23,17,28,28,0,0,0,96,20140303
2014,MEM,20,30,29,31,0,0,0,110,WAS,20,25,19,40,0,0,0,104,20140303
2014,SAS,13,37,35,37,0,0,0,122,CLE,23,17,28,33,0,0,0,101,20140304
2014,MIA,32,20,21,30,0,0,0,103,HOU,39,14,30,23,0,0,0,106,20140304
2014,GSW,25,23,25,25,0,0,0,98,IND,21,21,28,26,0,0,0,96,20140304
2014,NOP,35,32,28,37,0,0,0,132,LAL,23,28,34,40,0,0,0,125,20140304
2014,PHI,23,22,31,16,0,0,0,92,OKC,37,24,37,27,0,0,0,125,20140304
2014,LAC,24,20,37,23,0,0,0,104,PHO,25,30,18,23,0,0,0,96,20140304
2014,GSW,30,31,23,24,0,0,0,108,BOS,22,18,14,34,0,0,0,88,20140305
2014,MEM,19,25,16,34,0,0,0,94,BRK,30,24,33,16,0,0,0,103,20140305
2014,IND,8,30,19,30,0,0,0,87,CHA,28,19,26,36,0,0,0,109,20140305
2014,DAL,34,17,22,37,0,0,0,110,DEN,41,27,11,36,0,0,0,115,20140305
2014,CHI,19,33,19,34,0,0,0,105,DET,25,22,23,24,0,0,0,94,20140305
2014,SAC,28,33,34,21,0,0,0,116,MIL,26,22,26,28,0,0,0,102,20140305
2014,NYK,38,28,22,30,0,0,0,118,MIN,24,31,31,20,0,0,0,106,20140305
2014,HOU,19,22,34,26,0,0,0,101,ORL,32,16,17,24,0,0,0,89,20140305
2014,ATL,19,19,17,23,0,0,0,78,POR,29,27,23,23,0,0,0,102,20140305
2014,UTA,23,21,27,20,0,0,0,91,WAS,28,26,25,25,0,0,0,104,20140305
2014,LAC,29,44,36,33,0,0,0,142,LAL,27,13,20,34,0,0,0,94,20140306
2014,OKC,41,24,33,24,0,0,0,122,PHO,32,29,40,27,0,0,0,128,20140306
2014,MIA,22,29,23,13,0,0,0,87,SAS,37,25,20,29,0,0,0,111,20140306
2014,BRK,20,21,29,14,0,0,0,84,BOS,26,27,25,13,0,0,0,91,20140307
2014,CLE,25,25,24,18,0,0,0,92,CHA,32,23,21,25,0,0,0,101,20140307
2014,MEM,15,20,30,20,0,0,0,85,CHI,12,27,24,14,0,0,0,77,20140307
2014,POR,10,28,36,24,0,0,0,98,DAL,33,24,18,28,0,0,0,103,20140307
2014,LAL,35,31,25,35,0,0,0,126,DEN,42,35,33,24,0,0,0,134,20140307
2014,ATL,31,21,25,20,0,0,0,97,GSW,32,34,19,26,0,0,0,111,20140307
2014,IND,16,27,16,27,0,0,0,86,HOU,27,23,38,24,0,0,0,112,20140307
2014,DET,21,24,24,32,0,0,0,101,MIN,39,27,31,17,0,0,0,114,20140307
2014,MIL,25,24,28,27,0,0,0,104,NOP,22,29,27,34,0,0,0,112,20140307
2014,UTA,22,19,19,21,0,0,0,81,NYK,39,21,24,24,0,0,0,108,20140307
2014,SAC,19,25,19,24,0,0,0,87,TOR,29,22,29,19,0,0,0,99,20140307
2014,NYK,23,35,19,30,0,0,0,107,CLE,19,31,26,21,0,0,0,97,20140308
2014,ATL,32,26,20,30,0,0,0,108,LAC,25,32,31,21,0,0,0,109,20140308
2014,CHA,21,23,17,28,0,0,0,89,MEM,25,27,27,32,0,0,0,111,20140308
2014,WAS,36,39,10,29,0,0,0,114,MIL,27,26,21,33,0,0,0,107,20140308
2014,UTA,24,26,25,29,0,0,0,104,PHI,22,30,18,22,0,0,0,92,20140308
2014,ORL,27,34,22,29,0,0,0,112,SAS,31,28,29,33,0,0,0,121,20140308
2014,DET,22,27,35,27,0,0,0,111,BOS,26,31,38,23,0,0,0,118,20140309
2014,SAC,19,21,25,24,0,0,0,89,BRK,28,21,28,27,0,0,0,104,20140309
2014,MIA,19,24,24,19,2,0,0,88,CHI,21,16,22,27,9,0,0,95,20140309
2014,IND,18,27,26,23,0,0,0,94,DAL,30,18,28,29,0,0,0,105,20140309
2014,PHO,29,32,17,29,0,0,0,107,GSW,22,34,38,19,0,0,0,113,20140309
2014,POR,30,24,31,21,7,0,0,113,HOU,28,19,26,33,12,0,0,118,20140309
2014,OKC,35,21,19,35,0,0,0,110,LAL,26,25,36,27,0,0,0,114,20140309
2014,TOR,33,20,30,28,0,0,0,111,MIN,33,19,24,28,0,0,0,104,20140309
2014,DEN,29,25,19,21,13,0,0,107,NOP,17,26,30,21,17,0,0,111,20140309
2014,TOR,30,21,22,24,0,0,0,97,BRK,19,31,28,23,0,0,0,101,20140310
2014,DEN,22,23,23,30,0,0,0,98,CHA,25,26,28,26,0,0,0,105,20140310
2014,PHO,23,22,31,29,0,0,0,105,LAC,34,28,28,22,0,0,0,112,20140310
2014,WAS,23,22,28,17,0,0,0,90,MIA,31,22,20,26,0,0,0,99,20140310
2014,ORL,24,27,20,27,0,0,0,98,MIL,13,32,23,37,0,0,0,105,20140310
2014,PHI,31,30,24,25,0,0,0,110,NYK,26,35,30,32,0,0,0,123,20140310
2014,ATL,28,31,19,34,0,0,0,112,UTA,22,22,36,30,0,0,0,110,20140310
2014,SAS,38,23,29,14,0,0,0,104,CHI,14,19,33,30,0,0,0,96,20140311
2014,SAC,31,23,11,24,0,0,0,89,DET,28,24,20,27,0,0,0,99,20140311
2014,DAL,22,22,13,28,0,0,0,85,GSW,29,26,24,29,0,0,0,108,20140311
2014,BOS,20,20,21,22,0,0,0,83,IND,24,25,20,25,0,0,0,94,20140311
2014,POR,23,24,22,30,0,0,0,99,MEM,22,32,24,31,0,0,0,109,20140311
2014,MIL,33,28,23,17,0,0,0,101,MIN,28,27,31,26,0,0,0,112,20140311
2014,HOU,24,17,26,31,0,0,0,98,OKC,26,30,21,29,0,0,0,106,20140311
2014,NYK,36,32,17,31,0,0,0,116,BOS,24,24,27,17,0,0,0,92,20140312
2014,GSW,29,27,23,19,0,0,0,98,LAC,29,25,30,27,0,0,0,111,20140312
2014,BRK,22,20,31,23,0,0,0,96,MIA,22,20,29,24,0,0,0,95,20140312
2014,MEM,28,20,19,23,0,0,0,90,NOP,26,31,17,14,0,0,0,88,20140312
2014,DEN,23,29,33,35,0,0,0,120,ORL,27,23,24,38,0,0,0,112,20140312
2014,SAC,28,30,32,25,0,0,0,115,PHI,24,30,22,22,0,0,0,98,20140312
2014,CLE,37,23,22,28,0,0,0,110,PHO,24,23,30,24,0,0,0,101,20140312
2014,POR,24,16,24,26,0,0,0,90,SAS,30,26,17,30,0,0,0,103,20140312
2014,DET,21,24,24,18,0,0,0,87,TOR,29,23,22,27,0,0,0,101,20140312
2014,DAL,23,32,25,28,0,0,0,108,UTA,25,28,25,23,0,0,0,101,20140312
2014,CHA,22,26,21,29,0,0,0,98,WAS,27,19,20,19,0,0,0,85,20140312
2014,MIL,30,23,14,30,0,0,0,97,ATL,23,24,21,34,0,0,0,102,20140313
2014,HOU,20,22,16,29,0,0,0,87,CHI,25,25,35,26,0,0,0,111,20140313
2014,LAL,19,27,31,25,0,0,0,102,OKC,33,27,41,30,0,0,0,131,20140313
2014,PHO,29,17,18,23,0,0,0,87,BOS,22,22,16,20,0,0,0,80,20140314
2014,MIN,33,20,22,18,0,0,0,93,CHA,33,32,23,17,0,0,0,105,20140314
2014,CLE,16,36,32,19,0,0,0,103,GSW,32,21,18,23,0,0,0,94,20140314
2014,DEN,20,38,27,26,0,0,0,111,MIA,30,23,18,36,0,0,0,107,20140314
2014,POR,29,24,27,31,0,0,0,111,NOP,26,29,26,22,0,0,0,103,20140314
2014,WAS,27,17,23,20,18,0,0,105,ORL,21,20,25,21,14,0,0,101,20140314
2014,IND,27,25,26,23,0,0,0,101,PHI,20,25,21,28,0,0,0,94,20140314
2014,LAL,14,20,26,25,0,0,0,85,SAS,29,32,28,30,0,0,0,119,20140314
2014,MEM,24,20,23,19,0,0,0,86,TOR,19,28,24,28,0,0,0,99,20140314
2014,LAC,22,21,34,19,0,0,0,96,UTA,33,18,21,15,0,0,0,87,20140314
2014,DEN,15,22,34,21,0,0,0,92,ATL,28,25,24,20,0,0,0,97,20140315
2014,SAC,23,20,20,24,0,0,0,87,CHI,23,25,16,30,0,0,0,94,20140315
2014,IND,20,21,32,27,12,0,0,112,DET,29,31,19,21,4,0,0,104,20140315
2014,MIL,23,19,24,28,0,0,0,94,NYK,30,30,28,27,0,0,0,115,20140315
2014,MEM,22,23,29,29,0,0,0,103,PHI,21,15,21,20,0,0,0,77,20140315
2014,BRK,26,31,22,15,0,0,0,94,WAS,19,29,24,29,0,0,0,101,20140315
2014,CLE,18,20,21,21,0,0,0,80,LAC,27,25,24,26,0,0,0,102,20140316
2014,HOU,28,26,27,23,0,0,0,104,MIA,32,25,22,34,0,0,0,113,20140316
2014,CHA,23,23,30,25,0,0,0,101,MIL,28,22,24,18,0,0,0,92,20140316
2014,SAC,29,25,20,28,0,0,0,102,MIN,32,21,24,27,0,0,0,104,20140316
2014,BOS,25,39,20,28,8,0,0,120,NOP,27,30,27,28,9,0,0,121,20140316
2014,DAL,29,30,32,18,0,0,0,109,OKC,23,25,22,16,0,0,0,86,20140316
2014,GSW,23,21,33,36,0,0,0,113,POR,24,31,30,27,0,0,0,112,20140316
2014,UTA,23,30,23,28,0,0,0,104,SAS,26,35,30,31,0,0,0,122,20140316
2014,PHO,37,24,35,25,0,0,0,121,TOR,35,24,31,23,0,0,0,113,20140316
2014,PHO,20,29,23,23,0,0,0,95,BRK,30,32,28,18,0,0,0,108,20140317
2014,ATL,22,24,30,21,0,0,0,97,CHA,28,24,16,15,0,0,0,83,20140317
2014,OKC,23,24,27,23,0,0,0,97,CHI,21,24,22,18,0,0,0,85,20140317
2014,BOS,22,21,18,28,0,0,0,89,DAL,26,24,14,30,0,0,0,94,20140317
2014,LAC,25,28,30,17,0,0,0,100,DEN,23,33,27,27,0,0,0,110,20140317
2014,UTA,20,21,28,17,0,0,0,86,HOU,28,32,32,32,0,0,0,124,20140317
2014,PHI,24,26,17,23,0,0,0,90,IND,21,37,17,24,0,0,0,99,20140317
2014,TOR,26,23,29,28,7,0,0,113,ATL,17,32,31,26,12,0,0,118,20140318
2014,MIA,37,22,20,21,0,0,0,100,CLE,25,29,25,17,0,0,0,96,20140318
2014,ORL,27,20,19,23,0,0,0,89,GSW,30,27,30,16,0,0,0,103,20140318
2014,MIL,29,18,25,26,17,0,0,115,POR,26,26,23,23,22,0,0,120,20140318
2014,WAS,19,27,27,27,11,0,0,111,SAC,30,17,23,30,17,0,0,117,20140318
2014,MIA,34,25,19,18,0,0,0,96,BOS,22,31,27,21,0,0,0,101,20140319
2014,CHA,21,25,24,29,0,0,0,99,BRK,26,28,21,29,0,0,0,104,20140319
2014,MIN,37,29,28,19,10,0,0,123,DAL,24,35,28,26,9,0,0,122,20140319
2014,DET,28,33,23,25,0,0,0,109,DEN,27,27,31,33,0,0,0,118,20140319
2014,SAS,35,23,34,33,0,0,0,125,LAL,29,28,30,22,0,0,0,109,20140319
2014,UTA,19,13,31,23,0,0,0,86,MEM,30,18,26,22,0,0,0,96,20140319
2014,TOR,24,32,25,26,0,0,0,107,NOP,32,25,28,15,0,0,0,100,20140319
2014,IND,14,21,27,24,0,0,0,86,NYK,21,26,20,25,0,0,0,92,20140319
2014,CHI,28,24,23,27,0,0,0,102,PHI,26,19,24,25,0,0,0,94,20140319
2014,ORL,25,27,24,17,0,0,0,93,PHO,25,27,30,27,0,0,0,109,20140319
2014,OKC,21,35,29,17,0,0,0,102,CLE,25,21,22,27,0,0,0,95,20140320
2014,MIL,21,30,24,35,0,0,0,110,GSW,29,24,29,33,0,0,0,115,20140320
2014,MIN,33,21,28,24,0,0,0,106,HOU,27,37,34,31,0,0,0,129,20140320
2014,WAS,28,23,22,30,0,0,0,103,POR,23,30,33,30,0,0,0,116,20140320
2014,NOP,20,24,25,42,0,0,0,111,ATL,16,28,27,34,0,0,0,105,20140321
2014,BOS,28,26,22,22,0,0,0,98,BRK,34,30,28,22,0,0,0,114,20140321
2014,DEN,29,24,25,28,0,0,0,106,DAL,26,35,29,32,0,0,0,122,20140321
2014,CHI,23,20,19,17,0,0,0,79,IND,19,25,31,16,0,0,0,91,20140321
2014,WAS,33,25,30,29,0,0,0,117,LAL,21,26,34,26,0,0,0,107,20140321
2014,MEM,22,21,25,18,0,0,0,86,MIA,15,30,23,23,0,0,0,91,20140321
2014,NYK,21,20,31,21,0,0,0,93,PHI,24,12,29,27,0,0,0,92,20140321
2014,DET,27,23,21,21,0,0,0,92,PHO,26,25,22,25,0,0,0,98,20140321
2014,SAS,24,23,22,30,0,0,0,99,SAC,23,14,20,22,0,0,0,79,20140321
2014,OKC,22,20,30,24,11,12,0,119,TOR,20,26,25,25,11,11,0,118,20140321
2014,POR,22,24,27,21,0,0,0,94,CHA,33,36,29,26,0,0,0,124,20140322
2014,PHI,25,13,21,22,0,0,0,81,CHI,20,21,24,26,0,0,0,91,20140322
2014,HOU,39,28,34,17,0,0,0,118,CLE,31,24,24,32,0,0,0,111,20140322
2014,SAS,32,18,26,23,0,0,0,99,GSW,22,25,22,21,0,0,0,90,20140322
2014,DET,26,29,15,33,0,0,0,103,LAC,36,20,24,32,0,0,0,112,20140322
2014,IND,17,13,19,22,0,0,0,71,MEM,19,24,21,18,0,0,0,82,20140322
2014,MIA,22,21,29,23,0,0,0,95,NOP,22,23,31,29,0,0,0,105,20140322
2014,ORL,16,27,18,27,0,0,0,88,UTA,27,22,17,23,0,0,0,89,20140322
2014,BRK,15,26,24,26,16,0,0,107,DAL,29,19,24,19,13,0,0,104,20140323
2014,WAS,29,20,24,29,0,0,0,102,DEN,21,26,30,28,0,0,0,105,20140323
2014,ORL,24,24,25,21,0,0,0,94,LAL,29,26,20,28,0,0,0,103,20140323
2014,PHO,27,35,31,34,0,0,0,127,MIN,41,32,30,17,0,0,0,120,20140323
2014,CLE,27,19,31,29,0,0,0,106,NYK,34,27,23,16,0,0,0,100,20140323
2014,MIL,16,28,26,37,0,0,0,107,SAC,39,31,34,20,0,0,0,124,20140323
2014,ATL,25,24,22,15,0,0,0,86,TOR,16,26,18,36,0,0,0,96,20140323
2014,PHO,25,17,35,25,0,0,0,102,ATL,23,22,23,27,0,0,0,95,20140324
2014,HOU,25,29,24,22,0,0,0,100,CHA,24,26,18,21,0,0,0,89,20140324
2014,IND,19,15,22,21,0,0,0,77,CHI,15,18,31,25,0,0,0,89,20140324
2014,MIL,25,27,22,24,0,0,0,98,LAC,35,22,22,27,0,0,0,106,20140324
2014,MIN,15,24,29,24,0,0,0,92,MEM,30,27,24,28,0,0,0,109,20140324
2014,POR,25,17,19,30,0,0,0,91,MIA,22,24,26,21,0,0,0,93,20140324
2014,BRK,26,32,18,22,6,0,0,104,NOP,20,22,31,25,11,0,0,109,20140324
2014,DEN,24,34,15,23,0,0,0,96,OKC,41,31,18,27,0,0,0,117,20140324
2014,PHI,24,20,24,23,0,0,0,91,SAS,31,29,29,24,0,0,0,113,20140324
2014,DET,26,34,26,28,0,0,0,114,UTA,23,17,29,25,0,0,0,94,20140324
2014,TOR,17,28,36,19,0,0,0,100,CLE,26,33,29,14,0,0,0,102,20140325
2014,OKC,24,36,29,22,8,0,0,119,DAL,28,31,25,27,17,0,0,128,20140325
2014,NYK,22,20,31,23,0,0,0,96,LAL,14,36,51,26,0,0,0,127,20140325
2014,POR,26,16,23,20,0,0,0,85,ORL,23,27,29,16,0,0,0,95,20140325
2014,TOR,31,24,22,22,0,0,0,99,BOS,22,24,16,28,0,0,0,90,20140326
2014,BRK,28,31,19,27,6,0,0,111,CHA,24,34,25,22,11,0,0,116,20140326
2014,CLE,24,26,16,31,0,0,0,97,DET,33,18,31,14,0,0,0,96,20140326
2014,MIA,17,28,23,15,0,0,0,83,IND,23,21,19,21,0,0,0,84,20140326
2014,ATL,19,22,20,22,0,0,0,83,MIN,20,28,27,32,0,0,0,107,20140326
2014,LAC,27,25,23,21,0,0,0,96,NOP,29,26,21,22,0,0,0,98,20140326
2014,NYK,31,32,23,21,0,0,0,107,SAC,28,20,24,27,0,0,0,99,20140326
2014,DEN,28,15,24,36,0,0,0,103,SAS,34,29,21,24,0,0,0,108,20140326
2014,MEM,17,23,22,29,0,0,0,91,UTA,25,25,21,16,0,0,0,87,20140326
2014,PHO,25,29,25,20,0,0,0,99,WAS,23,21,25,24,0,0,0,93,20140326
2014,POR,22,31,25,22,0,0,0,100,ATL,16,21,27,21,0,0,0,85,20140327
2014,LAC,29,29,23,28,0,0,0,109,DAL,29,31,21,22,0,0,0,103,20140327
2014,PHI,28,21,31,18,0,0,0,98,HOU,35,28,37,20,0,0,0,120,20140327
2014,LAL,30,23,27,25,0,0,0,105,MIL,26,29,32,21,0,0,0,108,20140327
2014,CLE,29,21,27,20,0,0,0,97,BRK,29,32,24,23,0,0,0,108,20140328
2014,POR,19,28,26,18,0,0,0,91,CHI,16,20,22,16,0,0,0,74,20140328
2014,SAS,31,31,35,36,0,0,0,133,DEN,23,20,31,28,0,0,0,102,20140328
2014,MIA,28,29,35,18,0,0,0,110,DET,23,19,18,18,0,0,0,78,20140328
2014,MEM,27,25,24,17,0,0,0,93,GSW,30,23,26,21,0,0,0,100,20140328
2014,LAL,24,19,34,30,0,0,0,107,MIN,41,33,37,32,0,0,0,143,20140328
2014,UTA,22,16,28,29,0,0,0,95,NOP,20,23,29,30,0,0,0,102,20140328
2014,SAC,15,23,13,30,0,0,0,81,OKC,32,22,28,12,0,0,0,94,20140328
2014,CHA,30,20,31,16,8,0,0,105,ORL,16,25,33,23,13,0,0,110,20140328
2014,NYK,26,14,26,22,0,0,0,88,PHO,34,28,26,24,0,0,0,112,20140328
2014,BOS,26,27,20,30,0,0,0,103,TOR,32,24,29,20,0,0,0,105,20140328
2014,IND,21,16,19,22,0,0,0,78,WAS,24,20,30,17,0,0,0,91,20140328
2014,SAC,19,23,28,30,0,0,0,100,DAL,26,28,18,31,0,0,0,103,20140329
2014,LAC,23,38,27,30,0,0,0,118,HOU,33,25,26,23,0,0,0,107,20140329
2014,MIA,21,25,19,23,0,0,0,88,MIL,12,17,17,21,0,0,0,67,20140329
2014,DET,23,28,17,30,0,0,0,98,PHI,33,37,28,25,0,0,0,123,20140329
2014,NOP,15,20,24,21,0,0,0,80,SAS,28,24,18,26,0,0,0,96,20140329
2014,ATL,27,25,19,26,0,0,0,97,WAS,28,22,25,26,0,0,0,101,20140329
2014,CHI,25,26,27,29,0,0,0,107,BOS,26,24,27,25,0,0,0,102,20140330
2014,MIN,27,27,28,17,0,0,0,99,BRK,30,29,26,29,0,0,0,114,20140330
2014,IND,20,16,22,18,0,0,0,76,CLE,25,24,24,17,0,0,0,90,20140330
2014,NYK,22,34,18,15,0,0,0,89,GSW,32,12,22,18,0,0,0,84,20140330
2014,PHO,15,28,31,25,0,0,0,99,LAL,26,35,28,26,0,0,0,115,20140330
2014,UTA,9,31,37,19,0,0,0,96,OKC,26,33,33,24,0,0,0,116,20140330
2014,TOR,27,30,16,25,0,0,0,98,ORL,22,16,26,29,0,0,0,93,20140330
2014,MEM,23,22,25,28,0,0,0,98,POR,25,32,29,19,0,0,0,105,20140330
2014,PHI,31,22,20,22,0,0,0,95,ATL,18,25,32,28,0,0,0,103,20140331
2014,WAS,20,40,20,14,0,0,0,94,CHA,25,19,26,30,0,0,0,100,20140331
2014,BOS,24,26,20,10,0,0,0,80,CHI,25,23,23,23,0,0,0,94,20140331
2014,MEM,25,22,28,19,0,0,0,94,DEN,16,29,23,24,0,0,0,92,20140331
2014,MIL,30,31,21,29,0,0,0,111,DET,34,18,29,35,0,0,0,116,20140331
2014,SAS,25,23,21,34,0,0,0,103,IND,15,20,24,18,0,0,0,77,20140331
2014,TOR,23,28,14,18,0,0,0,83,MIA,24,30,20,19,0,0,0,93,20140331
2014,LAC,26,28,34,26,0,0,0,114,MIN,22,29,15,38,0,0,0,104,20140331
2014,SAC,29,24,27,22,0,0,0,102,NOP,22,33,21,21,0,0,0,97,20140331
2014,NYK,21,27,31,13,0,0,0,92,UTA,27,22,20,14,0,0,0,83,20140331
2014,HOU,24,27,28,17,0,0,0,96,BRK,29,25,29,22,0,0,0,105,20140401
2014,GSW,30,23,32,23,14,0,0,122,DAL,21,41,19,27,12,0,0,120,20140401
2014,POR,29,34,28,33,0,0,0,124,LAL,27,34,22,29,0,0,0,112,20140401
2014,CHI,31,26,21,27,0,0,0,105,ATL,31,18,23,20,0,0,0,92,20140402
2014,NOP,26,27,28,26,0,0,0,107,DEN,40,31,34,32,0,0,0,137,20140402
2014,DET,27,19,28,20,0,0,0,94,IND,28,22,23,28,0,0,0,101,20140402
2014,MIL,19,19,19,20,0,0,0,77,MIA,33,23,21,19,0,0,0,96,20140402
2014,MEM,20,21,20,27,0,0,0,88,MIN,20,28,29,25,0,0,0,102,20140402
2014,BRK,20,18,23,20,0,0,0,81,NYK,29,34,19,28,0,0,0,110,20140402
2014,CLE,35,35,24,25,0,0,0,119,ORL,27,20,21,30,0,0,0,98,20140402
2014,CHA,31,32,25,35,0,0,0,123,PHI,19,19,25,30,0,0,0,93,20140402
2014,LAC,30,30,18,34,0,0,0,112,PHO,25,37,29,17,0,0,0,108,20140402
2014,LAL,23,29,24,26,0,0,0,102,SAC,24,36,27,20,0,0,0,107,20140402
2014,GSW,18,24,25,23,0,0,0,90,SAS,31,26,30,24,0,0,0,111,20140402
2014,HOU,25,25,30,23,0,0,0,103,TOR,23,32,35,17,0,0,0,107,20140402
2014,BOS,21,25,16,30,0,0,0,92,WAS,29,28,32,29,0,0,0,118,20140402
2014,DAL,32,26,28,27,0,0,0,113,LAC,26,30,25,26,0,0,0,107,20140403
2014,SAS,24,27,20,23,0,0,0,94,OKC,22,26,32,26,0,0,0,106,20140403
2014,CLE,23,26,24,25,0,0,0,98,ATL,39,22,29,27,0,0,0,117,20140404
2014,PHI,23,26,27,35,0,0,0,111,BOS,17,34,20,31,0,0,0,102,20140404
2014,DET,22,23,24,35,0,0,0,104,BRK,22,35,34,25,0,0,0,116,20140404
2014,ORL,19,17,24,20,0,0,0,80,CHA,20,33,19,19,0,0,0,91,20140404
2014,MIL,15,20,27,28,0,0,0,90,CHI,27,24,31,20,0,0,0,102,20140404
2014,SAC,14,13,23,19,0,0,0,69,GSW,25,34,25,18,0,0,0,102,20140404
2014,OKC,23,22,39,23,0,0,0,107,HOU,27,23,32,29,0,0,0,111,20140404
2014,DAL,27,25,30,25,0,0,0,107,LAL,23,31,24,17,0,0,0,95,20140404
2014,DEN,18,29,18,27,0,0,0,92,MEM,24,19,26,31,0,0,0,100,20140404
2014,MIN,24,28,25,20,12,13,0,122,MIA,29,23,23,22,12,12,0,121,20140404
2014,WAS,27,12,25,26,0,0,0,90,NYK,21,22,24,22,0,0,0,89,20140404
2014,PHO,28,23,28,30,0,0,0,109,POR,26,28,26,13,0,0,0,93,20140404
2014,IND,28,18,29,19,0,0,0,94,TOR,27,27,21,27,0,0,0,102,20140404
2014,NOP,23,22,20,31,0,0,0,96,UTA,25,18,30,27,0,0,0,100,20140404
2014,CHA,17,23,22,20,14,0,0,96,CLE,21,12,33,16,12,0,0,94,20140405
2014,BOS,32,33,30,16,0,0,0,111,DET,29,26,30,30,0,0,0,115,20140405
2014,TOR,28,19,28,27,0,0,0,102,MIL,22,34,20,22,0,0,0,98,20140405
2014,MIN,26,22,29,15,0,0,0,92,ORL,25,21,26,28,0,0,0,100,20140405
2014,BRK,27,30,24,24,0,0,0,105,PHI,21,21,27,32,0,0,0,101,20140405
2014,CHI,28,24,24,20,0,0,0,96,WAS,16,10,35,17,0,0,0,78,20140405
2014,UTA,22,30,21,29,0,0,0,102,GSW,35,31,35,29,0,0,0,130,20140406
2014,DEN,27,25,36,29,8,0,0,125,HOU,22,47,19,29,13,0,0,130,20140406
2014,ATL,33,22,24,28,0,0,0,107,IND,11,12,36,29,0,0,0,88,20140406
2014,LAL,22,27,23,25,0,0,0,97,LAC,25,32,37,26,0,0,0,120,20140406
2014,NYK,26,24,14,27,0,0,0,91,MIA,25,23,25,29,0,0,0,102,20140406
2014,OKC,25,28,38,24,0,0,0,115,PHO,28,34,32,28,0,0,0,122,20140406
2014,NOP,25,30,14,25,0,0,0,94,POR,25,23,29,23,0,0,0,100,20140406
2014,DAL,29,16,23,25,0,0,0,93,SAC,24,24,17,26,0,0,0,91,20140406
2014,MEM,10,28,29,25,0,0,0,92,SAS,26,28,27,31,0,0,0,112,20140406
2014,DET,35,23,23,21,0,0,0,102,ATL,27,25,26,17,0,0,0,95,20140408
2014,HOU,35,31,49,30,0,0,0,145,LAL,26,35,29,40,0,0,0,130,20140408
2014,BRK,26,18,18,26,0,0,0,88,MIA,14,29,22,22,0,0,0,87,20140408
2014,SAS,19,15,29,28,0,0,0,91,MIN,27,27,31,25,0,0,0,110,20140408
2014,OKC,30,31,24,22,0,0,0,107,SAC,27,22,28,15,0,0,0,92,20140408
2014,DAL,39,22,20,14,0,0,0,95,UTA,25,21,19,18,0,0,0,83,20140408
2014,BOS,23,28,26,20,0,0,0,97,ATL,32,24,14,35,0,0,0,105,20140409
2014,DET,18,19,33,30,0,0,0,100,CLE,31,38,29,24,0,0,0,122,20140409
2014,HOU,18,40,30,28,0,0,0,116,DEN,30,38,37,18,0,0,0,123,20140409
2014,OKC,29,30,26,22,0,0,0,107,LAC,22,32,19,28,0,0,0,101,20140409
2014,MIA,32,26,22,22,0,0,0,102,MEM,31,23,26,27,0,0,0,107,20140409
2014,IND,25,28,19,32,0,0,0,104,MIL,25,25,17,35,0,0,0,102,20140409
2014,CHI,26,22,27,27,0,0,0,102,MIN,25,28,17,17,0,0,0,87,20140409
2014,PHO,23,24,24,23,0,0,0,94,NOP,14,32,18,24,0,0,0,88,20140409
2014,BRK,22,21,35,33,0,0,0,111,ORL,20,35,28,32,0,0,0,115,20140409
2014,SAC,20,26,25,28,0,0,0,99,POR,27,29,23,21,0,0,0,100,20140409
2014,PHI,28,32,29,25,0,0,0,114,TOR,34,34,30,27,0,0,0,125,20140409
2014,CHA,32,22,17,16,7,0,0,94,WAS,18,23,25,21,1,0,0,88,20140409
2014,SAS,30,19,34,26,0,0,0,109,DAL,22,29,21,28,0,0,0,100,20140410
2014,DEN,15,28,30,27,0,0,0,100,GSW,28,25,22,24,0,0,0,99,20140410
2014,CHA,29,26,20,28,0,0,0,103,BOS,28,29,27,22,0,0,0,106,20140411
2014,ATL,16,39,19,19,0,0,0,93,BRK,23,24,26,15,0,0,0,88,20140411
2014,DET,28,28,24,18,0,0,0,98,CHI,17,21,32,36,0,0,0,106,20140411
2014,GSW,26,32,25,29,0,0,0,112,LAL,26,17,26,26,0,0,0,95,20140411
2014,PHI,24,23,17,31,0,0,0,95,MEM,30,27,30,30,0,0,0,117,20140411
2014,IND,25,17,20,24,0,0,0,86,MIA,23,22,31,22,0,0,0,98,20140411
2014,CLE,32,37,18,29,0,0,0,116,MIL,37,25,30,27,0,0,0,119,20140411
2014,HOU,32,31,21,26,0,0,0,110,MIN,39,20,23,30,0,0,0,112,20140411
2014,NOP,23,24,15,32,0,0,0,94,OKC,30,30,27,29,0,0,0,116,20140411
2014,WAS,17,28,22,29,0,0,0,96,ORL,29,22,19,16,0,0,0,86,20140411
2014,PHO,37,25,19,23,0,0,0,104,SAS,24,25,37,26,0,0,0,112,20140411
2014,NYK,24,21,33,30,0,0,0,108,TOR,26,21,30,23,0,0,0,100,20140411
2014,POR,23,30,23,35,0,0,0,111,UTA,31,20,25,23,0,0,0,99,20140411
2014,MIA,23,26,13,23,0,0,0,85,ATL,28,21,20,29,0,0,0,98,20140412
2014,PHI,24,35,19,27,0,0,0,105,CHA,26,30,31,24,0,0,0,111,20140412
2014,BOS,28,32,29,22,0,0,0,111,CLE,18,24,16,41,0,0,0,99,20140412
2014,PHO,26,31,21,20,0,0,0,98,DAL,27,19,29,26,0,0,0,101,20140412
2014,UTA,23,21,21,29,0,0,0,94,DEN,18,16,30,37,0,0,0,101,20140412
2014,NOP,20,39,23,22,0,0,0,104,HOU,22,24,26,39,0,0,0,111,20140412
2014,SAC,26,21,32,22,0,0,0,101,LAC,27,29,29,32,0,0,0,117,20140412
2014,MIL,26,26,22,17,0,0,0,91,WAS,27,28,32,17,0,0,0,104,20140412
2014,ORL,28,21,21,18,0,0,0,88,BRK,25,21,33,18,0,0,0,97,20140413
2014,TOR,42,21,24,29,0,0,0,116,DET,26,23,37,21,0,0,0,107,20140413
2014,OKC,21,24,21,31,0,0,0,97,IND,22,25,27,28,0,0,0,102,20140413
2014,MEM,23,30,34,15,0,0,0,102,LAL,27,25,17,21,0,0,0,90,20140413
2014,CHI,22,17,25,25,0,0,0,89,NYK,19,26,32,23,0,0,0,100,20140413
2014,GSW,19,33,23,30,12,0,0,117,POR,23,21,32,29,14,0,0,119,20140413
2014,MIN,28,24,24,27,0,0,0,103,SAC,30,17,28,31,0,0,0,106,20140413
2014,CHA,26,18,21,30,0,0,0,95,ATL,24,26,30,13,0,0,0,93,20140414
2014,ORL,21,23,26,25,0,0,0,95,CHI,26,31,24,27,0,0,0,108,20140414
2014,MIN,42,22,28,28,0,0,0,120,GSW,28,34,35,33,0,0,0,130,20140414
2014,SAS,21,22,25,30,0,0,0,98,HOU,30,20,26,28,0,0,0,104,20140414
2014,OKC,21,25,23,20,0,0,0,89,NOP,23,22,25,31,0,0,0,101,20140414
2014,BOS,33,17,34,24,0,0,0,108,PHI,33,34,19,27,0,0,0,113,20140414
2014,MEM,24,22,21,30,0,0,0,97,PHO,14,28,25,24,0,0,0,91,20140414
2014,MIL,19,27,23,31,0,0,0,100,TOR,32,27,25,26,0,0,0,110,20140414
2014,LAL,23,34,29,33,0,0,0,119,UTA,30,21,35,18,0,0,0,104,20140414
2014,MIA,26,22,17,28,0,0,0,93,WAS,27,43,28,16,0,0,0,114,20140414
2014,NYK,29,26,28,26,0,0,0,109,BRK,18,25,24,31,0,0,0,98,20140415
2014,DEN,26,20,34,25,0,0,0,105,LAC,38,25,25,29,0,0,0,117,20140415
2014,WAS,38,30,23,27,0,0,0,118,BOS,24,32,19,27,0,0,0,102,20140416
2014,CHI,21,18,21,20,6,0,0,86,CHA,16,27,16,21,11,0,0,91,20140416
2014,BRK,21,28,15,21,0,0,0,85,CLE,33,18,30,33,0,0,0,114,20140416
2014,GSW,36,30,22,28,0,0,0,116,DEN,27,25,28,32,0,0,0,112,20140416
2014,DAL,24,29,20,20,12,0,0,105,MEM,29,22,24,18,13,0,0,106,20140416
2014,PHI,29,26,29,16,0,0,0,100,MIA,27,24,15,21,0,0,0,87,20140416
2014,ATL,29,29,24,29,0,0,0,111,MIL,39,24,20,20,0,0,0,103,20140416
2014,UTA,31,20,29,27,12,17,0,136,MIN,17,31,22,37,12,11,0,130,20140416
2014,HOU,30,20,28,22,0,0,0,100,NOP,28,25,27,25,0,0,0,105,20140416
2014,TOR,28,29,17,18,0,0,0,92,NYK,21,23,30,21,0,0,0,95,20140416
2014,DET,30,25,32,24,0,0,0,111,OKC,28,26,25,33,0,0,0,112,20140416
2014,IND,25,21,29,26,0,0,0,101,ORL,20,20,22,24,0,0,0,86,20140416
2014,LAC,29,23,33,19,0,0,0,104,POR,37,31,14,28,0,0,0,110,20140416
2014,PHO,21,26,24,33,0,0,0,104,SAC,24,23,27,25,0,0,0,99,20140416
2014,LAL,33,18,35,27,0,0,0,113,SAS,23,28,24,25,0,0,0,100,20140416
2014,ATL,28,22,30,21,0,0,0,101,IND,22,28,16,27,0,0,0,93,20140419
2014,GSW,24,28,35,22,0,0,0,109,LAC,29,23,27,26,0,0,0,105,20140419
2014,MEM,16,18,31,21,0,0,0,86,OKC,29,27,13,31,0,0,0,100,20140419
2014,BRK,29,21,17,27,0,0,0,94,TOR,21,25,16,25,0,0,0,87,20140419
2014,WAS,24,24,24,30,0,0,0,102,CHI,22,32,21,18,0,0,0,93,20140420
2014,POR,27,21,25,33,16,0,0,122,HOU,20,29,30,27,14,0,0,120,20140420
2014,CHA,23,19,23,23,0,0,0,88,MIA,19,30,23,27,0,0,0,99,20140420
2014,DAL,12,32,21,20,0,0,0,85,SAS,21,22,22,25,0,0,0,90,20140420
2014,GSW,20,21,32,25,0,0,0,98,LAC,31,36,38,33,0,0,0,138,20140421
2014,MEM,24,22,22,31,12,0,0,111,OKC,16,27,22,34,6,0,0,105,20140421
2014,WAS,31,25,14,21,10,0,0,101,CHI,20,29,26,16,8,0,0,99,20140422
2014,ATL,26,26,13,20,0,0,0,85,IND,21,27,31,22,0,0,0,101,20140422
2014,BRK,19,20,27,29,0,0,0,95,TOR,21,24,19,36,0,0,0,100,20140422
2014,POR,23,30,30,29,0,0,0,112,HOU,31,22,24,28,0,0,0,105,20140423
2014,CHA,19,28,25,25,0,0,0,97,MIA,29,28,22,22,0,0,0,101,20140423
2014,DAL,24,32,32,25,0,0,0,113,SAS,23,28,24,17,0,0,0,92,20140423
2014,IND,24,14,20,27,0,0,0,85,ATL,24,15,28,31,0,0,0,98,20140424
2014,LAC,24,22,29,23,0,0,0,98,GSW,21,22,21,32,0,0,0,96,20140424
2014,OKC,18,18,25,24,10,0,0,95,MEM,24,20,27,14,13,0,0,98,20140424
2014,TOR,23,22,21,32,0,0,0,98,BRK,19,30,28,25,0,0,0,102,20140425
2014,HOU,35,19,27,29,11,0,0,121,POR,24,31,23,32,6,0,0,116,20140425
2014,CHI,28,20,24,28,0,0,0,100,WAS,30,21,18,28,0,0,0,97,20140425
2014,IND,29,13,24,25,0,0,0,91,ATL,22,26,17,23,0,0,0,88,20140426
2014,MIA,23,35,28,12,0,0,0,98,CHA,27,19,19,20,0,0,0,85,20140426
2014,SAS,34,20,20,34,0,0,0,108,DAL,27,32,18,32,0,0,0,109,20140426
2014,OKC,15,27,22,16,12,0,0,92,MEM,18,17,17,28,9,0,0,89,20140426
2014,TOR,35,16,16,20,0,0,0,87,BRK,22,22,23,12,0,0,0,79,20140427
2014,LAC,24,24,23,26,0,0,0,97,GSW,39,27,23,29,0,0,0,118,20140427
2014,HOU,29,32,23,22,14,0,0,120,POR,23,28,28,27,17,0,0,123,20140427
2014,CHI,18,22,22,27,0,0,0,89,WAS,28,27,27,16,0,0,0,98,20140427
2014,MIA,26,26,32,25,0,0,0,109,CHA,27,27,17,27,0,0,0,98,20140428
2014,SAS,18,32,23,20,0,0,0,93,DAL,23,13,29,24,0,0,0,89,20140428
2014,ATL,20,41,26,20,0,0,0,107,IND,21,19,27,30,0,0,0,97,20140428
2014,WAS,23,18,20,14,0,0,0,75,CHI,15,26,11,17,0,0,0,69,20140429
2014,GSW,21,29,22,31,0,0,0,103,LAC,31,24,22,36,0,0,0,113,20140429
2014,MEM,30,25,21,14,10,0,0,100,OKC,25,18,27,20,9,0,0,99,20140429
2014,POR,27,21,29,21,0,0,0,98,HOU,30,26,26,26,0,0,0,108,20140430
2014,DAL,26,23,22,32,0,0,0,103,SAS,27,31,21,30,0,0,0,109,20140430
2014,BRK,25,19,25,44,0,0,0,113,TOR,28,34,29,24,0,0,0,115,20140430
2014,IND,20,24,20,31,0,0,0,95,ATL,22,17,28,21,0,0,0,88,20140501
2014,LAC,25,26,16,32,0,0,0,99,GSW,25,23,22,30,0,0,0,100,20140501
2014,OKC,25,31,26,22,0,0,0,104,MEM,17,24,20,23,0,0,0,84,20140501
2014,TOR,19,22,18,24,0,0,0,83,BRK,34,26,19,18,0,0,0,97,20140502
2014,SAS,26,26,29,30,0,0,0,111,DAL,34,24,18,37,0,0,0,113,20140502
2014,HOU,29,29,21,19,0,0,0,98,POR,28,28,22,21,0,0,0,99,20140502
2014,ATL,23,13,27,17,0,0,0,80,IND,24,23,24,21,0,0,0,92,20140503
2014,GSW,32,32,20,37,0,0,0,121,LAC,22,34,31,39,0,0,0,126,20140503
2014,MEM,36,22,23,28,0,0,0,109,OKC,27,34,33,26,0,0,0,120,20140503
2014,DAL,23,23,22,28,0,0,0,96,SAS,35,33,26,25,0,0,0,119,20140504
2014,BRK,26,35,20,23,0,0,0,104,TOR,28,25,20,30,0,0,0,103,20140504
2014,WAS,28,28,13,33,0,0,0,102,IND,15,28,19,34,0,0,0,96,20140505
2014,LAC,39,30,35,18,0,0,0,122,OKC,25,27,26,27,0,0,0,105,20140505
2014,BRK,20,23,23,20,0,0,0,86,MIA,22,24,33,28,0,0,0,107,20140506
2014,POR,16,23,26,27,0,0,0,92,SAS,29,36,25,26,0,0,0,116,20140506
2014,WAS,23,22,19,18,0,0,0,82,IND,23,20,25,18,0,0,0,86,20140507
2014,LAC,28,28,21,24,0,0,0,101,OKC,37,24,33,18,0,0,0,112,20140507
2014,BRK,21,25,21,15,0,0,0,82,MIA,15,30,24,25,0,0,0,94,20140508
2014,POR,26,25,20,26,0,0,0,97,SAS,29,41,17,27,0,0,0,114,20140508
2014,OKC,29,32,25,32,0,0,0,118,LAC,33,30,27,22,0,0,0,112,20140509
2014,IND,17,17,26,25,0,0,0,85,WAS,17,16,12,18,0,0,0,63,20140509
2014,MIA,30,19,14,27,0,0,0,90,BRK,29,22,26,27,0,0,0,104,20140510
2014,SAS,28,32,23,35,0,0,0,118,POR,18,22,29,34,0,0,0,103,20140510
2014,OKC,32,25,18,24,0,0,0,99,LAC,15,31,17,38,0,0,0,101,20140511
2014,IND,27,11,33,24,0,0,0,95,WAS,26,29,17,20,0,0,0,92,20140511
2014,MIA,27,29,23,23,0,0,0,102,BRK,22,27,27,20,0,0,0,96,20140512
2014,SAS,24,24,20,24,0,0,0,92,POR,29,21,35,18,0,0,0,103,20140512
2014,WAS,25,20,31,26,0,0,0,102,IND,19,19,14,27,0,0,0,79,20140513
2014,LAC,34,24,28,18,0,0,0,104,OKC,25,27,28,25,0,0,0,105,20140513
2014,BRK,22,27,26,19,0,0,0,94,MIA,23,19,24,30,0,0,0,96,20140514
2014,POR,19,25,19,19,0,0,0,82,SAS,19,32,26,27,0,0,0,104,20140514
2014,OKC,16,26,30,32,0,0,0,104,LAC,30,20,22,26,0,0,0,98,20140515
2014,IND,29,23,19,22,0,0,0,93,WAS,23,17,23,17,0,0,0,80,20140515
2014,MIA,24,21,25,26,0,0,0,96,IND,30,25,28,24,0,0,0,107,20140518
2014,OKC,27,32,23,23,0,0,0,105,SAS,30,37,22,33,0,0,0,122,20140519
2014,MIA,20,21,21,25,0,0,0,87,IND,21,16,26,20,0,0,0,83,20140520
2014,OKC,26,18,18,15,0,0,0,77,SAS,24,34,33,21,0,0,0,112,20140521
2014,IND,21,21,22,23,0,0,0,87,MIA,14,24,33,28,0,0,0,99,20140524
2014,SAS,29,24,23,21,0,0,0,97,OKC,28,29,26,23,0,0,0,106,20140525
2014,IND,19,25,20,26,0,0,0,90,MIA,27,22,31,22,0,0,0,102,20140526
2014,SAS,20,23,24,25,0,0,0,92,OKC,26,32,25,22,0,0,0,105,20140527
2014,MIA,16,26,15,33,0,0,0,90,IND,22,11,31,29,0,0,0,93,20140528
2014,OKC,32,23,19,15,0,0,0,89,SAS,32,33,29,23,0,0,0,117,20140529
2014,IND,13,21,24,34,0,0,0,92,MIA,24,36,31,26,0,0,0,117,20140530
2014,SAS,20,22,37,22,11,0,0,112,OKC,23,26,20,32,6,0,0,107,20140531
2014,MIA,20,29,29,17,0,0,0,95,SAS,26,28,20,36,0,0,0,110,20140605
2014,MIA,19,24,34,21,0,0,0,98,SAS,26,17,35,18,0,0,0,96,20140608
2014,SAS,41,30,15,25,0,0,0,111,MIA,25,25,25,17,0,0,0,92,20140610
2014,SAS,26,29,26,26,0,0,0,107,MIA,17,19,21,29,0,0,0,86,20140612
2014,MIA,29,11,18,29,0,0,0,87,SAS,22,25,30,27,0,0,0,104,20140615
